,denominador,numerador,Frequência,P-value,Qtd_1_Denom,Qtd_0_Demon,D0N0,D0N1,D1N0,D1N1
1,Fuma,Fuma,1,2.09E-45,46,154,154,0,0,46
2,Cirurgia na coluna,Fuma,0.314285714,0.000756144,70,108,96,12,48,22
4,Desempregado,Fuma,0.392857143,0.045173575,28,157,123,34,17,11
5,Licenca_Medica,Fuma,0.5,0.006774555,18,169,133,36,9,9
6,Aposentado_Invalidez,Fuma,0.625,0.00961679,8,174,135,39,3,5
10,Dor nas pernas,Fuma,0.344262295,0.040518281,61,122,97,25,40,21
14,Casado/Amasiaado,Fuma,0.142857143,0.006273695,84,109,75,34,72,12
17,X4,Fuma,1,0.001804648,3,190,147,43,0,3
24,D15,Fuma,1,0.002322567,5,123,82,41,0,5
27,D18,Fuma,0.642857143,0.019158686,14,114,77,37,5,9
29,D2,Fuma,1,9.61E-05,8,120,82,38,0,8
45,D34,Fuma,1,0.019277409,3,125,82,43,0,3
49,D38,Fuma,1,0.019277409,3,125,82,43,0,3
51,D4,Fuma,1,0.006667415,4,124,82,42,0,4
52,D40,Fuma,1,0.006667415,4,124,82,42,0,4
62,D5,Fuma,1,0.019277409,3,125,82,43,0,3
74,RMDQ7_v1,Fuma,0.342857143,0.015589297,35,148,124,24,23,12
75,RMDQ8_v1,Fuma,0.5,0.027338121,8,175,143,32,4,4
76,RMDQ9_v1,Fuma,0.333333333,0.039533218,30,153,127,26,20,10
87,RMDQ20_v1,Fuma,0.34375,0.021260536,32,151,126,25,21,11
91,RMDQ24_v1,Fuma,0.35483871,0.01509902,31,152,127,25,20,11
96,DN4 - Alfinetada e agulhada,Fuma,0.320754717,0.018814926,53,133,111,22,36,17
98,DN4 - Coceira,Fuma,0.5,0.039205208,8,178,143,35,4,4
99,DH4 - Hipoestesia ao toque,Fuma,0.571428571,0.016544161,7,179,144,35,3,4
100,DN4 - Hipoestesia a picada de agulha,Fuma,0.625,0.003179349,8,178,144,34,3,5
101,DN4 - Escovação,Fuma,0.666666667,0.005185635,6,180,145,35,2,4
102,Fuma,Cirurgia na coluna,0.647058824,0.000756144,34,144,96,48,12,22
103,Cirurgia na coluna,Cirurgia na coluna,1,3.04E-48,79,134,134,0,0,79
104,Aposentado,Cirurgia na coluna,0.606060606,0.005264365,33,151,99,52,13,20
105,Desempregado,Cirurgia na coluna,0.625,0.015653846,24,156,99,57,9,15
106,Licenca_Medica,Cirurgia na coluna,0.769230769,0.004250124,13,169,107,62,3,10
111,Dor nas pernas,Cirurgia na coluna,0.555555556,0.003576257,54,132,89,43,24,30
125,D15,Cirurgia na coluna,1,0.014463327,5,113,63,50,0,5
132,D21,Cirurgia na coluna,0,0.03276102,5,113,58,55,5,0
148,D36,Cirurgia na coluna,1,0.007126089,6,112,63,49,0,6
153,D40,Cirurgia na coluna,1,0.029424848,4,114,63,51,0,4
204,Cirurgia na coluna,Aposentado,0.277777778,0.005264365,72,112,99,13,52,20
205,Aposentado,Aposentado,1,1.26E-45,37,164,164,0,0,37
206,Desempregado,Aposentado,0.366666667,0.004636515,30,167,142,25,19,11
210,OutraDoenca,Aposentado,0.267605634,0.035879052,71,124,106,18,52,19
213,Retornar_trabalho,Aposentado,0.619047619,5.70E-09,21,155,138,17,8,13
217,Solteiro,Aposentado,0.111111111,0.03547402,81,109,84,25,72,9
221,X6,Aposentado,0.636363636,4.55E-05,11,179,152,27,4,7
227,D16,Aposentado,0.45,0.013733293,20,112,90,22,11,9
243,Lombalgia,Aposentado_Invalidez,0.114754098,0.016601391,61,70,69,1,54,7
250,D37,Aposentado,0.409090909,0.034688805,22,110,88,22,13,9
252,D39,Aposentado,0.466666667,0.024469658,15,117,93,24,8,7
262,D48,Aposentado,0.384615385,0.044395495,26,106,85,21,16,10
273,RMDQ4_v1,Aposentado,0.28,0.042074684,50,134,114,20,36,14
300,DN4 - Coceira,Aposentado,0.5,0.035505939,6,180,150,30,3,3
304,Fuma,Desempregado,0.244444444,0.045173575,45,140,123,17,34,11
305,Cirurgia na coluna,Desempregado,0.208333333,0.015653846,72,108,99,9,57,15
306,Aposentado,Desempregado,0.305555556,0.004636515,36,161,142,19,25,11
307,Desempregado,Desempregado,1,9.43E-45,30,167,167,0,0,30
308,Licenca_Medica,Desempregado,0.421052632,0.000639853,19,177,155,22,11,8
312,Dor nas costas,Desempregado,0.234782609,0.000319402,115,75,72,3,88,27
314,Retornar_trabalho,Desempregado,0.368421053,0.004801335,19,154,135,19,12,7
346,D32,Desempregado,0.081081081,0.042393405,37,93,71,22,34,3
348,D34,Desempregado,0.666666667,0.03492795,3,127,104,23,1,2
349,D35,Desempregado,1,0.003490999,2,128,105,23,0,2
354,D4,Desempregado,0.75,0.004044351,4,126,104,22,1,3
359,D44,Desempregado,0.078947368,0.03505672,38,92,70,22,35,3
365,D5,Desempregado,0.666666667,0.03492795,3,127,104,23,1,2
367,D51,Desempregado,1,0.039655629,1,129,105,24,0,1
370,D9,Desempregado,1,0.039655629,1,129,105,24,0,1
402,DH4 - Hipoestesia ao toque,Desempregado,0.6,0.00294161,5,178,155,23,2,3
403,DN4 - Hipoestesia a picada de agulha,Desempregado,0.5,0.010667604,6,177,154,23,3,3
404,DN4 - Escovação,Desempregado,0.75,0.000429574,4,179,156,23,1,3
405,Fuma,Licenca_Medica,0.2,0.006774555,45,142,133,9,36,9
406,Cirurgia na coluna,Licenca_Medica,0.138888889,0.004250124,72,110,107,3,62,10
408,Desempregado,Licenca_Medica,0.266666667,0.000639853,30,166,155,11,22,8
409,Licenca_Medica,Licenca_Medica,1,3.45E-45,19,180,180,0,0,19
410,Aposentado_Invalidez,Licenca_Medica,0.375,0.005305892,8,184,169,15,5,3
413,Dor nas costas,Licenca_Medica,0.137931034,0.027224233,116,75,72,3,100,16
414,Dor nas pernas,Licenca_Medica,0.2,0.001925592,60,129,122,7,48,12
428,D15,Licenca_Medica,0.5,0.007892773,6,126,111,15,3,3
449,D34,Licenca_Medica,0.666666667,0.006780018,3,129,113,16,1,2
451,D36,Licenca_Medica,0.428571429,0.020610881,7,125,110,15,4,3
452,D37,Licenca_Medica,0.272727273,0.041184163,22,110,98,12,16,6
456,D40,Licenca_Medica,0.75,0.000281575,4,128,113,15,1,3
457,D41,Licenca_Medica,0.428571429,0.020610881,7,125,110,15,4,3
466,D5,Licenca_Medica,0.666666667,0.006780018,3,129,113,16,1,2
468,D51,Licenca_Medica,1,0.011530428,1,131,114,17,0,1
471,D9,Licenca_Medica,1,0.011530428,1,131,114,17,0,1
498,DN4 - Choque elétrico,Licenca_Medica,0.170212766,0.032747284,47,137,128,9,39,8
500,DN4 - Alfinetada e agulhada,Licenca_Medica,0.176470588,0.01473243,51,133,125,8,42,9
502,DN4 - Coceira,Licenca_Medica,0.5,0.000455707,6,178,164,14,3,3
503,DH4 - Hipoestesia ao toque,Licenca_Medica,0.4,0.016029306,5,179,164,15,3,2
504,DN4 - Hipoestesia a picada de agulha,Licenca_Medica,0.333333333,0.038250994,6,178,163,15,4,2
505,DN4 - Escovação,Licenca_Medica,0.5,0.004423,4,180,165,15,2,2
506,Fuma,Aposentado_Invalidez,0.113636364,0.00961679,44,138,135,3,39,5
510,Licenca_Medica,Aposentado_Invalidez,0.166666667,0.005305892,18,174,169,5,15,3
511,Aposentado_Invalidez,Aposentado_Invalidez,1,9.43E-45,8,189,189,0,0,8
515,Dor nas pernas,Aposentado_Invalidez,0.118644068,0.000473032,59,129,128,1,52,7
516,Retornar_trabalho,Aposentado_Invalidez,0.19047619,0.000186476,21,153,150,3,17,4
545,D3,Aposentado_Invalidez,0.5,0.008993049,2,129,122,7,1,1
546,Lombalgia,D33,0.14516129,0.032162513,62,74,71,3,53,9
563,D46,Aposentado_Invalidez,0.131578947,0.031214413,38,93,90,3,33,5
579,RMDQ7_v1,Aposentado_Invalidez,0.121212121,0.01849634,33,146,142,4,29,4
581,RMDQ9_v1,Aposentado_Invalidez,0.142857143,0.006199483,28,151,147,4,24,4
582,RMDQ10_v1,Aposentado_Invalidez,0.117647059,0.022172222,34,145,141,4,30,4
583,RMDQ11_v1,Aposentado_Invalidez,0.111111111,0.03094463,36,143,139,4,32,4
584,RMDQ12_v1,Aposentado_Invalidez,0.105263158,0.041749623,38,141,137,4,34,4
587,RMDQ15_v1,Aposentado_Invalidez,0.12,0.049455908,25,154,149,5,22,3
591,RMDQ19_v1,Aposentado_Invalidez,0.153846154,0.003574036,26,153,149,4,22,4
592,RMDQ20_v1,Aposentado_Invalidez,0.129032258,0.012444048,31,148,144,4,27,4
593,RMDQ21_v1,Aposentado_Invalidez,0.102564103,0.047958398,39,140,136,4,35,4
594,RMDQ22_v1,Aposentado_Invalidez,0.125,0.015262312,32,147,143,4,28,4
595,RMDQ23_v1,Aposentado_Invalidez,0.129032258,0.012444048,31,148,144,4,27,4
596,RMDQ24_v1,Aposentado_Invalidez,0.137931034,0.007942392,29,150,146,4,25,4
603,DN4 - Coceira,Aposentado_Invalidez,0.333333333,0.000437803,6,176,170,6,4,2
604,DH4 - Hipoestesia ao toque,Aposentado_Invalidez,0.333333333,0.000437803,6,176,170,6,4,2
605,DN4 - Hipoestesia a picada de agulha,Aposentado_Invalidez,0.285714286,0.001462671,7,175,169,6,5,2
606,DN4 - Escovação,Aposentado_Invalidez,0.4,8.21E-05,5,177,171,6,3,2
613,Analgésicos,Analgésicos,1,1.11E-48,147,68,68,0,0,147
615,Dor nas costas,Analgésicos,0.81147541,6.20E-07,122,78,41,37,23,99
616,Dor nas pernas,Analgésicos,0.84375,0.000516846,64,134,54,80,10,54
631,D16,Analgésicos,0.9,0.020388783,20,110,40,70,2,18
645,D29,Analgésicos,0.833333333,0.008426224,42,88,35,53,7,35
647,Lombalgia,D47,0.14516129,0.032162513,62,74,71,3,53,9
649,D32,Analgésicos,0.891891892,0.000946868,37,93,38,55,4,33
656,D39,Analgésicos,0.933333333,0.023959532,15,115,41,74,1,14
662,D44,Analgésicos,0.868421053,0.002694298,38,92,37,55,5,33
664,D46,Analgésicos,0.868421053,0.002694298,38,92,37,55,5,33
666,D48,Analgésicos,0.846153846,0.039113011,26,104,38,66,4,22
676,RMDQ3_v1,Analgésicos,0.830985915,0.006358286,71,128,45,83,12,59
678,RMDQ5_v1,Analgésicos,0.846153846,0.003959426,65,134,47,87,10,55
679,RMDQ6_v1,Analgésicos,0.823529412,0.043993117,51,148,48,100,9,42
680,RMDQ7_v1,Analgésicos,0.888888889,0.009606303,36,162,53,109,4,32
682,RMDQ9_v1,Analgésicos,0.903225806,0.010501956,31,167,54,113,3,28
683,RMDQ10_v1,Analgésicos,0.891891892,0.007399914,37,161,53,108,4,33
684,RMDQ11_v1,Analgésicos,0.894736842,0.005678359,38,160,53,107,4,34
685,RMDQ12_v1,Analgésicos,0.853658537,0.024586893,41,157,51,106,6,35
687,RMDQ14_v1,Analgésicos,0.866666667,0.009193885,45,153,51,102,6,39
688,RMDQ15_v1,Analgésicos,0.888888889,0.029041827,27,171,54,117,3,24
689,RMDQ16_v1,Analgésicos,0.852941176,0.046299011,34,164,52,112,5,29
691,RMDQ18_v1,Analgésicos,0.909090909,0.006189497,33,165,54,111,3,30
692,RMDQ19_v1,Analgésicos,0.896551724,0.017581314,29,169,54,115,3,26
693,RMDQ20_v1,Analgésicos,0.911764706,0.004727577,34,164,54,110,3,31
694,RMDQ21_v1,Analgésicos,0.928571429,0.000482357,42,156,54,102,3,39
695,RMDQ22_v1,Analgésicos,0.852941176,0.046299011,34,164,52,112,5,29
696,RMDQ23_v1,Analgésicos,0.882352941,0.016003095,34,164,53,111,4,30
697,RMDQ24_v1,Analgésicos,0.90625,0.008075987,32,166,54,112,3,29
698,DN4 - Queimação,Analgésicos,0.795698925,0.001204309,93,105,44,61,19,74
699,DN4 - Sensação de frio dolorosa,Analgésicos,0.8,0.044360433,45,153,55,98,9,36
706,DN4 - Hipoestesia a picada de agulha,Analgésicos,1,0.048512652,8,193,64,129,0,8
710,Aposentado,OutraDoenca,0.513513514,0.035879052,37,158,106,52,18,19
715,OutraDoenca,OutraDoenca,1,6.20E-47,80,127,127,0,0,80
782,RMDQ8_v1,OutraDoenca,0.75,0.036939254,8,181,112,69,2,6
791,RMDQ17_v1,OutraDoenca,0.619047619,0.00084438,42,147,98,49,16,26
803,DN4 - Alfinetada e agulhada,OutraDoenca,0.491525424,0.034318583,59,133,89,44,30,29
812,Desempregado,Dor nas costas,0.9,0.000319402,30,160,72,88,3,27
813,Licenca_Medica,Dor nas costas,0.842105263,0.027224233,19,172,72,100,3,16
815,Analgésicos,Dor nas costas,0.727941176,6.20E-07,136,64,41,23,37,99
817,Dor nas costas,Dor nas costas,1,6.20E-47,128,79,79,0,0,128
818,Dor nas pernas,Dor nas costas,0.84375,5.86E-06,64,139,68,71,10,54
819,Retornar_trabalho,Dor nas costas,0.9,0.008590175,20,165,66,99,2,18
828,Livrar_costas,Dor nas costas,0.918918919,5.90E-05,111,16,7,9,9,102
829,Livrar_perna,Dor nas costas,0.571428571,0.000297933,14,113,10,103,6,8
833,D16,Dor nas costas,0.95,0.010243912,20,108,36,72,1,19
835,D18,Dor nas costas,0.9375,0.032586834,16,112,36,76,1,15
847,D29,Dor nas costas,0.902439024,0.001034627,41,87,33,54,4,37
849,Lombalgia,D45,0.161290323,0.005970555,62,74,72,2,52,10
851,D32,Dor nas costas,0.916666667,0.001319126,36,92,34,58,3,33
857,D38,Dor nas costas,0,0.005982854,3,125,34,91,3,0
864,D44,Dor nas costas,0.891891892,0.003980919,37,91,33,58,4,33
866,D46,Dor nas costas,0.837837838,0.043438907,37,91,31,60,6,31
881,RMDQ6_v1,Dor nas costas,0.770833333,0.041292104,48,143,56,87,11,37
882,RMDQ7_v1,Dor nas costas,0.823529412,0.017662644,34,156,61,95,6,28
884,RMDQ9_v1,Dor nas costas,0.827586207,0.027341825,29,161,62,99,5,24
885,RMDQ10_v1,Dor nas costas,0.828571429,0.012986902,35,155,61,94,6,29
886,RMDQ11_v1,Dor nas costas,0.828571429,0.012986902,35,155,61,94,6,29
887,RMDQ12_v1,Dor nas costas,0.794871795,0.030568114,39,151,59,92,8,31
889,RMDQ14_v1,Dor nas costas,0.813953488,0.009342115,43,147,59,88,8,35
891,RMDQ16_v1,Dor nas costas,0.84375,0.010781828,32,158,62,96,5,27
893,RMDQ18_v1,Dor nas costas,0.870967742,0.00439467,31,159,63,96,4,27
894,RMDQ19_v1,Dor nas costas,0.814814815,0.04928773,27,163,62,101,5,22
895,RMDQ20_v1,Dor nas costas,0.84375,0.010781828,32,158,62,96,5,27
898,RMDQ23_v1,Dor nas costas,0.8125,0.032035955,32,158,61,97,6,26
899,RMDQ24_v1,Dor nas costas,0.833333333,0.020172579,30,160,62,98,5,25
900,DN4 - Queimação,Dor nas costas,0.686046512,0.049836366,86,106,48,58,27,59
910,Fuma,Dor nas pernas,0.456521739,0.040518281,46,137,97,40,25,21
911,Cirurgia na coluna,Dor nas pernas,0.410958904,0.003576257,73,113,89,24,43,30
914,Licenca_Medica,Dor nas pernas,0.631578947,0.001925592,19,170,122,48,7,12
915,Aposentado_Invalidez,Dor nas pernas,0.875,0.000473032,8,180,128,52,1,7
916,Analgésicos,Dor nas pernas,0.402985075,0.000516846,134,64,54,10,80,54
918,Dor nas costas,Dor nas pernas,0.432,5.86E-06,125,78,68,10,71,54
919,Dor nas pernas,Dor nas pernas,1,2.80E-46,65,139,139,0,0,65
920,Retornar_trabalho,Dor nas pernas,0.65,0.000968017,20,162,116,46,7,13
929,Livrar_costas,Dor nas pernas,0.4,0.000663642,110,15,2,13,66,44
930,Livrar_perna,Dor nas pernas,0.928571429,0.000164949,14,111,67,44,1,13
933,D15,Dor nas pernas,0.857142857,0.019834506,7,120,71,49,1,6
934,D16,Dor nas pernas,0.95,3.72E-07,20,107,71,36,1,19
948,D29,Dor nas pernas,0.731707317,2.74E-06,41,86,61,25,11,30
950,Lombalgia,D49,0.177419355,0.002969643,62,74,72,2,51,11
952,D32,Dor nas pernas,0.833333333,1.03E-08,36,91,66,25,6,30
953,D33,Dor nas pernas,0.75,0.019889661,12,115,69,46,3,9
957,D37,Dor nas pernas,0.863636364,7.38E-06,22,105,69,36,3,19
958,D38,Dor nas pernas,1,0.044902775,3,124,72,52,0,3
959,D39,Dor nas pernas,0.866666667,0.000307451,15,112,70,42,2,13
962,D41,Dor nas pernas,0.857142857,0.019834506,7,120,71,49,1,6
965,D44,Dor nas pernas,0.837837838,3.58E-09,37,90,66,24,6,31
966,D45,Dor nas pernas,1,3.11E-05,12,115,72,43,0,12
967,D46,Dor nas pernas,0.864864865,3.04E-10,37,90,67,23,5,32
968,D47,Dor nas pernas,1,3.11E-05,12,115,72,43,0,12
969,D48,Dor nas pernas,0.92,4.19E-08,25,102,70,32,2,23
970,D49,Dor nas pernas,0.769230769,0.009828559,13,114,69,45,3,10
995,RMDQ19_v1,Dor nas pernas,0.518518519,0.041376392,27,161,110,51,13,14
1001,DN4 - Queimação,Dor nas pernas,0.458823529,0.000252532,85,105,83,22,46,39
1003,DN4 - Choque elétrico,Dor nas pernas,0.547169811,4.07E-05,53,139,106,33,24,29
1004,DN4 - Formigamento,Dor nas pernas,0.510638298,0.001539604,47,145,107,38,23,24
1005,DN4 - Alfinetada e agulhada,Dor nas pernas,0.5,0.000758979,56,136,102,34,28,28
1006,DN4 - Adormecimento,Dor nas pernas,0.464285714,0.006262141,56,134,99,35,30,26
1008,DH4 - Hipoestesia ao toque,Dor nas pernas,0.833333333,0.006595299,6,186,129,57,1,5
1010,DN4 - Escovação,Dor nas pernas,0.8,0.020790907,5,187,129,58,1,4
1013,Aposentado,Retornar_trabalho,0.433333333,5.70E-09,30,146,138,8,17,13
1014,Desempregado,Retornar_trabalho,0.269230769,0.004801335,26,147,135,12,19,7
1016,Aposentado_Invalidez,Retornar_trabalho,0.571428571,0.000186476,7,167,150,17,3,4
1019,Dor nas costas,Retornar_trabalho,0.153846154,0.008590175,117,68,66,2,99,18
1020,Dor nas pernas,Retornar_trabalho,0.220338983,0.000968017,59,123,116,7,46,13
1021,Retornar_trabalho,Retornar_trabalho,1,2.80E-46,21,183,183,0,0,21
1029,X6,Retornar_trabalho,0.444444444,0.003031321,9,158,141,17,5,4
1035,D16,Retornar_trabalho,0.411764706,0.00370268,17,102,89,13,10,7
1045,D25,Retornar_trabalho,0.75,0.001544314,4,115,98,17,1,3
1047,D27,Retornar_trabalho,0.6,0.008315517,5,114,97,17,2,3
1051,Lombalgia,D39,0.193548387,0.004554221,62,74,71,3,50,12
1058,D37,Retornar_trabalho,0.35,0.017051652,20,99,86,13,13,7
1060,D39,Retornar_trabalho,0.357142857,0.043993319,14,105,90,15,9,5
1070,D48,Retornar_trabalho,0.391304348,0.001433906,23,96,85,11,14,9
1081,RMDQ4_v1,Retornar_trabalho,0.183673469,0.041278471,49,139,128,11,40,9
1082,RMDQ5_v1,Retornar_trabalho,0.19047619,0.007933886,63,125,117,8,51,12
1083,RMDQ6_v1,Retornar_trabalho,0.1875,0.03466901,48,140,129,11,39,9
1087,RMDQ10_v1,Retornar_trabalho,0.194444444,0.04019157,36,151,139,12,29,7
1088,RMDQ11_v1,Retornar_trabalho,0.189189189,0.048968827,37,150,138,12,30,7
1098,RMDQ21_v1,Retornar_trabalho,0.23255814,0.001199768,43,144,135,9,33,10
1109,DH4 - Hipoestesia ao toque,Retornar_trabalho,0.428571429,0.001306649,7,184,170,14,4,3
1110,DN4 - Hipoestesia a picada de agulha,Retornar_trabalho,0.375,0.003705427,8,183,169,14,5,3
1111,DN4 - Escovação,Retornar_trabalho,0.5,0.000327726,6,185,171,14,3,3
1123,Masc,Masc,1,3.93E-54,161,79,79,0,0,161
1124,Fem,Masc,0,3.93E-54,79,161,0,161,79,0
1130,X6,Masc,1,0.010945431,12,190,68,122,0,12
1139,D19,Masc,1,0.044820788,7,129,48,81,0,7
1164,D41,Masc,1,0.044820788,7,129,48,81,0,7
1224,Masc,Fem,0,3.93E-54,161,79,0,79,161,0
1225,Fem,Fem,1,3.93E-54,79,161,161,0,0,79
1231,X6,Fem,0,0.010945431,12,190,122,68,12,0
1240,D19,Fem,0,0.044820788,7,129,81,48,7,0
1265,D41,Fem,0,0.044820788,7,129,81,48,7,0
1314,Fuma,Casado/Amasiaado,0.260869565,0.006273695,46,147,75,72,34,12
1327,Casado/Amasiaado,Casado/Amasiaado,1,7.65E-46,85,117,117,0,0,85
1328,Solteiro,Casado/Amasiaado,0,1.87E-26,88,114,29,85,88,0
1329,Separado_Divorciado,Casado/Amasiaado,0,0.01389343,8,194,109,85,8,0
1331,X5,Casado/Amasiaado,0,0.034045603,6,196,111,85,6,0
1332,X6,Casado/Amasiaado,0,0.002331214,12,190,105,85,12,0
1368,D43,Casado/Amasiaado,1,0.033543153,3,133,81,52,0,3
1406,DN4 - Sensação de frio dolorosa,Casado/Amasiaado,0.675,0.00050022,40,142,90,52,13,27
1409,DN4 - Alfinetada e agulhada,Casado/Amasiaado,0.327272727,0.048651461,55,130,67,63,37,18
1417,Aposentado,Solteiro,0.264705882,0.03547402,34,156,84,72,25,9
1428,Casado/Amasiaado,Solteiro,0,1.87E-26,85,117,29,88,85,0
1429,Solteiro,Solteiro,1,7.65E-46,88,114,114,0,0,88
1430,Separado_Divorciado,Solteiro,0,0.011220252,8,194,106,88,8,0
1432,X5,Solteiro,0,0.02890333,6,196,108,88,6,0
1433,X6,Solteiro,0,0.001699981,12,190,102,88,12,0
1451,D27,Solteiro,1,0.009247013,5,131,77,54,0,5
1471,D45,Solteiro,0.75,0.020643483,12,124,74,50,3,9
1472,D46,Solteiro,0.289473684,0.034420939,38,98,50,48,27,11
1507,DN4 - Sensação de frio dolorosa,Solteiro,0.25,0.009774876,40,142,74,68,30,10
1529,Casado/Amasiaado,Separado_Divorciado,0,0.01389343,85,117,109,8,85,0
1530,Solteiro,Separado_Divorciado,0,0.011220252,88,114,106,8,88,0
1531,Separado_Divorciado,Separado_Divorciado,1,7.65E-46,8,194,194,0,0,8
1617,Fuma,X4,0.065217391,0.001804648,46,147,147,0,43,3
1633,X4,X4,1,7.65E-46,3,199,199,0,0,3
1640,D15,X4,0.142857143,0.025464867,7,129,127,2,6,1
1642,D17,X4,0.2,0.005775792,5,131,129,2,4,1
1644,D19,X4,0.142857143,0.025464867,7,129,127,2,6,1
1645,D2,X4,0.25,6.05E-06,8,128,127,1,6,2
1656,D3,X4,0.5,3.55E-06,2,134,132,2,1,1
1663,D36,X4,0.125,0.041013946,8,128,126,2,7,1
1665,D38,X4,0.333333333,0.000205681,3,133,131,2,2,1
1667,D4,X4,0.25,0.001629579,4,132,130,2,3,1
1668,D40,X4,0.2,0.005775792,5,131,129,2,4,1
1712,DN4 - Alfinetada e agulhada,X4,0.054545455,0.007258773,55,130,130,0,52,3
1714,DN4 - Coceira,X4,0.142857143,0.006842345,7,178,176,2,6,1
1731,Casado/Amasiaado,X5,0,0.034045603,85,117,111,6,85,0
1732,Solteiro,X5,0,0.02890333,88,114,108,6,88,0
1735,X5,X5,1,7.65E-46,6,196,196,0,0,6
1739,Livrar_perda_sens,X5,1,9.37E-14,1,111,110,1,0,1
1814,DN4 - Adormecimento,X5,0.074074074,0.012071721,54,129,128,1,50,4
1821,Aposentado,X6,0.205882353,4.55E-05,34,156,152,4,27,7
1829,Retornar_trabalho,X6,0.19047619,0.003031321,21,146,141,5,17,4
1830,Masc,X6,0.089552239,0.010945431,134,68,68,0,122,12
1831,Fem,X6,0,0.010945431,68,134,122,12,68,0
1832,Casado/Amasiaado,X6,0,0.002331214,85,117,105,12,85,0
1833,Solteiro,X6,0,0.001699981,88,114,102,12,88,0
1837,X6,X6,1,7.65E-46,12,190,190,0,0,12
1868,D39,X6,0.2,0.046635117,15,121,114,7,12,3
1876,D46,X6,0.157894737,0.018910781,38,98,94,4,32,6
1878,D48,X6,0.192307692,0.009874806,26,110,105,5,21,5
1891,RMDQ6_v1,X6,0.145833333,0.008912245,48,135,130,5,41,7
1916,DN4 - Coceira,X6,0.285714286,0.009862403,7,178,169,9,5,2
1928,Dor nas costas,Livrar_costas,0.918918919,5.90E-05,111,16,7,9,9,102
1929,Dor nas pernas,Livrar_costas,0.771929825,0.000663642,57,68,2,66,13,44
1939,Livrar_costas,Livrar_costas,1,1.12E-29,112,16,16,0,0,112
1940,Livrar_perna,Livrar_costas,0,9.63E-26,14,114,2,112,14,0
1941,Livrar_perda_sens,Livrar_costas,0,0.000162441,2,126,14,112,2,0
1953,D24,Livrar_costas,1,0.01983502,25,75,14,61,0,25
1963,D33,Livrar_costas,0.666666667,0.039636817,12,88,10,78,4,8
1966,D36,Livrar_costas,0.571428571,0.022510445,7,93,11,82,3,4
1968,D38,Livrar_costas,0,1.31E-05,3,97,11,86,3,0
1971,D40,Livrar_costas,0.25,0.000332607,4,96,11,85,3,1
1976,D45,Livrar_costas,0.666666667,0.039636817,12,88,10,78,4,8
1977,D46,Livrar_costas,0.75,0.017425222,36,64,5,59,9,27
1978,D47,Livrar_costas,0.583333333,0.003236093,12,88,9,79,5,7
1990,RMDQ4_v1,Livrar_costas,0.96969697,0.048280755,33,91,15,76,1,32
2029,Dor nas costas,Livrar_perna,0.072072072,0.000297933,111,16,10,6,103,8
2030,Dor nas pernas,Livrar_perna,0.228070175,0.000164949,57,68,67,1,44,13
2040,Livrar_costas,Livrar_perna,0,9.63E-26,112,16,2,14,112,0
2041,Livrar_perna,Livrar_perna,1,1.12E-29,14,114,114,0,0,14
2054,D24,Livrar_perna,0,0.01983502,25,75,61,14,25,0
2064,D33,Livrar_perna,0.333333333,0.039636817,12,88,78,10,8,4
2067,D36,Livrar_perna,0.428571429,0.022510445,7,93,82,11,4,3
2069,D38,Livrar_perna,1,1.31E-05,3,97,86,11,0,3
2072,D40,Livrar_perna,0.75,0.000332607,4,96,85,11,1,3
2077,D45,Livrar_perna,0.333333333,0.039636817,12,88,78,10,8,4
2078,D46,Livrar_perna,0.25,0.017425222,36,64,59,5,27,9
2079,D47,Livrar_perna,0.416666667,0.003236093,12,88,79,9,7,5
2115,DN4 - Formigamento,Livrar_perna,0.225806452,0.027950488,31,89,82,7,24,7
2139,X5,Livrar_perda_sens,0.5,9.37E-14,2,110,110,0,1,1
2141,Livrar_costas,Livrar_perda_sens,0,0.000162441,112,16,14,2,112,0
2143,Livrar_perda_sens,Livrar_perda_sens,1,1.12E-29,2,126,126,0,0,2
NA,NA,NA,NA,NA,NA,NA,NA,NA,NA,NA
NA.1,NA,NA,NA,NA,NA,NA,NA,NA,NA,NA
NA.2,NA,NA,NA,NA,NA,NA,NA,NA,NA,NA
NA.3,NA,NA,NA,NA,NA,NA,NA,NA,NA,NA
NA.4,NA,NA,NA,NA,NA,NA,NA,NA,NA,NA
NA.5,NA,NA,NA,NA,NA,NA,NA,NA,NA,NA
NA.6,NA,NA,NA,NA,NA,NA,NA,NA,NA,NA
NA.7,NA,NA,NA,NA,NA,NA,NA,NA,NA,NA
NA.8,NA,NA,NA,NA,NA,NA,NA,NA,NA,NA
NA.9,NA,NA,NA,NA,NA,NA,NA,NA,NA,NA
NA.10,NA,NA,NA,NA,NA,NA,NA,NA,NA,NA
NA.11,NA,NA,NA,NA,NA,NA,NA,NA,NA,NA
NA.12,NA,NA,NA,NA,NA,NA,NA,NA,NA,NA
NA.13,NA,NA,NA,NA,NA,NA,NA,NA,NA,NA
NA.14,NA,NA,NA,NA,NA,NA,NA,NA,NA,NA
NA.15,NA,NA,NA,NA,NA,NA,NA,NA,NA,NA
NA.16,NA,NA,NA,NA,NA,NA,NA,NA,NA,NA
NA.17,NA,NA,NA,NA,NA,NA,NA,NA,NA,NA
NA.18,NA,NA,NA,NA,NA,NA,NA,NA,NA,NA
NA.19,NA,NA,NA,NA,NA,NA,NA,NA,NA,NA
NA.20,NA,NA,NA,NA,NA,NA,NA,NA,NA,NA
NA.21,NA,NA,NA,NA,NA,NA,NA,NA,NA,NA
NA.22,NA,NA,NA,NA,NA,NA,NA,NA,NA,NA
NA.23,NA,NA,NA,NA,NA,NA,NA,NA,NA,NA
NA.24,NA,NA,NA,NA,NA,NA,NA,NA,NA,NA
NA.25,NA,NA,NA,NA,NA,NA,NA,NA,NA,NA
NA.26,NA,NA,NA,NA,NA,NA,NA,NA,NA,NA
NA.27,NA,NA,NA,NA,NA,NA,NA,NA,NA,NA
NA.28,NA,NA,NA,NA,NA,NA,NA,NA,NA,NA
NA.29,NA,NA,NA,NA,NA,NA,NA,NA,NA,NA
NA.30,NA,NA,NA,NA,NA,NA,NA,NA,NA,NA
NA.31,NA,NA,NA,NA,NA,NA,NA,NA,NA,NA
NA.32,NA,NA,NA,NA,NA,NA,NA,NA,NA,NA
NA.33,NA,NA,NA,NA,NA,NA,NA,NA,NA,NA
NA.34,NA,NA,NA,NA,NA,NA,NA,NA,NA,NA
NA.35,NA,NA,NA,NA,NA,NA,NA,NA,NA,NA
NA.36,NA,NA,NA,NA,NA,NA,NA,NA,NA,NA
NA.37,NA,NA,NA,NA,NA,NA,NA,NA,NA,NA
NA.38,NA,NA,NA,NA,NA,NA,NA,NA,NA,NA
NA.39,NA,NA,NA,NA,NA,NA,NA,NA,NA,NA
NA.40,NA,NA,NA,NA,NA,NA,NA,NA,NA,NA
NA.41,NA,NA,NA,NA,NA,NA,NA,NA,NA,NA
NA.42,NA,NA,NA,NA,NA,NA,NA,NA,NA,NA
NA.43,NA,NA,NA,NA,NA,NA,NA,NA,NA,NA
NA.44,NA,NA,NA,NA,NA,NA,NA,NA,NA,NA
NA.45,NA,NA,NA,NA,NA,NA,NA,NA,NA,NA
2245,D1,D1,1,2.00E-31,1,135,135,0,0,1
2248,D17,D1,0.2,2.78E-07,5,131,131,0,4,1
2249,D18,D1,0.0625,0.005982535,16,120,120,0,15,1
2302,RMDQ13_v1,D1,0.045454545,0.036891632,22,95,95,0,21,1
2315,DN4 - Sensação de frio dolorosa,D1,0.041666667,0.0468674,24,94,94,0,23,1
2324,Fuma,D15,0.108695652,0.002322567,46,82,82,0,41,5
2325,Cirurgia na coluna,D15,0.090909091,0.014463327,55,63,63,0,50,5
2328,Licenca_Medica,D15,0.166666667,0.007892773,18,114,111,3,15,3
2333,Dor nas pernas,D15,0.109090909,0.019834506,55,72,71,1,49,6
2340,X4,D15,0.333333333,0.025464867,3,133,127,6,2,1
NA.46,NA,NA,NA,NA,NA,NA,NA,NA,NA,NA
2347,D15,D15,1,2.00E-31,7,129,129,0,0,7
2348,D16,D15,0.15,0.030825591,20,116,112,4,17,3
2349,D17,D15,0.4,0.000325897,5,131,126,5,3,2
2365,D31,D15,0.235294118,0.000245367,17,119,116,3,13,4
2368,D34,D15,0.333333333,0.025464867,3,133,127,6,2,1
2369,D35,D15,0.5,0.003826379,2,134,128,6,1,1
2370,D36,D15,0.625,3.80E-14,8,128,126,2,3,5
2371,D37,D15,0.181818182,0.002509261,22,114,111,3,18,4
2372,D38,D15,0.666666667,1.08E-06,3,133,128,5,1,2
2375,D40,D15,0.8,1.18E-14,5,131,128,3,1,4
2376,D41,D15,0.428571429,3.55E-06,7,129,125,4,4,3
2382,D47,D15,0.25,0.001115552,12,124,120,4,9,3
2385,D5,D15,0.333333333,0.025464867,3,133,127,6,2,1
2387,D51,D15,1,1.64E-05,1,135,129,6,0,1
2390,D9,D15,1,1.64E-05,1,135,129,6,0,1
2417,DN4 - Choque elétrico,D15,0.138888889,0.014498693,36,83,81,2,31,5
2419,DN4 - Alfinetada e agulhada,D15,0.138888889,0.014498693,36,83,81,2,31,5
2427,Aposentado,D16,0.290322581,0.013733293,31,101,90,11,22,9
2431,Analgésicos,D16,0.204545455,0.020388783,88,42,40,2,70,18
2433,Dor nas costas,D16,0.208791209,0.010243912,91,37,36,1,72,19
2434,Dor nas pernas,D16,0.345454545,3.72E-07,55,72,71,1,36,19
2435,Retornar_trabalho,D16,0.35,0.00370268,20,99,89,10,13,7
NA.47,NA,NA,NA,NA,NA,NA,NA,NA,NA,NA
2448,D15,D16,0.428571429,0.030825591,7,129,112,17,4,3
2449,D16,D16,1,2.00E-31,20,116,116,0,0,20
2463,D29,D16,0.380952381,2.63E-07,42,94,90,4,26,16
2465,Lombalgia,RMDQ19_v1,0.196721311,0.048791147,61,56,52,4,49,12
2467,D32,D16,0.459459459,3.20E-10,37,99,96,3,20,17
2472,D37,D16,0.818181818,2.79E-22,22,114,112,2,4,18
2474,D39,D16,0.866666667,7.25E-17,15,121,114,7,2,13
2477,D41,D16,0.571428571,0.001133566,7,129,113,16,3,4
2480,D44,D16,0.421052632,1.93E-08,38,98,94,4,22,16
2482,D46,D16,0.421052632,1.93E-08,38,98,94,4,22,16
2484,D48,D16,0.576923077,5.92E-12,26,110,105,5,11,15
2488,D51,D16,1,0.015639469,1,135,116,19,0,1
2491,D9,D16,1,0.015639469,1,135,116,19,0,1
2494,RMDQ3_v1,D16,0.333333333,0.001671446,36,82,74,8,24,12
2496,RMDQ5_v1,D16,0.393939394,5.14E-05,33,85,78,7,20,13
2497,RMDQ6_v1,D16,0.344827586,0.003757757,29,89,79,10,19,10
2510,RMDQ19_v1,D16,0.375,0.01961433,16,101,87,14,10,6
2542,X4,D17,0.333333333,0.005775792,3,133,129,4,2,1
NA.48,NA,NA,NA,NA,NA,NA,NA,NA,NA,NA
2548,D1,D17,1,2.78E-07,1,135,131,4,0,1
2549,D15,D17,0.285714286,0.000325897,7,129,126,3,5,2
2551,D17,D17,1,2.00E-31,5,131,131,0,0,5
2552,D18,D17,0.3125,4.39E-10,16,120,120,0,11,5
2572,D36,D17,0.25,0.000954536,8,128,125,3,6,2
2573,D37,D17,0.136363636,0.006699002,22,114,112,2,19,3
2577,D40,D17,0.4,1.09E-05,5,131,128,3,3,2
2578,D41,D17,0.285714286,0.000325897,7,129,126,3,5,2
2627,Fuma,D18,0.195652174,0.019158686,46,82,77,5,37,9
2635,Dor nas costas,D18,0.164835165,0.032586834,91,37,36,1,76,15
NA.49,NA,NA,NA,NA,NA,NA,NA,NA,NA,NA
2649,D1,D18,1,0.005982535,1,135,120,15,0,1
2652,D17,D18,1,4.39E-10,5,131,120,11,0,5
2653,D18,D18,1,2.00E-31,16,120,120,0,0,16
2654,D19,D18,0.571428571,0.000130178,7,129,117,12,3,4
2655,D2,D18,0.5,0.000540398,8,128,116,12,4,4
2656,D20,D18,0.625,4.41E-06,8,128,117,11,3,5
2657,D21,D18,0.428571429,0.00875177,7,129,116,13,4,3
2658,D22,D18,1,9.55E-05,2,134,120,14,0,2
2669,D32,D18,0.027027027,0.044937956,37,99,84,15,36,1
2677,D4,D18,0.5,0.015989391,4,132,118,14,2,2
2678,D40,D18,0.4,0.045864479,5,131,117,14,3,2
2680,D42,D18,0.666666667,0.002839859,3,133,119,14,1,2
2681,D43,D18,0.666666667,0.002839859,3,133,119,14,1,2
2682,D44,D18,0,0.008009752,38,98,82,16,38,0
2686,D48,D18,0,0.038426101,26,110,94,16,26,0
2694,RMDQ1_v1,D18,0.11627907,0.016715307,43,73,66,7,38,5
2695,RMDQ2_v1,D18,0.170212766,0.002974944,47,69,65,4,39,8
2697,RMDQ4_v1,D18,0.230769231,0.026127422,26,92,85,7,20,6
2722,DN4 - Alfinetada e agulhada,D18,0.166666667,0.032370928,36,83,79,4,30,6
2739,Masc,D19,0.079545455,0.044820788,88,48,48,0,81,7
2740,Fem,D19,0,0.044820788,48,88,81,7,48,0
2744,X4,D19,0.333333333,0.025464867,3,133,127,6,2,1
NA.50,NA,NA,NA,NA,NA,NA,NA,NA,NA,NA
2754,D18,D19,0.25,0.000130178,16,120,117,3,12,4
2755,D19,D19,1,2.00E-31,7,129,129,0,0,7
2756,D2,D19,0.25,0.008804172,8,128,123,5,6,2
2757,D20,D19,0.5,3.25E-09,8,128,125,3,4,4
2758,D21,D19,0.571428571,1.63E-10,7,129,126,3,3,4
2759,D22,D19,1,9.59E-10,2,134,129,5,0,2
2761,D24,D19,0.153846154,0.008615502,26,110,107,3,22,4
2762,D25,D19,0.5,3.77E-05,4,132,127,5,2,2
2763,D26,D19,0.5,0.003826379,2,134,128,6,1,1
2767,D3,D19,1,9.59E-10,2,134,129,5,0,2
2778,D4,D19,0.5,3.77E-05,4,132,127,5,2,2
2781,D42,D19,0.666666667,1.08E-06,3,133,128,5,1,2
2782,D43,D19,0.333333333,0.025464867,3,133,127,6,2,1
2797,RMDQ3_v1,D19,0.111111111,0.048334722,36,82,80,2,32,4
2821,DN4 - Choque elétrico,D19,0.111111111,0.013352924,36,83,82,1,32,4
2828,DN4 - Escovação,D19,0.25,0.034937979,4,115,111,4,3,1
2829,Fuma,D2,0.173913043,9.61E-05,46,82,82,0,38,8
2845,X4,D2,0.666666667,6.05E-06,3,133,127,6,1,2
NA.51,NA,NA,NA,NA,NA,NA,NA,NA,NA,NA
2855,D18,D2,0.25,0.000540398,16,120,116,4,12,4
2856,D19,D2,0.285714286,0.008804172,7,129,123,6,5,2
2857,D2,D2,1,2.00E-31,8,128,128,0,0,8
2868,D3,D2,1,1.21E-08,2,134,128,6,0,2
2873,D34,D2,0.666666667,6.05E-06,3,133,127,6,1,2
2874,D35,D2,0.5,0.007554332,2,134,127,7,1,1
2879,D4,D2,0.75,2.47E-09,4,132,127,5,1,3
2883,D43,D2,0.333333333,0.041013946,3,133,126,7,2,1
2890,D5,D2,1,2.45E-12,3,133,128,5,0,3
2891,D50,D2,0.5,0.007554332,2,134,127,7,1,1
2892,D51,D2,1,5.95E-05,1,135,128,7,0,1
2894,D53,D2,0.5,0.007554332,2,134,127,7,1,1
2895,D9,D2,1,5.95E-05,1,135,128,7,0,1
2902,RMDQ7_v1,D2,0.2,0.010423862,20,97,93,4,16,4
2920,DN4 - Queimação,D2,0.113207547,0.025252758,53,65,64,1,47,6
2922,DN4 - Choque elétrico,D2,0.138888889,0.014498693,36,83,81,2,31,5
2924,DN4 - Alfinetada e agulhada,D2,0.138888889,0.014498693,36,83,81,2,31,5
2926,DN4 - Coceira,D2,0.333333333,0.003361086,6,113,108,5,4,2
2927,DH4 - Hipoestesia ao toque,D2,0.4,0.000924203,5,114,109,5,3,2
2928,DN4 - Hipoestesia a picada de agulha,D2,0.4,0.000924203,5,114,109,5,3,2
2929,DN4 - Escovação,D2,0.5,0.000136371,4,115,110,5,2,2
NA.52,NA,NA,NA,NA,NA,NA,NA,NA,NA,NA
2956,D18,D20,0.3125,4.41E-06,16,120,117,3,11,5
2957,D19,D20,0.571428571,3.25E-09,7,129,125,4,3,4
2959,D20,D20,1,2.00E-31,8,128,128,0,0,8
2960,D21,D20,0.571428571,3.25E-09,7,129,125,4,3,4
2961,D22,D20,1,1.21E-08,2,134,128,6,0,2
2963,D24,D20,0.153846154,0.022039584,26,110,106,4,22,4
2964,D25,D20,0.5,0.000141008,4,132,126,6,2,2
2965,D26,D20,0.5,0.007554332,2,134,127,7,1,1
2983,D42,D20,0.666666667,6.05E-06,3,133,127,6,1,2
2984,D43,D20,0.666666667,6.05E-06,3,133,127,6,1,2
2995,D53,D20,0.5,0.007554332,2,134,127,7,1,1
2997,RMDQ1_v1,D20,0.069767442,0.000296752,43,73,70,3,40,3
2998,RMDQ2_v1,D20,0.085106383,0.00016533,47,69,67,2,43,4
3030,DN4 - Escovação,D20,0.25,0.034937979,4,115,111,4,3,1
3032,Cirurgia na coluna,D21,0,0.03276102,55,63,58,5,55,0
NA.53,NA,NA,NA,NA,NA,NA,NA,NA,NA,NA
3057,D18,D21,0.1875,0.00875177,16,120,116,4,13,3
3058,D19,D21,0.571428571,1.63E-10,7,129,126,3,3,4
3060,D20,D21,0.5,3.25E-09,8,128,125,3,4,4
3061,D21,D21,1,2.00E-31,7,129,129,0,0,7
3062,D22,D21,0.5,0.003826379,2,134,128,6,1,1
3065,D25,D21,0.5,3.77E-05,4,132,127,5,2,2
3066,D26,D21,0.5,0.003826379,2,134,128,6,1,1
3084,D42,D21,0.333333333,0.025464867,3,133,127,6,2,1
3085,D43,D21,0.666666667,1.08E-06,3,133,128,5,1,2
3096,D53,D21,0.5,0.003826379,2,134,128,6,1,1
NA.54,NA,NA,NA,NA,NA,NA,NA,NA,NA,NA
3158,D18,D22,0.125,9.55E-05,16,120,120,0,14,2
3159,D19,D22,0.285714286,9.59E-10,7,129,129,0,5,2
3161,D20,D22,0.25,1.21E-08,8,128,128,0,6,2
3162,D21,D22,0.142857143,0.003826379,7,129,128,1,6,1
3163,D22,D22,1,2.00E-31,2,134,134,0,0,2
3167,D26,D22,0.5,9.25E-09,2,134,133,1,1,1
3185,D42,D22,0.666666667,2.39E-21,3,133,133,0,1,2
3186,D43,D22,0.333333333,3.55E-06,3,133,132,1,2,1
3208,RMDQ10_v1,D22,0.045454545,0.036891632,22,95,95,0,21,1
3209,RMDQ11_v1,D22,0.043478261,0.042324283,23,94,94,0,22,1
3210,RMDQ12_v1,D22,0.045454545,0.036891632,22,95,95,0,21,1
3215,RMDQ17_v1,D22,0.045454545,0.036891632,22,95,95,0,21,1
3216,RMDQ18_v1,D22,0.05,0.026984377,20,97,97,0,19,1
3218,RMDQ20_v1,D22,0.047619048,0.031770515,21,96,96,0,20,1
3219,RMDQ21_v1,D22,0.041666667,0.04804517,24,93,93,0,23,1
3220,RMDQ22_v1,D22,0.05,0.026984377,20,97,97,0,19,1
3221,RMDQ23_v1,D22,0.052631579,0.022556252,19,98,98,0,18,1
3222,RMDQ24_v1,D22,0.052631579,0.022556252,19,98,98,0,18,1
NA.55,NA,NA,NA,NA,NA,NA,NA,NA,NA,NA
NA.56,NA,NA,NA,NA,NA,NA,NA,NA,NA,NA
NA.57,NA,NA,NA,NA,NA,NA,NA,NA,NA,NA
NA.58,NA,NA,NA,NA,NA,NA,NA,NA,NA,NA
NA.59,NA,NA,NA,NA,NA,NA,NA,NA,NA,NA
NA.60,NA,NA,NA,NA,NA,NA,NA,NA,NA,NA
NA.61,NA,NA,NA,NA,NA,NA,NA,NA,NA,NA
NA.62,NA,NA,NA,NA,NA,NA,NA,NA,NA,NA
NA.63,NA,NA,NA,NA,NA,NA,NA,NA,NA,NA
NA.64,NA,NA,NA,NA,NA,NA,NA,NA,NA,NA
NA.65,NA,NA,NA,NA,NA,NA,NA,NA,NA,NA
3265,D23,D23,1,2.00E-31,2,134,134,0,0,2
3267,D25,D23,0.25,7.24E-05,4,132,131,1,3,1
3269,D27,D23,0.2,0.000452967,5,131,130,1,4,1
3270,D28,D23,0.166666667,0.001562412,6,130,129,1,5,1
3289,D45,D23,0.083333333,0.038609547,12,124,123,1,11,1
3291,D47,D23,0.083333333,0.038609547,12,124,123,1,11,1
3353,Livrar_costas,D24,0.290697674,0.01983502,86,14,14,0,61,25
3354,Livrar_perna,D24,0,0.01983502,14,86,61,25,14,0
NA.66,NA,NA,NA,NA,NA,NA,NA,NA,NA,NA
3361,D19,D24,0.571428571,0.008615502,7,129,107,22,3,4
3363,D20,D24,0.5,0.022039584,8,128,106,22,4,4
3367,D24,D24,1,2.00E-31,26,110,110,0,0,26
3368,D25,D24,1,2.97E-05,4,132,110,22,0,4
3389,D44,D24,0.078947368,0.038212143,38,98,75,23,35,3
3395,D5,D24,0.666666667,0.034185079,3,133,109,24,1,2
3406,RMDQ6_v1,D24,0.068965517,0.03837877,29,89,67,22,27,2
3412,RMDQ12_v1,D24,0.045454545,0.039558689,22,95,72,23,21,1
3413,RMDQ13_v1,D24,0.045454545,0.039558689,22,95,72,23,21,1
3417,RMDQ17_v1,D24,0.045454545,0.039558689,22,95,72,23,21,1
3425,DN4 - Queimação,D24,0.113207547,0.027974988,53,65,47,18,47,6
3428,DN4 - Formigamento,D24,0.032258065,0.006261147,31,88,65,23,30,1
3430,DN4 - Adormecimento,D24,0.060606061,0.016353386,33,85,63,22,31,2
3445,Retornar_trabalho,D25,0.15,0.001544314,20,99,98,1,17,3
NA.67,NA,NA,NA,NA,NA,NA,NA,NA,NA,NA
3462,D19,D25,0.285714286,3.77E-05,7,129,127,2,5,2
3464,D20,D25,0.25,0.000141008,8,128,126,2,6,2
3465,D21,D25,0.285714286,3.77E-05,7,129,127,2,5,2
3467,D23,D25,0.5,7.24E-05,2,134,131,3,1,1
3468,D24,D25,0.153846154,2.97E-05,26,110,110,0,22,4
3469,D25,D25,1,2.00E-31,4,132,132,0,0,4
3471,D27,D25,0.2,0.021429625,5,131,128,3,4,1
3472,D28,D25,0.166666667,0.041823155,6,130,127,3,5,1
NA.68,NA,NA,NA,NA,NA,NA,NA,NA,NA,NA
3563,D19,D26,0.142857143,0.003826379,7,129,128,1,6,1
3565,D20,D26,0.125,0.007554332,8,128,127,1,7,1
3566,D21,D26,0.142857143,0.003826379,7,129,128,1,6,1
3567,D22,D26,0.5,9.25E-09,2,134,133,1,1,1
3571,D26,D26,1,2.00E-31,2,134,134,0,0,2
3573,D28,D26,0.166666667,0.001562412,6,130,129,1,5,1
3589,D42,D26,0.333333333,3.55E-06,3,133,132,1,2,1
3590,D43,D26,0.333333333,3.55E-06,3,133,132,1,2,1
3647,Retornar_trabalho,D27,0.15,0.008315517,20,99,97,2,17,3
3651,Solteiro,D27,0.084745763,0.009247013,59,77,77,0,54,5
NA.69,NA,NA,NA,NA,NA,NA,NA,NA,NA,NA
3669,D23,D27,0.5,0.000452967,2,134,130,4,1,1
3671,D25,D27,0.25,0.021429625,4,132,128,4,3,1
3673,D27,D27,1,2.00E-31,5,131,131,0,0,5
3674,D28,D27,0.5,6.95E-10,6,130,128,2,3,3
3711,RMDQ8_v1,D27,0.25,0.015649204,4,113,110,3,3,1
3713,RMDQ10_v1,D27,0.136363636,0.003423706,22,95,94,1,19,3
3714,RMDQ11_v1,D27,0.130434783,0.004597329,23,94,93,1,20,3
3717,RMDQ14_v1,D27,0.12,0.007750056,25,92,91,1,22,3
3721,RMDQ18_v1,D27,0.15,0.001746014,20,97,96,1,17,3
3722,RMDQ19_v1,D27,0.125,0.031432613,16,101,99,2,14,2
3724,RMDQ21_v1,D27,0.125,0.006030785,24,93,92,1,21,3
3732,DN4 - Alfinetada e agulhada,D27,0.111111111,0.002007139,36,83,83,0,32,4
3733,DN4 - Adormecimento,D27,0.090909091,0.032983476,33,85,84,1,30,3
3736,DN4 - Hipoestesia a picada de agulha,D27,0.2,0.034937979,5,114,111,3,4,1
NA.70,NA,NA,NA,NA,NA,NA,NA,NA,NA,NA
3770,D23,D28,0.5,0.001562412,2,134,129,5,1,1
3772,D25,D28,0.25,0.041823155,4,132,127,5,3,1
3773,D26,D28,0.5,0.001562412,2,134,129,5,1,1
3774,D27,D28,0.6,6.95E-10,5,131,128,3,2,3
3775,D28,D28,1,2.00E-31,6,130,130,0,0,6
3779,D31,D28,0.176470588,0.004499593,17,119,116,3,14,3
3792,D43,D28,0.333333333,0.013636157,3,133,128,5,2,1
3803,D53,D28,0.5,0.001562412,2,134,129,5,1,1
3808,RMDQ4_v1,D28,0.115384615,0.03634271,26,92,90,2,23,3
3812,RMDQ8_v1,D28,0.25,0.037027753,4,113,109,4,3,1
3814,RMDQ10_v1,D28,0.136363636,0.015970538,22,95,93,2,19,3
3815,RMDQ11_v1,D28,0.130434783,0.020342296,23,94,92,2,20,3
3818,RMDQ14_v1,D28,0.12,0.031241051,25,92,90,2,22,3
3825,RMDQ21_v1,D28,0.125,0.025421986,24,93,91,2,21,3
3833,DN4 - Alfinetada e agulhada,D28,0.083333333,0.047489344,36,83,82,1,33,3
3834,DN4 - Adormecimento,D28,0.121212121,0.00109209,33,85,85,0,29,4
3837,DN4 - Hipoestesia a picada de agulha,D28,0.2,0.034937979,5,114,111,3,4,1
3845,Analgésicos,D29,0.397727273,0.008426224,88,42,35,7,53,35
3847,Dor nas costas,D29,0.406593407,0.001034627,91,37,33,4,54,37
3848,Dor nas pernas,D29,0.545454545,2.74E-06,55,72,61,11,25,30
NA.71,NA,NA,NA,NA,NA,NA,NA,NA,NA,NA
3863,D16,D29,0.8,2.63E-07,20,116,90,26,4,16
3877,D29,D29,1,2.00E-31,42,94,94,0,0,42
3879,Lombalgia,RMDQ23_v1,0.229508197,0.039939432,61,56,51,5,47,14
3881,D32,D29,0.891891892,2.31E-19,37,99,90,9,4,33
3886,D37,D29,0.772727273,2.69E-07,22,114,89,25,5,17
3888,D39,D29,0.8,1.27E-05,15,121,91,30,3,12
3891,D41,D29,0.857142857,0.001263725,7,129,93,36,1,6
3894,D44,D29,0.815789474,1.61E-15,38,98,87,11,7,31
3896,D46,D29,0.789473684,4.19E-14,38,98,86,12,8,30
3898,D48,D29,0.769230769,1.60E-08,26,110,88,22,6,20
3910,RMDQ5_v1,D29,0.515151515,0.024398893,33,85,60,25,16,17
3945,Aposentado_Invalidez,D3,0.125,0.008993049,8,123,122,1,7,1
3956,X4,D3,0.333333333,3.55E-06,3,133,132,1,2,1
NA.72,NA,NA,NA,NA,NA,NA,NA,NA,NA,NA
3967,D19,D3,0.285714286,9.59E-10,7,129,129,0,5,2
3968,D2,D3,0.25,1.21E-08,8,128,128,0,6,2
3979,D3,D3,1,2.00E-31,2,134,134,0,0,2
3990,D4,D3,0.5,2.74E-16,4,132,132,0,2,2
3998,D47,D3,0.083333333,0.038609547,12,124,123,1,11,1
4033,DN4 - Choque elétrico,D3,0.055555556,0.030339821,36,83,83,0,34,2
4035,DN4 - Alfinetada e agulhada,D3,0.055555556,0.030339821,36,83,83,0,34,2
4037,DN4 - Coceira,D3,0.166666667,0.003384702,6,113,112,1,5,1
4038,DH4 - Hipoestesia ao toque,D3,0.2,0.001130826,5,114,113,1,4,1
4039,DN4 - Hipoestesia a picada de agulha,D3,0.2,0.001130826,5,114,113,1,4,1
4040,DN4 - Escovação,D3,0.25,0.000223631,4,115,114,1,3,1
4043,Aposentado,Lombalgia,0.64516129,0.025232843,31,101,59,42,11,20
4046,Aposentado_Invalidez,Lombalgia,0.875,0.016601391,8,123,69,54,1,7
4047,Analgésicos,Lombalgia,0.602272727,3.44E-05,88,42,33,9,35,53
4049,Dor nas costas,Lombalgia,0.615384615,8.15E-07,91,37,32,5,35,56
4050,Dor nas pernas,Lombalgia,0.727272727,1.12E-06,55,72,51,21,15,40
4051,Retornar_trabalho,Lombalgia,0.85,0.00019374,20,99,60,39,3,17
NA.73,NA,NA,NA,NA,NA,NA,NA,NA,NA,NA
4065,D16,Lombalgia,0.8,0.000820692,20,116,70,46,4,16
4079,D29,Lombalgia,0.928571429,1.38E-13,42,94,71,23,3,39
4081,Lombalgia,D37,0.241935484,0.020124187,62,74,67,7,47,15
4083,D32,Lombalgia,0.918918919,3.40E-11,37,99,71,28,3,34
4084,D33,Lombalgia,0.75,0.032162513,12,124,71,53,3,9
4088,D37,Lombalgia,0.681818182,0.020124187,22,114,67,47,7,15
4090,D39,Lombalgia,0.8,0.004554221,15,121,71,50,3,12
4096,D44,Lombalgia,0.868421053,1.80E-09,38,98,69,29,5,33
4097,D45,Lombalgia,0.833333333,0.005970555,12,124,72,52,2,10
4098,D46,Lombalgia,0.868421053,1.80E-09,38,98,69,29,5,33
4099,D47,Lombalgia,0.75,0.032162513,12,124,71,53,3,9
4100,D48,Lombalgia,0.884615385,1.06E-06,26,110,71,39,3,23
4101,D49,Lombalgia,0.846153846,0.002969643,13,123,72,51,2,11
4110,RMDQ3_v1,Lombalgia,0.666666667,0.041766153,36,82,44,38,12,24
4112,RMDQ5_v1,Lombalgia,0.727272727,0.006220155,33,85,47,38,9,24
4113,RMDQ6_v1,Lombalgia,0.689655172,0.041414317,29,89,47,42,9,20
4126,RMDQ19_v1,Lombalgia,0.75,0.048791147,16,101,52,49,4,12
4130,RMDQ23_v1,Lombalgia,0.736842105,0.039939432,19,98,51,47,5,14
4132,DN4 - Queimação,Lombalgia,0.58490566,0.030217085,53,65,40,25,22,31
4134,DN4 - Choque elétrico,Lombalgia,0.638888889,0.02147444,36,83,49,34,13,23
4137,DN4 - Adormecimento,Lombalgia,0.636363636,0.028312243,33,85,50,35,12,21
NA.74,NA,NA,NA,NA,NA,NA,NA,NA,NA,NA
4165,D15,D31,0.571428571,0.000245367,7,129,116,13,3,4
4179,D28,D31,0.5,0.004499593,6,130,116,14,3,3
4183,D31,D31,1,2.00E-31,17,119,119,0,0,17
4185,D33,D31,0.666666667,2.82E-09,12,124,115,9,4,8
4188,D36,D31,0.375,0.027531894,8,128,114,14,5,3
4190,D38,D31,0.666666667,0.004122296,3,133,118,15,1,2
4193,D40,D31,0.6,0.001066755,5,131,117,14,2,3
4198,D45,D31,0.583333333,4.96E-07,12,124,114,10,5,7
4200,D47,D31,0.666666667,2.82E-09,12,124,115,9,4,8
4202,D49,D31,0.538461538,2.14E-06,13,123,113,10,6,7
4235,DN4 - Choque elétrico,D31,0.305555556,0.000314121,36,83,78,5,25,11
4237,DN4 - Alfinetada e agulhada,D31,0.277777778,0.002541356,36,83,77,6,26,10
4238,DN4 - Adormecimento,D31,0.242424242,0.034680647,33,85,77,8,25,8
4246,Desempregado,D32,0.12,0.042393405,25,105,71,34,22,3
4249,Analgésicos,D32,0.375,0.000946868,88,42,38,4,55,33
4251,Dor nas costas,D32,0.362637363,0.001319126,91,37,34,3,58,33
4252,Dor nas pernas,D32,0.545454545,1.03E-08,55,72,66,6,25,30
NA.75,NA,NA,NA,NA,NA,NA,NA,NA,NA,NA
4267,D16,D32,0.85,3.20E-10,20,116,96,20,3,17
4269,D18,D32,0.0625,0.044937956,16,120,84,36,15,1
4281,D29,D32,0.785714286,2.31E-19,42,94,90,4,9,33
4283,Lombalgia,D16,0.258064516,0.000820692,62,74,70,4,46,16
4285,D32,D32,1,2.00E-31,37,99,99,0,0,37
4290,D37,D32,0.727272727,1.60E-07,22,114,93,21,6,16
4292,D39,D32,0.866666667,4.11E-08,15,121,97,24,2,13
4298,D44,D32,0.842105263,1.38E-20,38,98,93,5,6,32
4300,D46,D32,0.789473684,3.09E-17,38,98,91,7,8,30
4302,D48,D32,0.807692308,8.85E-12,26,110,94,16,5,21
4314,RMDQ5_v1,D32,0.484848485,0.012456296,33,85,64,21,17,16
4328,RMDQ19_v1,D32,0.5625,0.022610031,16,101,73,28,7,9
4353,Dor nas pernas,D33,0.163636364,0.019889661,55,72,69,3,46,9
4363,Livrar_costas,D33,0.093023256,0.039636817,86,14,10,4,78,8
4364,Livrar_perna,D33,0.285714286,0.039636817,14,86,78,8,10,4
NA.76,NA,NA,NA,NA,NA,NA,NA,NA,NA,NA
4384,Lombalgia,Retornar_trabalho,0.303571429,0.00019374,56,63,60,3,39,17
4385,D31,D33,0.470588235,2.82E-09,17,119,115,4,9,8
4387,D33,D33,1,2.00E-31,12,124,124,0,0,12
4392,D38,D33,0.666666667,0.000354465,3,133,123,10,1,2
4395,D40,D33,0.4,0.012270026,5,131,121,10,3,2
4400,D45,D33,0.666666667,1.38E-13,12,124,120,4,4,8
4402,D47,D33,0.583333333,2.41E-10,12,124,119,5,5,7
4404,D49,D33,0.692307692,6.78E-16,13,123,120,3,4,9
4437,DN4 - Choque elétrico,D33,0.194444444,0.025529852,36,83,78,5,29,7
4438,DN4 - Formigamento,D33,0.290322581,4.62E-05,31,88,85,3,22,9
4439,DN4 - Alfinetada e agulhada,D33,0.194444444,0.025529852,36,83,78,5,29,7
4445,Fuma,D34,0.065217391,0.019277409,46,82,82,0,43,3
4448,Desempregado,D34,0.08,0.03492795,25,105,104,1,23,2
4449,Licenca_Medica,D34,0.111111111,0.006780018,18,114,113,1,16,2
NA.77,NA,NA,NA,NA,NA,NA,NA,NA,NA,NA
4468,D15,D34,0.142857143,0.025464867,7,129,127,2,6,1
4473,D2,D34,0.25,6.05E-06,8,128,127,1,6,2
4489,D34,D34,1,2.00E-31,3,133,133,0,0,3
4490,D35,D34,0.5,3.55E-06,2,134,132,2,1,1
4495,D4,D34,0.25,0.001629579,4,132,130,2,3,1
4499,D43,D34,0.333333333,0.000205681,3,133,131,2,2,1
4506,D5,D34,0.666666667,1.51E-14,3,133,132,1,1,2
4507,D50,D34,1,2.39E-21,2,134,133,1,0,2
4508,D51,D34,1,2.34E-11,1,135,133,2,0,1
4509,D52,D34,0.5,3.55E-06,2,134,132,2,1,1
4510,D53,D34,0.5,3.55E-06,2,134,132,2,1,1
4511,D9,D34,1,2.34E-11,1,135,133,2,0,1
4542,DN4 - Coceira,D34,0.166666667,0.023314143,6,113,111,2,5,1
4543,DH4 - Hipoestesia ao toque,D34,0.4,4.71E-08,5,114,113,1,3,2
4544,DN4 - Hipoestesia a picada de agulha,D34,0.4,4.71E-08,5,114,113,1,3,2
4545,DN4 - Escovação,D34,0.5,7.19E-10,4,115,114,1,2,2
4549,Desempregado,D35,0.08,0.003490999,25,105,105,0,23,2
NA.78,NA,NA,NA,NA,NA,NA,NA,NA,NA,NA
4569,D15,D35,0.142857143,0.003826379,7,129,128,1,6,1
4574,D2,D35,0.125,0.007554332,8,128,127,1,7,1
4590,D34,D35,0.333333333,3.55E-06,3,133,132,1,2,1
4591,D35,D35,1,2.00E-31,2,134,134,0,0,2
4596,D4,D35,0.5,2.74E-16,4,132,132,0,2,2
4607,D5,D35,0.333333333,3.55E-06,3,133,132,1,2,1
4609,D51,D35,1,2.11E-16,1,135,134,1,0,1
4612,D9,D35,1,2.11E-16,1,135,134,1,0,1
4619,RMDQ7_v1,D35,0.05,0.026984377,20,97,97,0,19,1
4621,RMDQ9_v1,D35,0.055555556,0.018508014,18,99,99,0,17,1
4622,RMDQ10_v1,D35,0.045454545,0.036891632,22,95,95,0,21,1
4623,RMDQ11_v1,D35,0.043478261,0.042324283,23,94,94,0,22,1
4624,RMDQ12_v1,D35,0.045454545,0.036891632,22,95,95,0,21,1
4625,RMDQ13_v1,D35,0.045454545,0.036891632,22,95,95,0,21,1
4627,RMDQ15_v1,D35,0.066666667,0.008821462,15,102,102,0,14,1
4628,RMDQ16_v1,D35,0.052631579,0.022556252,19,98,98,0,18,1
4629,RMDQ17_v1,D35,0.045454545,0.036891632,22,95,95,0,21,1
4630,RMDQ18_v1,D35,0.05,0.026984377,20,97,97,0,19,1
4631,RMDQ19_v1,D35,0.0625,0.011626735,16,101,101,0,15,1
4632,RMDQ20_v1,D35,0.047619048,0.031770515,21,96,96,0,20,1
4633,RMDQ21_v1,D35,0.041666667,0.04804517,24,93,93,0,23,1
4634,RMDQ22_v1,D35,0.05,0.026984377,20,97,97,0,19,1
4635,RMDQ23_v1,D35,0.052631579,0.022556252,19,98,98,0,18,1
4636,RMDQ24_v1,D35,0.052631579,0.022556252,19,98,98,0,18,1
4643,DN4 - Coceira,D35,0.166666667,1.31E-05,6,113,113,0,5,1
4644,DH4 - Hipoestesia ao toque,D35,0.2,1.63E-06,5,114,114,0,4,1
4645,DN4 - Hipoestesia a picada de agulha,D35,0.2,1.63E-06,5,114,114,0,4,1
4646,DN4 - Escovação,D35,0.25,7.26E-08,4,115,115,0,3,1
4648,Cirurgia na coluna,D36,0.109090909,0.007126089,55,63,63,0,49,6
4651,Licenca_Medica,D36,0.166666667,0.020610881,18,114,110,4,15,3
4663,X4,D36,0.333333333,0.041013946,3,133,126,7,2,1
4666,Livrar_costas,D36,0.046511628,0.022510445,86,14,11,3,82,4
4667,Livrar_perna,D36,0.214285714,0.022510445,14,86,82,4,11,3
NA.79,NA,NA,NA,NA,NA,NA,NA,NA,NA,NA
4670,D15,D36,0.714285714,3.80E-14,7,129,126,3,2,5
4672,D17,D36,0.4,0.000954536,5,131,125,6,3,2
4688,D31,D36,0.176470588,0.027531894,17,119,114,5,14,3
4693,D36,D36,1,2.00E-31,8,128,128,0,0,8
4694,D37,D36,0.227272727,0.000244803,22,114,111,3,17,5
4695,D38,D36,1,2.45E-12,3,133,128,5,0,3
4698,D40,D36,1,7.99E-20,5,131,128,3,0,5
4699,D41,D36,0.571428571,3.25E-09,7,129,125,4,3,4
4705,D47,D36,0.25,0.003202226,12,124,119,5,9,3
4742,DN4 - Alfinetada e agulhada,D36,0.166666667,0.004332247,36,83,81,2,30,6
4750,Aposentado,D37,0.290322581,0.034688805,31,101,88,13,22,9
4752,Licenca_Medica,D37,0.333333333,0.041184163,18,114,98,16,12,6
4757,Dor nas pernas,D37,0.345454545,7.38E-06,55,72,69,3,36,19
4758,Retornar_trabalho,D37,0.35,0.017051652,20,99,86,13,13,7
NA.80,NA,NA,NA,NA,NA,NA,NA,NA,NA,NA
4771,D15,D37,0.571428571,0.002509261,7,129,111,18,3,4
4772,D16,D37,0.9,2.79E-22,20,116,112,4,2,18
4773,D17,D37,0.6,0.006699002,5,131,112,19,2,3
4786,D29,D37,0.404761905,2.69E-07,42,94,89,5,25,17
4788,Lombalgia,Aposentado,0.322580645,0.025232843,62,70,59,11,42,20
4790,D32,D37,0.432432432,1.60E-07,37,99,93,6,21,16
4794,D36,D37,0.625,0.000244803,8,128,111,17,3,5
4795,D37,D37,1,2.00E-31,22,114,114,0,0,22
4797,D39,D37,1,9.03E-21,15,121,114,7,0,15
4799,D40,D37,0.6,0.006699002,5,131,112,19,2,3
4800,D41,D37,1,6.25E-10,7,129,114,15,0,7
4803,D44,D37,0.421052632,3.16E-07,38,98,92,6,22,16
4805,D46,D37,0.447368421,1.78E-08,38,98,93,5,21,17
4807,D48,D37,0.576923077,1.64E-10,26,110,103,7,11,15
4811,D51,D37,1,0.022325957,1,135,114,21,0,1
4814,D9,D37,1,0.022325957,1,135,114,21,0,1
4817,RMDQ3_v1,D37,0.333333333,0.003459096,36,82,73,9,24,12
4819,RMDQ5_v1,D37,0.393939394,0.000132448,33,85,77,8,20,13
4820,RMDQ6_v1,D37,0.344827586,0.006827836,29,89,78,11,19,10
4833,RMDQ19_v1,D37,0.375,0.028282123,16,101,86,15,10,6
4844,DN4 - Adormecimento,D37,0.303030303,0.042743741,33,85,73,12,23,10
4849,Fuma,D38,0.065217391,0.019277409,46,82,82,0,43,3
4857,Dor nas costas,D38,0,0.005982854,91,37,34,3,91,0
4858,Dor nas pernas,D38,0.054545455,0.044902775,55,72,72,0,52,3
4865,X4,D38,0.333333333,0.000205681,3,133,131,2,2,1
4868,Livrar_costas,D38,0,1.31E-05,86,14,11,3,86,0
4869,Livrar_perna,D38,0.214285714,1.31E-05,14,86,86,0,11,3
NA.81,NA,NA,NA,NA,NA,NA,NA,NA,NA,NA
4872,D15,D38,0.285714286,1.08E-06,7,129,128,1,5,2
4890,D31,D38,0.117647059,0.004122296,17,119,118,1,15,2
4892,D33,D38,0.166666667,0.000354465,12,124,123,1,10,2
4895,D36,D38,0.375,2.45E-12,8,128,128,0,5,3
4897,D38,D38,1,2.00E-31,3,133,133,0,0,3
4900,D40,D38,0.6,3.10E-19,5,131,131,0,2,3
4901,D41,D38,0.142857143,0.025464867,7,129,127,2,6,1
4905,D45,D38,0.166666667,0.000354465,12,124,123,1,10,2
4907,D47,D38,0.25,1.80E-08,12,124,124,0,9,3
4909,D49,D38,0.153846154,0.000669323,13,123,122,1,11,2
4944,DN4 - Alfinetada e agulhada,D38,0.083333333,0.007727575,36,83,83,0,33,3
4952,Aposentado,D39,0.225806452,0.024469658,31,101,93,8,24,7
4956,Analgésicos,D39,0.159090909,0.023959532,88,42,41,1,74,14
4959,Dor nas pernas,D39,0.236363636,0.000307451,55,72,70,2,42,13
4960,Retornar_trabalho,D39,0.25,0.043993319,20,99,90,9,15,5
4968,X6,D39,0.3,0.046635117,10,126,114,12,7,3
NA.82,NA,NA,NA,NA,NA,NA,NA,NA,NA,NA
4974,D16,D39,0.65,7.25E-17,20,116,114,2,7,13
4988,D29,D39,0.285714286,1.27E-05,42,94,91,3,30,12
4990,Lombalgia,RMDQ6_v1,0.322580645,0.041414317,62,56,47,9,42,20
4992,D32,D39,0.351351351,4.11E-08,37,99,97,2,24,13
4997,D37,D39,0.681818182,9.03E-21,22,114,114,0,7,15
4999,D39,D39,1,2.00E-31,15,121,121,0,0,15
5002,D41,D39,0.571428571,6.36E-05,7,129,118,11,3,4
5005,D44,D39,0.342105263,7.71E-08,38,98,96,2,25,13
5007,D46,D39,0.394736842,4.28E-11,38,98,98,0,23,15
5009,D48,D39,0.461538462,2.05E-10,26,110,107,3,14,12
5019,RMDQ3_v1,D39,0.277777778,0.000397102,36,82,78,4,26,10
5020,RMDQ4_v1,D39,0.269230769,0.007162535,26,92,85,7,19,7
5021,RMDQ5_v1,D39,0.333333333,7.00E-06,33,85,82,3,22,11
5022,RMDQ6_v1,D39,0.275862069,0.002572071,29,89,83,6,21,8
5051,Fuma,D4,0.086956522,0.006667415,46,82,82,0,42,4
5054,Desempregado,D4,0.12,0.004044351,25,105,104,1,22,3
5067,X4,D4,0.333333333,0.001629579,3,133,130,3,2,1
NA.83,NA,NA,NA,NA,NA,NA,NA,NA,NA,NA
5077,D18,D4,0.125,0.015989391,16,120,118,2,14,2
5078,D19,D4,0.285714286,3.77E-05,7,129,127,2,5,2
5079,D2,D4,0.375,2.47E-09,8,128,127,1,5,3
5090,D3,D4,1,2.74E-16,2,134,132,2,0,2
5095,D34,D4,0.333333333,0.001629579,3,133,130,3,2,1
5096,D35,D4,1,2.74E-16,2,134,132,2,0,2
5101,D4,D4,1,2.00E-31,4,132,132,0,0,4
5112,D5,D4,0.333333333,0.001629579,3,133,130,3,2,1
5114,D51,D4,1,8.13E-09,1,135,132,3,0,1
5117,D9,D4,1,8.13E-09,1,135,132,3,0,1
5124,RMDQ7_v1,D4,0.1,0.020853932,20,97,96,1,18,2
5126,RMDQ9_v1,D4,0.111111111,0.012630829,18,99,98,1,16,2
5127,RMDQ10_v1,D4,0.090909091,0.031603187,22,95,94,1,20,2
5128,RMDQ11_v1,D4,0.086956522,0.037934361,23,94,93,1,21,2
5129,RMDQ12_v1,D4,0.090909091,0.031603187,22,95,94,1,20,2
5130,RMDQ13_v1,D4,0.090909091,0.031603187,22,95,94,1,20,2
5132,RMDQ15_v1,D4,0.133333333,0.004711047,15,102,101,1,13,2
5133,RMDQ16_v1,D4,0.105263158,0.016431718,19,98,97,1,17,2
5134,RMDQ17_v1,D4,0.090909091,0.031603187,22,95,94,1,20,2
5135,RMDQ18_v1,D4,0.1,0.020853932,20,97,96,1,18,2
5136,RMDQ19_v1,D4,0.125,0.00680424,16,101,100,1,14,2
5137,RMDQ20_v1,D4,0.095238095,0.025909421,21,96,95,1,19,2
5138,RMDQ21_v1,D4,0.083333333,0.044897228,24,93,92,1,22,2
5139,RMDQ22_v1,D4,0.1,0.020853932,20,97,96,1,18,2
5140,RMDQ23_v1,D4,0.105263158,0.016431718,19,98,97,1,17,2
5141,RMDQ24_v1,D4,0.105263158,0.016431718,19,98,97,1,17,2
5144,DN4 - Choque elétrico,D4,0.083333333,0.007727575,36,83,83,0,33,3
5146,DN4 - Alfinetada e agulhada,D4,0.083333333,0.007727575,36,83,83,0,33,3
5148,DN4 - Coceira,D4,0.333333333,7.78E-07,6,113,112,1,4,2
5149,DH4 - Hipoestesia ao toque,D4,0.4,4.71E-08,5,114,113,1,3,2
5150,DN4 - Hipoestesia a picada de agulha,D4,0.4,4.71E-08,5,114,113,1,3,2
5151,DN4 - Escovação,D4,0.5,7.19E-10,4,115,114,1,2,2
5152,Fuma,D40,0.086956522,0.006667415,46,82,82,0,42,4
5153,Cirurgia na coluna,D40,0.072727273,0.029424848,55,63,63,0,51,4
5156,Licenca_Medica,D40,0.166666667,0.000281575,18,114,113,1,15,3
5168,X4,D40,0.333333333,0.005775792,3,133,129,4,2,1
5171,Livrar_costas,D40,0.011627907,0.000332607,86,14,11,3,85,1
5172,Livrar_perna,D40,0.214285714,0.000332607,14,86,85,1,11,3
NA.84,NA,NA,NA,NA,NA,NA,NA,NA,NA,NA
5175,D15,D40,0.571428571,1.18E-14,7,129,128,1,3,4
5177,D17,D40,0.4,1.09E-05,5,131,128,3,3,2
5178,D18,D40,0.125,0.045864479,16,120,117,3,14,2
5193,D31,D40,0.176470588,0.001066755,17,119,117,2,14,3
5195,D33,D40,0.166666667,0.012270026,12,124,121,3,10,2
5198,D36,D40,0.625,7.99E-20,8,128,128,0,3,5
5199,D37,D40,0.136363636,0.006699002,22,114,112,2,19,3
5200,D38,D40,1,3.10E-19,3,133,131,2,0,3
5203,D40,D40,1,2.00E-31,5,131,131,0,0,5
5204,D41,D40,0.428571429,1.55E-08,7,129,127,2,4,3
5208,D45,D40,0.166666667,0.012270026,12,124,121,3,10,2
5210,D47,D40,0.25,3.94E-05,12,124,122,2,9,3
5212,D49,D40,0.153846154,0.018333115,13,123,120,3,11,2
5247,DN4 - Alfinetada e agulhada,D40,0.111111111,0.013352924,36,83,82,1,32,4
5257,Licenca_Medica,D41,0.166666667,0.020610881,18,114,110,4,15,3
5262,Dor nas pernas,D41,0.109090909,0.019834506,55,72,71,1,49,6
5264,Masc,D41,0.079545455,0.044820788,88,48,48,0,81,7
5265,Fem,D41,0,0.044820788,48,88,81,7,48,0
NA.85,NA,NA,NA,NA,NA,NA,NA,NA,NA,NA
5276,D15,D41,0.428571429,3.55E-06,7,129,125,4,4,3
5277,D16,D41,0.2,0.001133566,20,116,113,3,16,4
5278,D17,D41,0.4,0.000325897,5,131,126,5,3,2
5291,D29,D41,0.142857143,0.001263725,42,94,93,1,36,6
5299,D36,D41,0.5,3.25E-09,8,128,125,3,4,4
5300,D37,D41,0.318181818,6.25E-10,22,114,114,0,15,7
5301,D38,D41,0.333333333,0.025464867,3,133,127,6,2,1
5302,D39,D41,0.266666667,6.36E-05,15,121,118,3,11,4
5304,D40,D41,0.6,1.55E-08,5,131,127,4,2,3
5305,D41,D41,1,2.00E-31,7,129,129,0,0,7
5310,D46,D41,0.131578947,0.008467934,38,98,96,2,33,5
5312,D48,D41,0.153846154,0.008615502,26,110,107,3,22,4
5348,DN4 - Alfinetada e agulhada,D41,0.138888889,0.014498693,36,83,81,2,31,5
NA.86,NA,NA,NA,NA,NA,NA,NA,NA,NA,NA
5380,D18,D42,0.125,0.002839859,16,120,119,1,14,2
5381,D19,D42,0.285714286,1.08E-06,7,129,128,1,5,2
5383,D20,D42,0.25,6.05E-06,8,128,127,1,6,2
5384,D21,D42,0.142857143,0.025464867,7,129,127,2,6,1
5385,D22,D42,1,2.39E-21,2,134,133,1,0,2
5389,D26,D42,0.5,3.55E-06,2,134,132,2,1,1
5407,D42,D42,1,2.00E-31,3,133,133,0,0,3
5408,D43,D42,0.333333333,0.000205681,3,133,131,2,2,1
5418,D52,D42,0.5,3.55E-06,2,134,132,2,1,1
5432,RMDQ12_v1,D42,0.090909091,0.003034577,22,95,95,0,20,2
5434,RMDQ14_v1,D42,0.08,0.00621115,25,92,92,0,23,2
5468,Casado/Amasiaado,D43,0.054545455,0.033543153,55,81,81,0,52,3
NA.87,NA,NA,NA,NA,NA,NA,NA,NA,NA,NA
5481,D18,D43,0.125,0.002839859,16,120,119,1,14,2
5482,D19,D43,0.142857143,0.025464867,7,129,127,2,6,1
5483,D2,D43,0.125,0.041013946,8,128,126,2,7,1
5484,D20,D43,0.25,6.05E-06,8,128,127,1,6,2
5485,D21,D43,0.285714286,1.08E-06,7,129,128,1,5,2
5486,D22,D43,0.5,3.55E-06,2,134,132,2,1,1
5490,D26,D43,0.5,3.55E-06,2,134,132,2,1,1
5492,D28,D43,0.166666667,0.013636157,6,130,128,2,5,1
5499,D34,D43,0.333333333,0.000205681,3,133,131,2,2,1
5508,D42,D43,0.333333333,0.000205681,3,133,131,2,2,1
5509,D43,D43,1,2.00E-31,3,133,133,0,0,3
5517,D50,D43,0.5,3.55E-06,2,134,132,2,1,1
5519,D52,D43,0.5,3.55E-06,2,134,132,2,1,1
5520,D53,D43,1,2.39E-21,2,134,133,1,0,2
5525,RMDQ4_v1,D43,0.076923077,0.00729467,26,92,92,0,24,2
5527,RMDQ6_v1,D43,0.068965517,0.012463179,29,89,89,0,27,2
5531,RMDQ10_v1,D43,0.090909091,0.003034577,22,95,95,0,20,2
5532,RMDQ11_v1,D43,0.086956522,0.003929589,23,94,94,0,21,2
5533,RMDQ12_v1,D43,0.090909091,0.003034577,22,95,95,0,20,2
5535,RMDQ14_v1,D43,0.08,0.00621115,25,92,92,0,23,2
5541,RMDQ20_v1,D43,0.095238095,0.002289209,21,96,96,0,19,2
5542,RMDQ21_v1,D43,0.083333333,0.004985247,24,93,93,0,22,2
5545,RMDQ24_v1,D43,0.105263158,0.001196854,19,98,98,0,17,2
5547,DN4 - Sensação de frio dolorosa,D43,0.041666667,0.0468674,24,94,94,0,23,1
5553,DH4 - Hipoestesia ao toque,D43,0.2,1.63E-06,5,114,114,0,4,1
5554,DN4 - Hipoestesia a picada de agulha,D43,0.2,1.63E-06,5,114,114,0,4,1
5555,DN4 - Escovação,D43,0.25,7.26E-08,4,115,115,0,3,1
5559,Desempregado,D44,0.12,0.03505672,25,105,70,35,22,3
5562,Analgésicos,D44,0.375,0.002694298,88,42,37,5,55,33
5564,Dor nas costas,D44,0.362637363,0.003980919,91,37,33,4,58,33
5565,Dor nas pernas,D44,0.563636364,3.58E-09,55,72,66,6,24,31
NA.88,NA,NA,NA,NA,NA,NA,NA,NA,NA,NA
5580,D16,D44,0.8,1.93E-08,20,116,94,22,4,16
5582,D18,D44,0,0.008009752,16,120,82,38,16,0
5589,D24,D44,0.115384615,0.038212143,26,110,75,35,23,3
5594,D29,D44,0.738095238,1.61E-15,42,94,87,7,11,31
5596,Lombalgia,D48,0.370967742,1.06E-06,62,74,71,3,39,23
5598,D32,D44,0.864864865,1.38E-20,37,99,93,6,5,32
5603,D37,D44,0.727272727,3.16E-07,22,114,92,22,6,16
5605,D39,D44,0.866666667,7.71E-08,15,121,96,25,2,13
5611,D44,D44,1,2.00E-31,38,98,98,0,0,38
5612,D45,D44,0.583333333,0.014001518,12,124,93,31,5,7
5613,D46,D44,0.894736842,2.32E-23,38,98,94,4,4,34
5615,D48,D44,0.846153846,8.00E-13,26,110,94,16,4,22
5647,DN4 - Queimação,D44,0.41509434,0.031815051,53,65,50,15,31,22
5666,Dor nas pernas,D45,0.218181818,3.11E-05,55,72,72,0,43,12
5671,Solteiro,D45,0.152542373,0.020643483,59,77,74,3,50,9
5676,Livrar_costas,D45,0.093023256,0.039636817,86,14,10,4,78,8
5677,Livrar_perna,D45,0.285714286,0.039636817,14,86,78,8,10,4
NA.89,NA,NA,NA,NA,NA,NA,NA,NA,NA,NA
5689,D23,D45,0.5,0.038609547,2,134,123,11,1,1
5697,Lombalgia,DN4 - Adormecimento,0.375,0.028312243,56,62,50,12,35,21
5698,D31,D45,0.411764706,4.96E-07,17,119,114,5,10,7
5700,D33,D45,0.666666667,1.38E-13,12,124,120,4,4,8
5705,D38,D45,0.666666667,0.000354465,3,133,123,10,1,2
5708,D40,D45,0.4,0.012270026,5,131,121,10,3,2
5712,D44,D45,0.184210526,0.014001518,38,98,93,5,31,7
5713,D45,D45,1,2.00E-31,12,124,124,0,0,12
5714,D46,D45,0.184210526,0.014001518,38,98,93,5,31,7
5715,D47,D45,0.833333333,1.57E-21,12,124,122,2,2,10
5717,D49,D45,0.615384615,1.84E-12,13,123,119,4,5,8
5748,DN4 - Queimação,D45,0.188679245,0.004758539,53,65,63,2,43,10
5750,DN4 - Choque elétrico,D45,0.194444444,0.025529852,36,83,78,5,29,7
5751,DN4 - Formigamento,D45,0.258064516,0.000723216,31,88,84,4,23,8
5752,DN4 - Alfinetada e agulhada,D45,0.222222222,0.003779086,36,83,79,4,28,8
5763,Aposentado_Invalidez,D46,0.625,0.031214413,8,123,90,33,3,5
5764,Analgésicos,D46,0.375,0.002694298,88,42,37,5,55,33
5766,Dor nas costas,D46,0.340659341,0.043438907,91,37,31,6,60,31
5767,Dor nas pernas,D46,0.581818182,3.04E-10,55,72,67,5,23,32
5772,Solteiro,D46,0.186440678,0.034420939,59,77,50,27,48,11
5776,X6,D46,0.6,0.018910781,10,126,94,32,4,6
5777,Livrar_costas,D46,0.313953488,0.017425222,86,14,5,9,59,27
5778,Livrar_perna,D46,0.642857143,0.017425222,14,86,59,27,5,9
NA.90,NA,NA,NA,NA,NA,NA,NA,NA,NA,NA
5782,D16,D46,0.8,1.93E-08,20,116,94,22,4,16
5796,D29,D46,0.714285714,4.19E-14,42,94,86,8,12,30
5798,Lombalgia,RMDQ3_v1,0.387096774,0.041766153,62,56,44,12,38,24
5800,D32,D46,0.810810811,3.09E-17,37,99,91,8,7,30
5805,D37,D46,0.772727273,1.78E-08,22,114,93,21,5,17
5807,D39,D46,1,4.28E-11,15,121,98,23,0,15
5810,D41,D46,0.714285714,0.008467934,7,129,96,33,2,5
5813,D44,D46,0.894736842,2.32E-23,38,98,94,4,4,34
5814,D45,D46,0.583333333,0.014001518,12,124,93,31,5,7
5815,D46,D46,1,2.00E-31,38,98,98,0,0,38
5816,D47,D46,0.666666667,0.001742243,12,124,94,30,4,8
5817,D48,D46,0.923076923,4.19E-16,26,110,96,14,2,24
5818,D49,D46,0.538461538,0.028611459,13,123,92,31,6,7
5829,RMDQ5_v1,D46,0.484848485,0.012456296,33,85,64,21,17,16
5849,DN4 - Queimação,D46,0.433962264,0.010907577,53,65,51,14,30,23
5868,Dor nas pernas,D47,0.218181818,3.11E-05,55,72,72,0,43,12
5878,Livrar_costas,D47,0.081395349,0.003236093,86,14,9,5,79,7
5879,Livrar_perna,D47,0.357142857,0.003236093,14,86,79,7,9,5
NA.91,NA,NA,NA,NA,NA,NA,NA,NA,NA,NA
5882,D15,D47,0.428571429,0.001115552,7,129,120,9,4,3
5891,D23,D47,0.5,0.038609547,2,134,123,11,1,1
5898,D3,D47,0.5,0.038609547,2,134,123,11,1,1
5899,Lombalgia,RMDQ5_v1,0.387096774,0.006220155,62,56,47,9,38,24
5900,D31,D47,0.470588235,2.82E-09,17,119,115,4,9,8
5902,D33,D47,0.583333333,2.41E-10,12,124,119,5,5,7
5905,D36,D47,0.375,0.003202226,8,128,119,9,5,3
5907,D38,D47,1,1.80E-08,3,133,124,9,0,3
5910,D40,D47,0.6,3.94E-05,5,131,122,9,2,3
5915,D45,D47,0.833333333,1.57E-21,12,124,122,2,2,10
5916,D46,D47,0.210526316,0.001742243,38,98,94,4,30,8
5917,D47,D47,1,2.00E-31,12,124,124,0,0,12
5919,D49,D47,0.692307692,6.78E-16,13,123,120,3,4,9
5950,DN4 - Queimação,D47,0.188679245,0.004758539,53,65,63,2,43,10
5952,DN4 - Choque elétrico,D47,0.25,0.000372577,36,83,80,3,27,9
5953,DN4 - Formigamento,D47,0.258064516,0.000723216,31,88,84,4,23,8
5954,DN4 - Alfinetada e agulhada,D47,0.25,0.000372577,36,83,80,3,27,9
5962,Aposentado,D48,0.322580645,0.044395495,31,101,85,16,21,10
5966,Analgésicos,D48,0.25,0.039113011,88,42,38,4,66,22
5969,Dor nas pernas,D48,0.418181818,4.19E-08,55,72,70,2,32,23
5970,Retornar_trabalho,D48,0.45,0.001433906,20,99,85,14,11,9
5978,X6,D48,0.5,0.009874806,10,126,105,21,5,5
NA.92,NA,NA,NA,NA,NA,NA,NA,NA,NA,NA
5984,D16,D48,0.75,5.92E-12,20,116,105,11,5,15
5986,D18,D48,0,0.038426101,16,120,94,26,16,0
5998,D29,D48,0.476190476,1.60E-08,42,94,88,6,22,20
6000,Lombalgia,DN4 - Choque elétrico,0.403508772,0.02147444,57,62,49,13,34,23
6002,D32,D48,0.567567568,8.85E-12,37,99,94,5,16,21
6007,D37,D48,0.681818182,1.64E-10,22,114,103,11,7,15
6009,D39,D48,0.8,2.05E-10,15,121,107,14,3,12
6012,D41,D48,0.571428571,0.008615502,7,129,107,22,3,4
6015,D44,D48,0.578947368,8.00E-13,38,98,94,4,16,22
6017,D46,D48,0.631578947,4.19E-16,38,98,96,2,14,24
6019,D48,D48,1,2.00E-31,26,110,110,0,0,26
6031,RMDQ5_v1,D48,0.363636364,0.019280311,33,85,71,14,21,12
6054,DN4 - Formigamento,D48,0.387096774,0.004902155,31,88,75,13,19,12
6070,Dor nas pernas,D49,0.181818182,0.009828559,55,72,69,3,45,10
NA.93,NA,NA,NA,NA,NA,NA,NA,NA,NA,NA
6101,Lombalgia,D44,0.532258065,1.80E-09,62,74,69,5,29,33
6102,D31,D49,0.411764706,2.14E-06,17,119,113,6,10,7
6104,D33,D49,0.75,6.78E-16,12,124,120,4,3,9
6109,D38,D49,0.666666667,0.000669323,3,133,122,11,1,2
6112,D40,D49,0.4,0.018333115,5,131,120,11,3,2
6117,D45,D49,0.666666667,1.84E-12,12,124,119,5,4,8
6118,D46,D49,0.184210526,0.028611459,38,98,92,6,31,7
6119,D47,D49,0.75,6.78E-16,12,124,120,4,3,9
6121,D49,D49,1,2.00E-31,13,123,123,0,0,13
6131,RMDQ4_v1,D49,0,0.042159773,26,92,79,13,26,0
6154,DN4 - Choque elétrico,D49,0.222222222,0.009268729,36,83,78,5,28,8
6155,DN4 - Formigamento,D49,0.322580645,9.51E-06,31,88,85,3,21,10
6156,DN4 - Alfinetada e agulhada,D49,0.222222222,0.009268729,36,83,78,5,28,8
6162,Fuma,D5,0.065217391,0.019277409,46,82,82,0,43,3
6165,Desempregado,D5,0.08,0.03492795,25,105,104,1,23,2
6166,Licenca_Medica,D5,0.111111111,0.006780018,18,114,113,1,16,2
NA.94,NA,NA,NA,NA,NA,NA,NA,NA,NA,NA
6185,D15,D5,0.142857143,0.025464867,7,129,127,2,6,1
6190,D2,D5,0.375,2.45E-12,8,128,128,0,5,3
6195,D24,D5,0.076923077,0.034185079,26,110,109,1,24,2
6206,D34,D5,0.666666667,1.51E-14,3,133,132,1,1,2
6207,D35,D5,0.5,3.55E-06,2,134,132,2,1,1
6212,D4,D5,0.25,0.001629579,4,132,130,2,3,1
6223,D5,D5,1,2.00E-31,3,133,133,0,0,3
6224,D50,D5,0.5,3.55E-06,2,134,132,2,1,1
6225,D51,D5,1,2.34E-11,1,135,133,2,0,1
6228,D9,D5,1,2.34E-11,1,135,133,2,0,1
6235,RMDQ7_v1,D5,0.1,0.020853932,20,97,96,1,18,2
6236,RMDQ8_v1,D5,0.25,0.003868582,4,113,111,2,3,1
6259,DN4 - Coceira,D5,0.166666667,0.023314143,6,113,111,2,5,1
6260,DH4 - Hipoestesia ao toque,D5,0.2,0.010856066,5,114,112,2,4,1
6261,DN4 - Hipoestesia a picada de agulha,D5,0.2,0.010856066,5,114,112,2,4,1
6262,DN4 - Escovação,D5,0.25,0.00353018,4,115,113,2,3,1
NA.95,NA,NA,NA,NA,NA,NA,NA,NA,NA,NA
6291,D2,D50,0.125,0.007554332,8,128,127,1,7,1
6307,D34,D50,0.666666667,2.39E-21,3,133,133,0,1,2
6317,D43,D50,0.333333333,3.55E-06,3,133,132,1,2,1
6324,D5,D50,0.333333333,3.55E-06,3,133,132,1,2,1
6325,D50,D50,1,2.00E-31,2,134,134,0,0,2
6327,D52,D50,0.5,9.25E-09,2,134,133,1,1,1
6328,D53,D50,0.5,9.25E-09,2,134,133,1,1,1
6361,DH4 - Hipoestesia ao toque,D50,0.2,0.001130826,5,114,113,1,4,1
6362,DN4 - Hipoestesia a picada de agulha,D50,0.2,0.001130826,5,114,113,1,4,1
6363,DN4 - Escovação,D50,0.25,0.000223631,4,115,114,1,3,1
6367,Desempregado,D51,0.04,0.039655629,25,105,105,0,24,1
6368,Licenca_Medica,D51,0.055555556,0.011530428,18,114,114,0,17,1
NA.96,NA,NA,NA,NA,NA,NA,NA,NA,NA,NA
6387,D15,D51,0.142857143,1.64E-05,7,129,129,0,6,1
6388,D16,D51,0.05,0.015639469,20,116,116,0,19,1
6392,D2,D51,0.125,5.95E-05,8,128,128,0,7,1
6408,D34,D51,0.333333333,2.34E-11,3,133,133,0,2,1
6409,D35,D51,0.5,2.11E-16,2,134,134,0,1,1
6411,D37,D51,0.045454545,0.022325957,22,114,114,0,21,1
6414,D4,D51,0.25,8.13E-09,4,132,132,0,3,1
6425,D5,D51,0.333333333,2.34E-11,3,133,133,0,2,1
6427,D51,D51,1,2.00E-31,1,135,135,0,0,1
6430,D9,D51,1,2.00E-31,1,135,135,0,0,1
6437,RMDQ7_v1,D51,0.05,0.026984377,20,97,97,0,19,1
6439,RMDQ9_v1,D51,0.055555556,0.018508014,18,99,99,0,17,1
6440,RMDQ10_v1,D51,0.045454545,0.036891632,22,95,95,0,21,1
6441,RMDQ11_v1,D51,0.043478261,0.042324283,23,94,94,0,22,1
6442,RMDQ12_v1,D51,0.045454545,0.036891632,22,95,95,0,21,1
6443,RMDQ13_v1,D51,0.045454545,0.036891632,22,95,95,0,21,1
6445,RMDQ15_v1,D51,0.066666667,0.008821462,15,102,102,0,14,1
6446,RMDQ16_v1,D51,0.052631579,0.022556252,19,98,98,0,18,1
6447,RMDQ17_v1,D51,0.045454545,0.036891632,22,95,95,0,21,1
6448,RMDQ18_v1,D51,0.05,0.026984377,20,97,97,0,19,1
6449,RMDQ19_v1,D51,0.0625,0.011626735,16,101,101,0,15,1
6450,RMDQ20_v1,D51,0.047619048,0.031770515,21,96,96,0,20,1
6451,RMDQ21_v1,D51,0.041666667,0.04804517,24,93,93,0,23,1
6452,RMDQ22_v1,D51,0.05,0.026984377,20,97,97,0,19,1
6453,RMDQ23_v1,D51,0.052631579,0.022556252,19,98,98,0,18,1
6454,RMDQ24_v1,D51,0.052631579,0.022556252,19,98,98,0,18,1
6461,DN4 - Coceira,D51,0.166666667,1.31E-05,6,113,113,0,5,1
6462,DH4 - Hipoestesia ao toque,D51,0.2,1.63E-06,5,114,114,0,4,1
6463,DN4 - Hipoestesia a picada de agulha,D51,0.2,1.63E-06,5,114,114,0,4,1
6464,DN4 - Escovação,D51,0.25,7.26E-08,4,115,115,0,3,1
NA.97,NA,NA,NA,NA,NA,NA,NA,NA,NA,NA
6509,D34,D52,0.333333333,3.55E-06,3,133,132,1,2,1
6518,D42,D52,0.333333333,3.55E-06,3,133,132,1,2,1
6519,D43,D52,0.333333333,3.55E-06,3,133,132,1,2,1
6527,D50,D52,0.5,9.25E-09,2,134,133,1,1,1
6529,D52,D52,1,2.00E-31,2,134,134,0,0,2
6530,D53,D52,0.5,9.25E-09,2,134,133,1,1,1
6538,RMDQ7_v1,D52,0.05,0.026984377,20,97,97,0,19,1
6543,RMDQ12_v1,D52,0.045454545,0.036891632,22,95,95,0,21,1
6563,DH4 - Hipoestesia ao toque,D52,0.2,0.001130826,5,114,113,1,4,1
6564,DN4 - Hipoestesia a picada de agulha,D52,0.2,0.001130826,5,114,113,1,4,1
6565,DN4 - Escovação,D52,0.25,0.000223631,4,115,114,1,3,1
NA.98,NA,NA,NA,NA,NA,NA,NA,NA,NA,NA
6594,D2,D53,0.125,0.007554332,8,128,127,1,7,1
6595,D20,D53,0.125,0.007554332,8,128,127,1,7,1
6596,D21,D53,0.142857143,0.003826379,7,129,128,1,6,1
6603,D28,D53,0.166666667,0.001562412,6,130,129,1,5,1
6610,D34,D53,0.333333333,3.55E-06,3,133,132,1,2,1
6620,D43,D53,0.666666667,2.39E-21,3,133,133,0,1,2
6628,D50,D53,0.5,9.25E-09,2,134,133,1,1,1
6630,D52,D53,0.5,9.25E-09,2,134,133,1,1,1
6631,D53,D53,1,2.00E-31,2,134,134,0,0,2
6639,RMDQ7_v1,D53,0.05,0.026984377,20,97,97,0,19,1
6641,RMDQ9_v1,D53,0.055555556,0.018508014,18,99,99,0,17,1
6642,RMDQ10_v1,D53,0.045454545,0.036891632,22,95,95,0,21,1
6643,RMDQ11_v1,D53,0.043478261,0.042324283,23,94,94,0,22,1
6644,RMDQ12_v1,D53,0.045454545,0.036891632,22,95,95,0,21,1
6645,RMDQ13_v1,D53,0.045454545,0.036891632,22,95,95,0,21,1
6648,RMDQ16_v1,D53,0.052631579,0.022556252,19,98,98,0,18,1
6652,RMDQ20_v1,D53,0.047619048,0.031770515,21,96,96,0,20,1
6653,RMDQ21_v1,D53,0.041666667,0.04804517,24,93,93,0,23,1
6656,RMDQ24_v1,D53,0.052631579,0.022556252,19,98,98,0,18,1
6658,DN4 - Sensação de frio dolorosa,D53,0.041666667,0.0468674,24,94,94,0,23,1
6664,DH4 - Hipoestesia ao toque,D53,0.2,1.63E-06,5,114,114,0,4,1
6665,DN4 - Hipoestesia a picada de agulha,D53,0.2,1.63E-06,5,114,114,0,4,1
6666,DN4 - Escovação,D53,0.25,7.26E-08,4,115,115,0,3,1
6670,Desempregado,D9,0.04,0.039655629,25,105,105,0,24,1
6671,Licenca_Medica,D9,0.055555556,0.011530428,18,114,114,0,17,1
NA.99,NA,NA,NA,NA,NA,NA,NA,NA,NA,NA
6690,D15,D9,0.142857143,1.64E-05,7,129,129,0,6,1
6691,D16,D9,0.05,0.015639469,20,116,116,0,19,1
6695,D2,D9,0.125,5.95E-05,8,128,128,0,7,1
6711,D34,D9,0.333333333,2.34E-11,3,133,133,0,2,1
6712,D35,D9,0.5,2.11E-16,2,134,134,0,1,1
6714,D37,D9,0.045454545,0.022325957,22,114,114,0,21,1
6717,D4,D9,0.25,8.13E-09,4,132,132,0,3,1
6728,D5,D9,0.333333333,2.34E-11,3,133,133,0,2,1
6730,D51,D9,1,2.00E-31,1,135,135,0,0,1
6733,D9,D9,1,2.00E-31,1,135,135,0,0,1
6740,RMDQ7_v1,D9,0.05,0.026984377,20,97,97,0,19,1
6742,RMDQ9_v1,D9,0.055555556,0.018508014,18,99,99,0,17,1
6743,RMDQ10_v1,D9,0.045454545,0.036891632,22,95,95,0,21,1
6744,RMDQ11_v1,D9,0.043478261,0.042324283,23,94,94,0,22,1
6745,RMDQ12_v1,D9,0.045454545,0.036891632,22,95,95,0,21,1
6746,RMDQ13_v1,D9,0.045454545,0.036891632,22,95,95,0,21,1
6748,RMDQ15_v1,D9,0.066666667,0.008821462,15,102,102,0,14,1
6749,RMDQ16_v1,D9,0.052631579,0.022556252,19,98,98,0,18,1
6750,RMDQ17_v1,D9,0.045454545,0.036891632,22,95,95,0,21,1
6751,RMDQ18_v1,D9,0.05,0.026984377,20,97,97,0,19,1
6752,RMDQ19_v1,D9,0.0625,0.011626735,16,101,101,0,15,1
6753,RMDQ20_v1,D9,0.047619048,0.031770515,21,96,96,0,20,1
6754,RMDQ21_v1,D9,0.041666667,0.04804517,24,93,93,0,23,1
6755,RMDQ22_v1,D9,0.05,0.026984377,20,97,97,0,19,1
6756,RMDQ23_v1,D9,0.052631579,0.022556252,19,98,98,0,18,1
6757,RMDQ24_v1,D9,0.052631579,0.022556252,19,98,98,0,18,1
6764,DN4 - Coceira,D9,0.166666667,1.31E-05,6,113,113,0,5,1
6765,DH4 - Hipoestesia ao toque,D9,0.2,1.63E-06,5,114,114,0,4,1
6766,DN4 - Hipoestesia a picada de agulha,D9,0.2,1.63E-06,5,114,114,0,4,1
6767,DN4 - Escovação,D9,0.25,7.26E-08,4,115,115,0,3,1
6794,D18,RMDQ1_v1,0.384615385,0.016715307,12,104,66,38,7,5
6797,D20,RMDQ1_v1,0.428571429,0.000296752,6,110,70,40,3,3
6835,RMDQ1_v1,RMDQ1_v1,1,6.30E-94,85,134,134,0,0,85
6836,RMDQ2_v1,RMDQ1_v1,0.922222222,3.17E-86,90,129,127,2,7,83
6837,RMDQ3_v1,RMDQ1_v1,0.607594937,8.14E-07,78,141,104,37,30,48
6838,RMDQ4_v1,RMDQ1_v1,0.5,0.024980332,53,166,108,58,26,27
6839,RMDQ5_v1,RMDQ1_v1,0.625,2.39E-06,72,147,107,40,27,45
6840,RMDQ6_v1,RMDQ1_v1,0.535714286,0.026455748,56,163,108,55,26,30
6841,RMDQ7_v1,RMDQ1_v1,0.846153846,6.58E-10,39,180,128,52,6,33
6843,RMDQ9_v1,RMDQ1_v1,0.911764706,6.79E-11,34,185,131,54,3,31
6844,RMDQ10_v1,RMDQ1_v1,0.75,1.18E-06,40,179,124,55,10,30
6845,RMDQ11_v1,RMDQ1_v1,0.714285714,7.52E-06,42,177,122,55,12,30
6846,RMDQ12_v1,RMDQ1_v1,0.75,2.14E-07,44,175,123,52,11,33
6847,RMDQ13_v1,RMDQ1_v1,0.717391304,1.41E-06,46,173,121,52,13,33
6848,RMDQ14_v1,RMDQ1_v1,0.836734694,1.92E-12,49,170,126,44,8,41
6849,RMDQ15_v1,RMDQ1_v1,0.935483871,1.08E-10,31,188,132,56,2,29
6850,RMDQ16_v1,RMDQ1_v1,0.810810811,4.53E-08,37,182,127,55,7,30
6851,RMDQ17_v1,RMDQ1_v1,0.714285714,5.99E-07,49,170,120,50,14,35
6852,RMDQ18_v1,RMDQ1_v1,0.777777778,9.01E-07,36,183,126,57,8,28
6853,RMDQ19_v1,RMDQ1_v1,0.875,6.45E-09,32,187,130,57,4,28
6854,RMDQ20_v1,RMDQ1_v1,0.815789474,1.73E-08,38,181,127,54,7,31
6855,RMDQ21_v1,RMDQ1_v1,0.854166667,4.91E-13,48,171,127,44,7,41
6856,RMDQ22_v1,RMDQ1_v1,0.763157895,1.05E-06,38,181,125,56,9,29
6857,RMDQ23_v1,RMDQ1_v1,0.783783784,3.63E-07,37,182,126,56,8,29
6858,RMDQ24_v1,RMDQ1_v1,0.857142857,3.54E-09,35,184,129,55,5,30
6860,DN4 - Sensação de frio dolorosa,RMDQ1_v1,0.234042553,0.036360777,47,160,90,70,36,11
6864,DN4 - Adormecimento,RMDQ1_v1,0.525423729,0.008152081,58,150,100,50,27,31
6895,D18,RMDQ2_v1,0.615384615,0.002974944,12,104,65,39,4,8
6898,D20,RMDQ2_v1,0.571428571,0.00016533,6,110,67,43,2,4
6936,RMDQ1_v1,RMDQ2_v1,0.976470588,3.17E-86,85,134,127,7,2,83
6937,RMDQ2_v1,RMDQ2_v1,1,6.30E-94,90,129,129,0,0,90
6938,RMDQ3_v1,RMDQ2_v1,0.670886076,6.35E-09,78,141,104,37,25,53
6939,RMDQ4_v1,RMDQ2_v1,0.574074074,0.002816443,53,166,107,59,22,31
6940,RMDQ5_v1,RMDQ2_v1,0.680555556,7.66E-08,72,147,106,41,23,49
6941,RMDQ6_v1,RMDQ2_v1,0.553571429,0.035376337,56,163,104,59,25,31
6942,RMDQ7_v1,RMDQ2_v1,0.897435897,6.98E-11,39,180,125,55,4,35
6944,RMDQ9_v1,RMDQ2_v1,0.882352941,8.08E-09,34,185,125,60,4,30
6945,RMDQ10_v1,RMDQ2_v1,0.825,2.51E-08,40,179,122,57,7,33
6946,RMDQ11_v1,RMDQ2_v1,0.785714286,2.39E-07,42,177,120,57,9,33
6947,RMDQ12_v1,RMDQ2_v1,0.772727273,2.88E-07,44,175,119,56,10,34
6948,RMDQ13_v1,RMDQ2_v1,0.695652174,4.95E-05,46,173,115,58,14,32
6949,RMDQ14_v1,RMDQ2_v1,0.918367347,2.05E-15,49,170,125,45,4,45
6950,RMDQ15_v1,RMDQ2_v1,0.935483871,1.04E-09,31,188,127,61,2,29
6951,RMDQ16_v1,RMDQ2_v1,0.810810811,3.53E-07,37,182,122,60,7,30
6952,RMDQ17_v1,RMDQ2_v1,0.755102041,1.62E-07,49,170,117,53,12,37
6953,RMDQ18_v1,RMDQ2_v1,0.888888889,1.25E-09,36,183,125,58,4,32
6954,RMDQ19_v1,RMDQ2_v1,0.84375,4.39E-07,32,187,124,63,5,27
6955,RMDQ20_v1,RMDQ2_v1,0.842105263,1.82E-08,38,181,123,58,6,32
6956,RMDQ21_v1,RMDQ2_v1,0.916666667,6.17E-15,48,171,125,46,4,44
6957,RMDQ22_v1,RMDQ2_v1,0.789473684,1.06E-06,38,181,121,60,8,30
6958,RMDQ23_v1,RMDQ2_v1,0.810810811,3.53E-07,37,182,122,60,7,30
6959,RMDQ24_v1,RMDQ2_v1,0.885714286,3.20E-09,35,184,125,59,4,31
6961,DN4 - Sensação de frio dolorosa,RMDQ2_v1,0.234042553,0.030275437,47,160,89,71,36,11
6965,DN4 - Adormecimento,RMDQ2_v1,0.508474576,0.022231549,58,150,98,52,28,30
6976,Analgésicos,RMDQ3_v1,0.415492958,0.006358286,142,57,45,12,83,59
6994,D16,RMDQ3_v1,0.6,0.001671446,20,98,74,24,8,12
6997,D19,RMDQ3_v1,0.666666667,0.048334722,6,112,80,32,2,4
7010,Lombalgia,D46,0.532258065,1.80E-09,62,74,69,5,29,33
7017,D37,RMDQ3_v1,0.571428571,0.003459096,21,97,73,24,9,12
7019,D39,RMDQ3_v1,0.714285714,0.000397102,14,104,78,26,4,10
7037,RMDQ1_v1,RMDQ3_v1,0.564705882,8.14E-07,85,134,104,30,37,48
7038,RMDQ2_v1,RMDQ3_v1,0.588888889,6.35E-09,90,129,104,25,37,53
7039,RMDQ3_v1,RMDQ3_v1,1,5.47E-50,80,141,141,0,0,80
7040,RMDQ4_v1,RMDQ3_v1,0.945454545,2.78E-25,55,166,138,28,3,52
7041,RMDQ5_v1,RMDQ3_v1,0.98630137,6.61E-42,73,148,140,8,1,72
7042,RMDQ6_v1,RMDQ3_v1,0.929824561,3.95E-25,57,164,137,27,4,53
7043,RMDQ7_v1,RMDQ3_v1,0.871794872,1.86E-13,39,181,136,45,5,34
7044,RMDQ8_v1,RMDQ3_v1,1,0.000118444,8,212,141,71,0,8
7045,RMDQ9_v1,RMDQ3_v1,0.941176471,1.42E-14,34,186,139,47,2,32
7046,RMDQ10_v1,RMDQ3_v1,0.825,1.12E-11,40,180,134,46,7,33
7047,RMDQ11_v1,RMDQ3_v1,0.880952381,4.59E-15,42,178,136,42,5,37
7048,RMDQ12_v1,RMDQ3_v1,0.840909091,9.45E-14,44,176,134,42,7,37
7049,RMDQ13_v1,RMDQ3_v1,0.826086957,1.14E-13,46,174,133,41,8,38
7050,RMDQ14_v1,RMDQ3_v1,0.755102041,5.59E-11,49,171,129,42,12,37
7051,RMDQ15_v1,RMDQ3_v1,0.870967742,1.46E-10,31,189,137,52,4,27
7052,RMDQ16_v1,RMDQ3_v1,0.864864865,2.04E-12,37,183,136,47,5,32
7053,RMDQ17_v1,RMDQ3_v1,0.836734694,2.67E-15,49,171,133,38,8,41
7054,RMDQ18_v1,RMDQ3_v1,0.916666667,2.43E-14,36,184,138,46,3,33
7055,RMDQ19_v1,RMDQ3_v1,0.9375,1.61E-13,32,188,139,49,2,30
7056,RMDQ20_v1,RMDQ3_v1,0.868421053,6.22E-13,38,182,136,46,5,33
7057,RMDQ21_v1,RMDQ3_v1,0.854166667,6.16E-16,48,172,134,38,7,41
7058,RMDQ22_v1,RMDQ3_v1,0.973684211,3.86E-18,38,182,140,42,1,37
7059,RMDQ23_v1,RMDQ3_v1,0.891891892,1.29E-13,37,183,137,46,4,33
7060,RMDQ24_v1,RMDQ3_v1,0.942857143,4.14E-15,35,185,139,46,2,33
7062,DN4 - Sensação de frio dolorosa,RMDQ3_v1,0.489361702,0.014995913,47,161,113,48,24,23
7068,DH4 - Hipoestesia ao toque,RMDQ3_v1,0.714285714,0.042495037,7,205,135,70,2,5
7073,Aposentado,RMDQ4_v1,0.411764706,0.042074684,34,150,114,36,20,14
7081,Retornar_trabalho,RMDQ4_v1,0.45,0.041278471,20,168,128,40,11,9
7090,Livrar_costas,RMDQ4_v1,0.296296296,0.048280755,108,16,15,1,76,32
7097,D18,RMDQ4_v1,0.461538462,0.026127422,13,105,85,20,7,6
7108,D28,RMDQ4_v1,0.6,0.03634271,5,113,90,23,2,3
7120,D39,RMDQ4_v1,0.5,0.007162535,14,104,85,19,7,7
7125,D43,RMDQ4_v1,1,0.00729467,2,116,92,24,0,2
7131,D49,RMDQ4_v1,0,0.042159773,13,105,79,26,13,0
7138,RMDQ1_v1,RMDQ4_v1,0.317647059,0.024980332,85,134,108,26,58,27
7139,RMDQ2_v1,RMDQ4_v1,0.344444444,0.002816443,90,129,107,22,59,31
7140,RMDQ3_v1,RMDQ4_v1,0.65,2.78E-25,80,141,138,3,28,52
7141,RMDQ4_v1,RMDQ4_v1,1,5.47E-50,55,166,166,0,0,55
7142,RMDQ5_v1,RMDQ4_v1,0.643835616,1.46E-21,73,148,140,8,26,47
7143,RMDQ6_v1,RMDQ4_v1,0.561403509,2.37E-10,57,164,141,23,25,32
7145,RMDQ8_v1,RMDQ4_v1,0.875,2.50E-05,8,212,165,47,1,7
7148,RMDQ11_v1,RMDQ4_v1,0.428571429,0.002171792,42,178,142,36,24,18
7149,RMDQ12_v1,RMDQ4_v1,0.363636364,0.04169107,44,176,138,38,28,16
7150,RMDQ13_v1,RMDQ4_v1,0.369565217,0.027852265,46,174,137,37,29,17
7151,RMDQ14_v1,RMDQ4_v1,0.367346939,0.024522305,49,171,135,36,31,18
7154,RMDQ17_v1,RMDQ4_v1,0.387755102,0.008655614,49,171,136,35,30,19
7158,RMDQ21_v1,RMDQ4_v1,0.458333333,0.000106234,48,172,140,32,26,22
7159,RMDQ22_v1,RMDQ4_v1,0.394736842,0.018724428,38,182,143,39,23,15
7163,DN4 - Sensação de frio dolorosa,RMDQ4_v1,0.361702128,0.00286381,47,161,135,26,30,17
7178,Analgésicos,RMDQ5_v1,0.387323944,0.003959426,142,57,47,10,87,55
7182,Retornar_trabalho,RMDQ5_v1,0.6,0.007933886,20,168,117,51,8,12
7196,D16,RMDQ5_v1,0.65,5.14E-05,20,98,78,20,7,13
7210,D29,RMDQ5_v1,0.404761905,0.024398893,42,76,60,16,25,17
7212,Lombalgia,D32,0.548387097,3.40E-11,62,74,71,3,28,34
7214,D32,RMDQ5_v1,0.432432432,0.012456296,37,81,64,17,21,16
7219,D37,RMDQ5_v1,0.619047619,0.000132448,21,97,77,20,8,13
7221,D39,RMDQ5_v1,0.785714286,7.00E-06,14,104,82,22,3,11
7229,D46,RMDQ5_v1,0.432432432,0.012456296,37,81,64,17,21,16
7231,D48,RMDQ5_v1,0.461538462,0.019280311,26,92,71,21,14,12
7239,RMDQ1_v1,RMDQ5_v1,0.529411765,2.39E-06,85,134,107,27,40,45
7240,RMDQ2_v1,RMDQ5_v1,0.544444444,7.66E-08,90,129,106,23,41,49
7241,RMDQ3_v1,RMDQ5_v1,0.9,6.61E-42,80,141,140,1,8,72
7242,RMDQ4_v1,RMDQ5_v1,0.854545455,1.46E-21,55,166,140,26,8,47
7243,RMDQ5_v1,RMDQ5_v1,1,5.47E-50,73,148,148,0,0,73
7244,RMDQ6_v1,RMDQ5_v1,0.947368421,1.35E-30,57,164,145,19,3,54
7245,RMDQ7_v1,RMDQ5_v1,0.897435897,5.95E-17,39,181,144,37,4,35
7246,RMDQ8_v1,RMDQ5_v1,1,3.61E-05,8,212,148,64,0,8
7247,RMDQ9_v1,RMDQ5_v1,0.941176471,1.07E-16,34,186,146,40,2,32
7248,RMDQ10_v1,RMDQ5_v1,0.85,6.73E-15,40,180,142,38,6,34
7249,RMDQ11_v1,RMDQ5_v1,0.904761905,7.49E-19,42,178,144,34,4,38
7250,RMDQ12_v1,RMDQ5_v1,0.863636364,2.30E-17,44,176,142,34,6,38
7251,RMDQ13_v1,RMDQ5_v1,0.782608696,1.35E-13,46,174,138,36,10,36
7252,RMDQ14_v1,RMDQ5_v1,0.755102041,4.50E-13,49,171,136,35,12,37
7253,RMDQ15_v1,RMDQ5_v1,0.870967742,3.39E-12,31,189,144,45,4,27
7254,RMDQ16_v1,RMDQ5_v1,0.864864865,2.15E-14,37,183,143,40,5,32
7255,RMDQ17_v1,RMDQ5_v1,0.836734694,6.65E-18,49,171,140,31,8,41
7256,RMDQ18_v1,RMDQ5_v1,0.916666667,1.71E-16,36,184,145,39,3,33
7257,RMDQ19_v1,RMDQ5_v1,0.96875,5.96E-17,32,188,147,41,1,31
7258,RMDQ20_v1,RMDQ5_v1,0.894736842,2.47E-16,38,182,144,38,4,34
7259,RMDQ21_v1,RMDQ5_v1,0.875,5.88E-20,48,172,142,30,6,42
7260,RMDQ22_v1,RMDQ5_v1,1,2.55E-22,38,182,148,34,0,38
7261,RMDQ23_v1,RMDQ5_v1,0.918918919,4.11E-17,37,183,145,38,3,34
7262,RMDQ24_v1,RMDQ5_v1,0.971428571,8.24E-19,35,185,147,38,1,34
7267,DN4 - Alfinetada e agulhada,RMDQ5_v1,0.419354839,0.047995804,62,150,108,42,36,26
7268,DN4 - Adormecimento,RMDQ5_v1,0.440677966,0.025634363,59,150,108,42,33,26
7279,Analgésicos,RMDQ6_v1,0.295774648,0.043993117,142,57,48,9,100,42
7281,Dor nas costas,RMDQ6_v1,0.298387097,0.041292104,124,67,56,11,87,37
7283,Retornar_trabalho,RMDQ6_v1,0.45,0.03466901,20,168,129,39,11,9
7291,X6,RMDQ6_v1,0.583333333,0.008912245,12,171,130,41,5,7
7297,D16,RMDQ6_v1,0.5,0.003757757,20,98,79,19,10,10
7306,D24,RMDQ6_v1,0.083333333,0.03837877,24,94,67,27,22,2
7313,Lombalgia,DN4 - Queimação,0.553571429,0.030217085,56,62,40,22,25,31
7320,D37,RMDQ6_v1,0.476190476,0.006827836,21,97,78,19,11,10
7322,D39,RMDQ6_v1,0.571428571,0.002572071,14,104,83,21,6,8
7327,D43,RMDQ6_v1,1,0.012463179,2,116,89,27,0,2
7340,RMDQ1_v1,RMDQ6_v1,0.352941176,0.026455748,85,134,108,26,55,30
7341,RMDQ2_v1,RMDQ6_v1,0.344444444,0.035376337,90,129,104,25,59,31
7342,RMDQ3_v1,RMDQ6_v1,0.6625,3.95E-25,80,141,137,4,27,53
7343,RMDQ4_v1,RMDQ6_v1,0.581818182,2.37E-10,55,166,141,25,23,32
7344,RMDQ5_v1,RMDQ6_v1,0.739726027,1.35E-30,73,148,145,3,19,54
7345,RMDQ6_v1,RMDQ6_v1,1,5.47E-50,57,164,164,0,0,57
7346,RMDQ7_v1,RMDQ6_v1,0.846153846,8.70E-21,39,181,158,23,6,33
7347,RMDQ8_v1,RMDQ6_v1,0.875,4.06E-05,8,212,163,49,1,7
7348,RMDQ9_v1,RMDQ6_v1,0.970588235,1.92E-25,34,186,163,23,1,33
7349,RMDQ10_v1,RMDQ6_v1,0.875,2.30E-23,40,180,159,21,5,35
7350,RMDQ11_v1,RMDQ6_v1,0.928571429,7.30E-29,42,178,161,17,3,39
7351,RMDQ12_v1,RMDQ6_v1,0.886363636,5.51E-27,44,176,159,17,5,39
7352,RMDQ13_v1,RMDQ6_v1,0.804347826,6.23E-22,46,174,155,19,9,37
7353,RMDQ14_v1,RMDQ6_v1,0.693877551,1.17E-15,49,171,149,22,15,34
7354,RMDQ15_v1,RMDQ6_v1,0.870967742,1.89E-17,31,189,160,29,4,27
7355,RMDQ16_v1,RMDQ6_v1,0.891891892,1.70E-22,37,183,160,23,4,33
7356,RMDQ17_v1,RMDQ6_v1,0.795918367,5.75E-23,49,171,154,17,10,39
7357,RMDQ18_v1,RMDQ6_v1,0.916666667,2.01E-23,36,184,161,23,3,33
7358,RMDQ19_v1,RMDQ6_v1,0.96875,1.09E-23,32,188,163,25,1,31
7359,RMDQ20_v1,RMDQ6_v1,0.973684211,4.62E-29,38,182,163,19,1,37
7360,RMDQ21_v1,RMDQ6_v1,0.729166667,1.37E-17,48,172,151,21,13,35
7361,RMDQ22_v1,RMDQ6_v1,1,4.20E-31,38,182,164,18,0,38
7362,RMDQ23_v1,RMDQ6_v1,0.918918919,2.64E-24,37,183,161,22,3,34
7363,RMDQ24_v1,RMDQ6_v1,1,2.44E-28,35,185,164,21,0,35
7368,DN4 - Alfinetada e agulhada,RMDQ6_v1,0.370967742,0.004291836,62,150,122,28,39,23
7369,DN4 - Adormecimento,RMDQ6_v1,0.372881356,0.006522893,59,150,121,29,37,22
7371,DH4 - Hipoestesia ao toque,RMDQ6_v1,0.571428571,0.037279133,7,205,158,47,3,4
7372,DN4 - Hipoestesia a picada de agulha,RMDQ6_v1,0.571428571,0.037279133,7,205,158,47,3,4
7373,DN4 - Escovação,RMDQ6_v1,0.666666667,0.013242004,6,206,159,47,2,4
7374,Fuma,RMDQ7_v1,0.333333333,0.015589297,36,147,124,23,24,12
7379,Aposentado_Invalidez,RMDQ7_v1,0.5,0.01849634,8,171,142,29,4,4
7380,Analgésicos,RMDQ7_v1,0.226950355,0.009606303,141,57,53,4,109,32
7382,Dor nas costas,RMDQ7_v1,0.227642276,0.017662644,123,67,61,6,95,28
7402,D2,RMDQ7_v1,0.5,0.010423862,8,109,93,16,4,4
7419,D35,RMDQ7_v1,1,0.026984377,1,116,97,19,0,1
7424,D4,RMDQ7_v1,0.666666667,0.020853932,3,114,96,18,1,2
7435,D5,RMDQ7_v1,0.666666667,0.020853932,3,114,96,18,1,2
7437,D51,RMDQ7_v1,1,0.026984377,1,116,97,19,0,1
7438,D52,RMDQ7_v1,1,0.026984377,1,116,97,19,0,1
7439,D53,RMDQ7_v1,1,0.026984377,1,116,97,19,0,1
7440,D9,RMDQ7_v1,1,0.026984377,1,116,97,19,0,1
7441,RMDQ1_v1,RMDQ7_v1,0.388235294,6.58E-10,85,134,128,6,52,33
7442,RMDQ2_v1,RMDQ7_v1,0.388888889,6.98E-11,90,129,125,4,55,35
7443,RMDQ3_v1,RMDQ7_v1,0.430379747,1.86E-13,79,141,136,5,45,34
7445,RMDQ5_v1,RMDQ7_v1,0.486111111,5.95E-17,72,148,144,4,37,35
7446,RMDQ6_v1,RMDQ7_v1,0.589285714,8.70E-21,56,164,158,6,23,33
7447,RMDQ7_v1,RMDQ7_v1,1,9.04E-50,39,181,181,0,0,39
7448,RMDQ8_v1,RMDQ7_v1,1,5.39E-10,8,212,181,31,0,8
7449,RMDQ9_v1,RMDQ7_v1,0.970588235,1.25E-39,34,186,180,6,1,33
7450,RMDQ10_v1,RMDQ7_v1,0.825,1.93E-32,40,180,174,6,7,33
7451,RMDQ11_v1,RMDQ7_v1,0.785714286,1.69E-30,42,178,172,6,9,33
7452,RMDQ12_v1,RMDQ7_v1,0.818181818,1.47E-35,44,176,173,3,8,36
7453,RMDQ13_v1,RMDQ7_v1,0.717391304,4.01E-27,46,174,168,6,13,33
7454,RMDQ14_v1,RMDQ7_v1,0.714285714,6.07E-29,49,171,167,4,14,35
7455,RMDQ15_v1,RMDQ7_v1,0.870967742,1.02E-27,31,189,177,12,4,27
7456,RMDQ16_v1,RMDQ7_v1,0.864864865,3.23E-33,37,183,176,7,5,32
7457,RMDQ17_v1,RMDQ7_v1,0.632653061,2.87E-21,49,171,163,8,18,31
7458,RMDQ18_v1,RMDQ7_v1,0.861111111,7.24E-32,36,184,176,8,5,31
7459,RMDQ19_v1,RMDQ7_v1,0.96875,7.42E-37,32,188,180,8,1,31
7460,RMDQ20_v1,RMDQ7_v1,0.868421053,1.39E-34,38,182,176,6,5,33
7461,RMDQ21_v1,RMDQ7_v1,0.6875,1.21E-25,48,172,166,6,15,33
7462,RMDQ22_v1,RMDQ7_v1,0.842105263,3.97E-32,38,182,175,7,6,32
7463,RMDQ23_v1,RMDQ7_v1,0.864864865,3.23E-33,37,183,176,7,5,32
7464,RMDQ24_v1,RMDQ7_v1,0.942857143,2.93E-38,35,185,179,6,2,33
7466,DN4 - Sensação de frio dolorosa,RMDQ7_v1,0.063829787,0.024434786,47,161,128,33,44,3
7469,DN4 - Alfinetada e agulhada,RMDQ7_v1,0.290322581,0.002660066,62,150,132,18,44,18
7472,DH4 - Hipoestesia ao toque,RMDQ7_v1,0.571428571,0.004002903,7,205,173,32,3,4
7473,DN4 - Hipoestesia a picada de agulha,RMDQ7_v1,0.571428571,0.004002903,7,205,173,32,3,4
7474,DN4 - Escovação,RMDQ7_v1,0.666666667,0.001008032,6,206,174,32,2,4
7475,Fuma,RMDQ8_v1,0.111111111,0.027338121,36,147,143,4,32,4
7482,OutraDoenca,RMDQ8_v1,0.08,0.036939254,75,114,112,2,69,6
7511,D27,RMDQ8_v1,0.25,0.015649204,4,113,110,3,3,1
7512,D28,RMDQ8_v1,0.2,0.037027753,5,112,109,3,4,1
7536,D5,RMDQ8_v1,0.333333333,0.003868582,3,114,111,3,2,1
7544,RMDQ3_v1,RMDQ8_v1,0.101265823,0.000118444,79,141,141,0,71,8
7545,RMDQ4_v1,RMDQ8_v1,0.12962963,2.50E-05,54,166,165,1,47,7
7546,RMDQ5_v1,RMDQ8_v1,0.111111111,3.61E-05,72,148,148,0,64,8
7547,RMDQ6_v1,RMDQ8_v1,0.125,4.06E-05,56,164,163,1,49,7
7548,RMDQ7_v1,RMDQ8_v1,0.205128205,5.39E-10,39,181,181,0,31,8
7549,RMDQ8_v1,RMDQ8_v1,1,9.04E-50,8,212,212,0,0,8
7550,RMDQ9_v1,RMDQ8_v1,0.205882353,9.31E-09,34,186,185,1,27,7
7551,RMDQ10_v1,RMDQ8_v1,0.175,2.24E-07,40,180,179,1,33,7
7552,RMDQ11_v1,RMDQ8_v1,0.166666667,5.30E-07,42,178,177,1,35,7
7553,RMDQ12_v1,RMDQ8_v1,0.159090909,1.16E-06,44,176,175,1,37,7
7554,RMDQ13_v1,RMDQ8_v1,0.152173913,2.38E-06,46,174,173,1,39,7
7555,RMDQ14_v1,RMDQ8_v1,0.142857143,6.27E-06,49,171,170,1,42,7
7556,RMDQ15_v1,RMDQ8_v1,0.129032258,0.002941893,31,189,185,4,27,4
7557,RMDQ16_v1,RMDQ8_v1,0.189189189,5.18E-08,37,183,182,1,30,7
7558,RMDQ17_v1,RMDQ8_v1,0.142857143,6.27E-06,49,171,170,1,42,7
7559,RMDQ18_v1,RMDQ8_v1,0.194444444,3.02E-08,36,184,183,1,29,7
7560,RMDQ19_v1,RMDQ8_v1,0.21875,2.49E-09,32,188,187,1,25,7
7561,RMDQ20_v1,RMDQ8_v1,0.184210526,8.66E-08,38,182,181,1,31,7
7562,RMDQ21_v1,RMDQ8_v1,0.145833333,4.60E-06,48,172,171,1,41,7
7563,RMDQ22_v1,RMDQ8_v1,0.184210526,8.66E-08,38,182,181,1,31,7
7564,RMDQ23_v1,RMDQ8_v1,0.189189189,5.18E-08,37,183,182,1,30,7
7565,RMDQ24_v1,RMDQ8_v1,0.2,1.70E-08,35,185,184,1,28,7
7570,DN4 - Alfinetada e agulhada,RMDQ8_v1,0.112903226,2.85E-05,62,150,150,0,55,7
7576,Fuma,RMDQ9_v1,0.277777778,0.039533218,36,147,127,20,26,10
7581,Aposentado_Invalidez,RMDQ9_v1,0.5,0.006199483,8,171,147,24,4,4
7582,Analgésicos,RMDQ9_v1,0.19858156,0.010501956,141,57,54,3,113,28
7584,Dor nas costas,RMDQ9_v1,0.195121951,0.027341825,123,67,62,5,99,24
7621,D35,RMDQ9_v1,1,0.018508014,1,116,99,17,0,1
7626,D4,RMDQ9_v1,0.666666667,0.012630829,3,114,98,16,1,2
7639,D51,RMDQ9_v1,1,0.018508014,1,116,99,17,0,1
7641,D53,RMDQ9_v1,1,0.018508014,1,116,99,17,0,1
7642,D9,RMDQ9_v1,1,0.018508014,1,116,99,17,0,1
7643,RMDQ1_v1,RMDQ9_v1,0.364705882,6.79E-11,85,134,131,3,54,31
7644,RMDQ2_v1,RMDQ9_v1,0.333333333,8.08E-09,90,129,125,4,60,30
7645,RMDQ3_v1,RMDQ9_v1,0.405063291,1.42E-14,79,141,139,2,47,32
7647,RMDQ5_v1,RMDQ9_v1,0.444444444,1.07E-16,72,148,146,2,40,32
7648,RMDQ6_v1,RMDQ9_v1,0.589285714,1.92E-25,56,164,163,1,23,33
7649,RMDQ7_v1,RMDQ9_v1,0.846153846,1.25E-39,39,181,180,1,6,33
7650,RMDQ8_v1,RMDQ9_v1,0.875,9.31E-09,8,212,185,27,1,7
7651,RMDQ9_v1,RMDQ9_v1,1,9.04E-50,34,186,186,0,0,34
7652,RMDQ10_v1,RMDQ9_v1,0.825,1.84E-38,40,180,179,1,7,33
7653,RMDQ11_v1,RMDQ9_v1,0.785714286,2.70E-36,42,178,177,1,9,33
7654,RMDQ12_v1,RMDQ9_v1,0.75,2.53E-34,44,176,175,1,11,33
7655,RMDQ13_v1,RMDQ9_v1,0.717391304,1.60E-32,46,174,173,1,13,33
7656,RMDQ14_v1,RMDQ9_v1,0.653061224,6.64E-28,49,171,169,2,17,32
7657,RMDQ15_v1,RMDQ9_v1,0.870967742,1.10E-32,31,189,182,7,4,27
7658,RMDQ16_v1,RMDQ9_v1,0.864864865,3.05E-39,37,183,181,2,5,32
7659,RMDQ17_v1,RMDQ9_v1,0.632653061,8.47E-26,49,171,168,3,18,31
7660,RMDQ18_v1,RMDQ9_v1,0.861111111,1.20E-37,36,184,181,3,5,31
7661,RMDQ19_v1,RMDQ9_v1,0.96875,3.19E-43,32,188,185,3,1,31
7662,RMDQ20_v1,RMDQ9_v1,0.868421053,7.40E-41,38,182,181,1,5,33
7663,RMDQ21_v1,RMDQ9_v1,0.6875,7.15E-31,48,172,171,1,15,33
7664,RMDQ22_v1,RMDQ9_v1,0.842105263,5.02E-38,38,182,180,2,6,32
7665,RMDQ23_v1,RMDQ9_v1,0.864864865,3.05E-39,37,183,181,2,5,32
7666,RMDQ24_v1,RMDQ9_v1,0.942857143,5.83E-45,35,185,184,1,2,33
7671,DN4 - Alfinetada e agulhada,RMDQ9_v1,0.241935484,0.011224323,62,150,134,16,47,15
7672,DN4 - Adormecimento,RMDQ9_v1,0.237288136,0.023242032,59,150,133,17,45,14
7674,DH4 - Hipoestesia ao toque,RMDQ9_v1,0.714285714,1.52E-05,7,205,179,26,2,5
7675,DN4 - Hipoestesia a picada de agulha,RMDQ9_v1,0.571428571,0.001204515,7,205,178,27,3,4
7676,DN4 - Escovação,RMDQ9_v1,0.666666667,0.000252087,6,206,179,27,2,4
7682,Aposentado_Invalidez,RMDQ10_v1,0.5,0.022172222,8,171,141,30,4,4
7683,Analgésicos,RMDQ10_v1,0.234042553,0.007399914,141,57,53,4,108,33
7685,Dor nas costas,RMDQ10_v1,0.235772358,0.012986902,123,67,61,6,94,29
7687,Retornar_trabalho,RMDQ10_v1,0.368421053,0.04019157,19,168,139,29,12,7
7708,D22,RMDQ10_v1,1,0.036891632,1,116,95,21,0,1
7713,D27,RMDQ10_v1,0.75,0.003423706,4,113,94,19,1,3
7714,D28,RMDQ10_v1,0.6,0.015970538,5,112,93,19,2,3
7722,D35,RMDQ10_v1,1,0.036891632,1,116,95,21,0,1
7727,D4,RMDQ10_v1,0.666666667,0.031603187,3,114,94,20,1,2
7731,D43,RMDQ10_v1,1,0.003034577,2,115,95,20,0,2
7740,D51,RMDQ10_v1,1,0.036891632,1,116,95,21,0,1
7742,D53,RMDQ10_v1,1,0.036891632,1,116,95,21,0,1
7743,D9,RMDQ10_v1,1,0.036891632,1,116,95,21,0,1
7744,RMDQ1_v1,RMDQ10_v1,0.352941176,1.18E-06,85,134,124,10,55,30
7745,RMDQ2_v1,RMDQ10_v1,0.366666667,2.51E-08,90,129,122,7,57,33
7746,RMDQ3_v1,RMDQ10_v1,0.417721519,1.12E-11,79,141,134,7,46,33
7748,RMDQ5_v1,RMDQ10_v1,0.472222222,6.73E-15,72,148,142,6,38,34
7749,RMDQ6_v1,RMDQ10_v1,0.625,2.30E-23,56,164,159,5,21,35
7750,RMDQ7_v1,RMDQ10_v1,0.846153846,1.93E-32,39,181,174,7,6,33
7751,RMDQ8_v1,RMDQ10_v1,0.875,2.24E-07,8,212,179,33,1,7
7752,RMDQ9_v1,RMDQ10_v1,0.970588235,1.84E-38,34,186,179,7,1,33
7753,RMDQ10_v1,RMDQ10_v1,1,9.04E-50,40,180,180,0,0,40
7754,RMDQ11_v1,RMDQ10_v1,0.880952381,5.57E-39,42,178,175,3,5,37
7755,RMDQ12_v1,RMDQ10_v1,0.795454545,3.95E-32,44,176,171,5,9,35
7756,RMDQ13_v1,RMDQ10_v1,0.717391304,3.32E-26,46,174,167,7,13,33
7757,RMDQ14_v1,RMDQ10_v1,0.734693878,5.18E-30,49,171,167,4,13,36
7758,RMDQ15_v1,RMDQ10_v1,0.870967742,7.11E-27,31,189,176,13,4,27
7759,RMDQ16_v1,RMDQ10_v1,0.864864865,3.42E-32,37,183,175,8,5,32
7760,RMDQ17_v1,RMDQ10_v1,0.673469388,4.46E-24,49,171,164,7,16,33
7761,RMDQ18_v1,RMDQ10_v1,0.972222222,3.30E-41,36,184,179,5,1,35
7762,RMDQ19_v1,RMDQ10_v1,0.96875,8.97E-36,32,188,179,9,1,31
7763,RMDQ20_v1,RMDQ10_v1,0.921052632,1.40E-38,38,182,177,5,3,35
7764,RMDQ21_v1,RMDQ10_v1,0.770833333,5.35E-33,48,172,169,3,11,37
7765,RMDQ22_v1,RMDQ10_v1,0.894736842,5.28E-36,38,182,176,6,4,34
7766,RMDQ23_v1,RMDQ10_v1,1,1.92E-45,37,183,180,3,0,37
7767,RMDQ24_v1,RMDQ10_v1,1,1.24E-42,35,185,180,5,0,35
7772,DN4 - Alfinetada e agulhada,RMDQ10_v1,0.241935484,0.02590076,62,150,132,18,47,15
7773,DN4 - Adormecimento,RMDQ10_v1,0.237288136,0.048369471,59,150,131,19,45,14
7775,DH4 - Hipoestesia ao toque,RMDQ10_v1,0.571428571,0.002031223,7,205,176,29,3,4
7776,DN4 - Hipoestesia a picada de agulha,RMDQ10_v1,0.571428571,0.002031223,7,205,176,29,3,4
7777,DN4 - Escovação,RMDQ10_v1,0.666666667,0.000460768,6,206,177,29,2,4
7783,Aposentado_Invalidez,RMDQ11_v1,0.5,0.03094463,8,171,139,32,4,4
7784,Analgésicos,RMDQ11_v1,0.241134752,0.005678359,141,57,53,4,107,34
7786,Dor nas costas,RMDQ11_v1,0.235772358,0.012986902,123,67,61,6,94,29
7788,Retornar_trabalho,RMDQ11_v1,0.368421053,0.048968827,19,168,138,30,12,7
7809,D22,RMDQ11_v1,1,0.042324283,1,116,94,22,0,1
7814,D27,RMDQ11_v1,0.75,0.004597329,4,113,93,20,1,3
7815,D28,RMDQ11_v1,0.6,0.020342296,5,112,92,20,2,3
7823,D35,RMDQ11_v1,1,0.042324283,1,116,94,22,0,1
7828,D4,RMDQ11_v1,0.666666667,0.037934361,3,114,93,21,1,2
7832,D43,RMDQ11_v1,1,0.003929589,2,115,94,21,0,2
7841,D51,RMDQ11_v1,1,0.042324283,1,116,94,22,0,1
7843,D53,RMDQ11_v1,1,0.042324283,1,116,94,22,0,1
7844,D9,RMDQ11_v1,1,0.042324283,1,116,94,22,0,1
7845,RMDQ1_v1,RMDQ11_v1,0.352941176,7.52E-06,85,134,122,12,55,30
7846,RMDQ2_v1,RMDQ11_v1,0.366666667,2.39E-07,90,129,120,9,57,33
7847,RMDQ3_v1,RMDQ11_v1,0.46835443,4.59E-15,79,141,136,5,42,37
7848,RMDQ4_v1,RMDQ11_v1,0.333333333,0.002171792,54,166,142,24,36,18
7849,RMDQ5_v1,RMDQ11_v1,0.527777778,7.49E-19,72,148,144,4,34,38
7850,RMDQ6_v1,RMDQ11_v1,0.696428571,7.30E-29,56,164,161,3,17,39
7851,RMDQ7_v1,RMDQ11_v1,0.846153846,1.69E-30,39,181,172,9,6,33
7852,RMDQ8_v1,RMDQ11_v1,0.875,5.30E-07,8,212,177,35,1,7
7853,RMDQ9_v1,RMDQ11_v1,0.970588235,2.70E-36,34,186,177,9,1,33
7854,RMDQ10_v1,RMDQ11_v1,0.925,5.57E-39,40,180,175,5,3,37
7855,RMDQ11_v1,RMDQ11_v1,1,9.04E-50,42,178,178,0,0,42
7856,RMDQ12_v1,RMDQ11_v1,0.795454545,3.83E-30,44,176,169,7,9,35
7857,RMDQ13_v1,RMDQ11_v1,0.717391304,1.68E-24,46,174,165,9,13,33
7858,RMDQ14_v1,RMDQ11_v1,0.734693878,4.48E-28,49,171,165,6,13,36
7859,RMDQ15_v1,RMDQ11_v1,0.870967742,2.63E-25,31,189,174,15,4,27
7860,RMDQ16_v1,RMDQ11_v1,0.864864865,2.74E-30,37,183,173,10,5,32
7861,RMDQ17_v1,RMDQ11_v1,0.673469388,1.87E-22,49,171,162,9,16,33
7862,RMDQ18_v1,RMDQ11_v1,0.972222222,7.00E-39,36,184,177,7,1,35
7863,RMDQ19_v1,RMDQ11_v1,0.96875,9.22E-34,32,188,177,11,1,31
7864,RMDQ20_v1,RMDQ11_v1,0.921052632,2.36E-36,38,182,175,7,3,35
7865,RMDQ21_v1,RMDQ11_v1,0.770833333,6.43E-31,48,172,167,5,11,37
7866,RMDQ22_v1,RMDQ11_v1,0.894736842,6.70E-34,38,182,174,8,4,34
7867,RMDQ23_v1,RMDQ11_v1,0.918918919,4.63E-35,37,183,175,8,3,34
7868,RMDQ24_v1,RMDQ11_v1,1,2.97E-40,35,185,178,7,0,35
7873,DN4 - Alfinetada e agulhada,RMDQ11_v1,0.306451613,0.000365088,62,150,134,16,43,19
7876,DH4 - Hipoestesia ao toque,RMDQ11_v1,0.571428571,0.003232851,7,205,174,31,3,4
7877,DN4 - Hipoestesia a picada de agulha,RMDQ11_v1,0.571428571,0.003232851,7,205,174,31,3,4
7878,DN4 - Escovação,RMDQ11_v1,0.666666667,0.000787769,6,206,175,31,2,4
7884,Aposentado_Invalidez,RMDQ12_v1,0.5,0.041749623,8,171,137,34,4,4
7885,Analgésicos,RMDQ12_v1,0.24822695,0.024586893,141,57,51,6,106,35
7887,Dor nas costas,RMDQ12_v1,0.25203252,0.030568114,123,67,59,8,92,31
7910,D22,RMDQ12_v1,1,0.036891632,1,116,95,21,0,1
7912,D24,RMDQ12_v1,0.041666667,0.039558689,24,93,72,21,23,1
7924,D35,RMDQ12_v1,1,0.036891632,1,116,95,21,0,1
7929,D4,RMDQ12_v1,0.666666667,0.031603187,3,114,94,20,1,2
7932,D42,RMDQ12_v1,1,0.003034577,2,115,95,20,0,2
7933,D43,RMDQ12_v1,1,0.003034577,2,115,95,20,0,2
7942,D51,RMDQ12_v1,1,0.036891632,1,116,95,21,0,1
7943,D52,RMDQ12_v1,1,0.036891632,1,116,95,21,0,1
7944,D53,RMDQ12_v1,1,0.036891632,1,116,95,21,0,1
7945,D9,RMDQ12_v1,1,0.036891632,1,116,95,21,0,1
7946,RMDQ1_v1,RMDQ12_v1,0.388235294,2.14E-07,85,134,123,11,52,33
7947,RMDQ2_v1,RMDQ12_v1,0.377777778,2.88E-07,90,129,119,10,56,34
7948,RMDQ3_v1,RMDQ12_v1,0.46835443,9.45E-14,79,141,134,7,42,37
7949,RMDQ4_v1,RMDQ12_v1,0.296296296,0.04169107,54,166,138,28,38,16
7950,RMDQ5_v1,RMDQ12_v1,0.527777778,2.30E-17,72,148,142,6,34,38
7951,RMDQ6_v1,RMDQ12_v1,0.696428571,5.51E-27,56,164,159,5,17,39
7952,RMDQ7_v1,RMDQ12_v1,0.923076923,1.47E-35,39,181,173,8,3,36
7953,RMDQ8_v1,RMDQ12_v1,0.875,1.16E-06,8,212,175,37,1,7
7954,RMDQ9_v1,RMDQ12_v1,0.970588235,2.53E-34,34,186,175,11,1,33
7955,RMDQ10_v1,RMDQ12_v1,0.875,3.95E-32,40,180,171,9,5,35
7956,RMDQ11_v1,RMDQ12_v1,0.833333333,3.83E-30,42,178,169,9,7,35
7957,RMDQ12_v1,RMDQ12_v1,1,9.04E-50,44,176,176,0,0,44
7958,RMDQ13_v1,RMDQ12_v1,0.804347826,1.02E-30,46,174,167,7,9,37
7959,RMDQ14_v1,RMDQ12_v1,0.755102041,3.11E-28,49,171,164,7,12,37
7960,RMDQ15_v1,RMDQ12_v1,0.935483871,2.31E-28,31,189,174,15,2,29
7961,RMDQ16_v1,RMDQ12_v1,0.864864865,1.47E-28,37,183,171,12,5,32
7962,RMDQ17_v1,RMDQ12_v1,0.673469388,5.55E-21,49,171,160,11,16,33
7963,RMDQ18_v1,RMDQ12_v1,0.916666667,6.68E-32,36,184,173,11,3,33
7964,RMDQ19_v1,RMDQ12_v1,0.96875,6.22E-32,32,188,175,13,1,31
7965,RMDQ20_v1,RMDQ12_v1,0.921052632,2.51E-34,38,182,173,9,3,35
7966,RMDQ21_v1,RMDQ12_v1,0.729166667,3.55E-25,48,172,163,9,13,35
7967,RMDQ22_v1,RMDQ12_v1,0.894736842,5.48E-32,38,182,172,10,4,34
7968,RMDQ23_v1,RMDQ12_v1,0.918918919,4.16E-33,37,183,173,10,3,34
7969,RMDQ24_v1,RMDQ12_v1,1,4.33E-38,35,185,176,9,0,35
7971,DN4 - Sensação de frio dolorosa,RMDQ12_v1,0.063829787,0.013549261,47,161,125,36,44,3
7972,DN4 - Choque elétrico,RMDQ12_v1,0.1,0.047436981,60,152,119,33,54,6
7977,DH4 - Hipoestesia ao toque,RMDQ12_v1,0.571428571,0.007131659,7,205,170,35,3,4
7978,DN4 - Hipoestesia a picada de agulha,RMDQ12_v1,0.571428571,0.007131659,7,205,170,35,3,4
7979,DN4 - Escovação,RMDQ12_v1,0.666666667,0.001962883,6,206,171,35,2,4
8002,D1,RMDQ13_v1,1,0.036891632,1,116,95,21,0,1
8013,D24,RMDQ13_v1,0.041666667,0.039558689,24,93,72,21,23,1
8025,D35,RMDQ13_v1,1,0.036891632,1,116,95,21,0,1
8030,D4,RMDQ13_v1,0.666666667,0.031603187,3,114,94,20,1,2
8043,D51,RMDQ13_v1,1,0.036891632,1,116,95,21,0,1
8045,D53,RMDQ13_v1,1,0.036891632,1,116,95,21,0,1
8046,D9,RMDQ13_v1,1,0.036891632,1,116,95,21,0,1
8047,RMDQ1_v1,RMDQ13_v1,0.388235294,1.41E-06,85,134,121,13,52,33
8048,RMDQ2_v1,RMDQ13_v1,0.355555556,4.95E-05,90,129,115,14,58,32
8049,RMDQ3_v1,RMDQ13_v1,0.481012658,1.14E-13,79,141,133,8,41,38
8050,RMDQ4_v1,RMDQ13_v1,0.314814815,0.027852265,54,166,137,29,37,17
8051,RMDQ5_v1,RMDQ13_v1,0.5,1.35E-13,72,148,138,10,36,36
8052,RMDQ6_v1,RMDQ13_v1,0.660714286,6.23E-22,56,164,155,9,19,37
8053,RMDQ7_v1,RMDQ13_v1,0.846153846,4.01E-27,39,181,168,13,6,33
8054,RMDQ8_v1,RMDQ13_v1,0.875,2.38E-06,8,212,173,39,1,7
8055,RMDQ9_v1,RMDQ13_v1,0.970588235,1.60E-32,34,186,173,13,1,33
8056,RMDQ10_v1,RMDQ13_v1,0.825,3.32E-26,40,180,167,13,7,33
8057,RMDQ11_v1,RMDQ13_v1,0.785714286,1.68E-24,42,178,165,13,9,33
8058,RMDQ12_v1,RMDQ13_v1,0.840909091,1.02E-30,44,176,167,9,7,37
8059,RMDQ13_v1,RMDQ13_v1,1,9.04E-50,46,174,174,0,0,46
8060,RMDQ14_v1,RMDQ13_v1,0.653061224,4.39E-18,49,171,157,14,17,32
8061,RMDQ15_v1,RMDQ13_v1,0.870967742,1.41E-22,31,189,170,19,4,27
8062,RMDQ16_v1,RMDQ13_v1,0.945945946,1.27E-33,37,183,172,11,2,35
8063,RMDQ17_v1,RMDQ13_v1,0.693877551,2.93E-21,49,171,159,12,15,34
8064,RMDQ18_v1,RMDQ13_v1,0.861111111,7.04E-26,36,184,169,15,5,31
8065,RMDQ19_v1,RMDQ13_v1,0.96875,2.92E-30,32,188,173,15,1,31
8066,RMDQ20_v1,RMDQ13_v1,0.868421053,4.34E-28,38,182,169,13,5,33
8067,RMDQ21_v1,RMDQ13_v1,0.6875,3.03E-20,48,172,159,13,15,33
8068,RMDQ22_v1,RMDQ13_v1,0.842105263,5.08E-26,38,182,168,14,6,32
8069,RMDQ23_v1,RMDQ13_v1,0.864864865,5.61E-27,37,183,169,14,5,32
8070,RMDQ24_v1,RMDQ13_v1,0.942857143,2.55E-31,35,185,172,13,2,33
8073,DN4 - Choque elétrico,RMDQ13_v1,0.1,0.019315803,60,152,115,37,54,6
8078,DH4 - Hipoestesia ao toque,RMDQ13_v1,0.571428571,0.013650434,7,205,166,39,3,4
8079,DN4 - Hipoestesia a picada de agulha,RMDQ13_v1,0.571428571,0.013650434,7,205,166,39,3,4
8080,DN4 - Escovação,RMDQ13_v1,0.666666667,0.004152011,6,206,167,39,2,4
8087,Analgésicos,RMDQ14_v1,0.276595745,0.009193885,141,57,51,6,102,39
8089,Dor nas costas,RMDQ14_v1,0.284552846,0.009342115,123,67,59,8,88,35
8117,D27,RMDQ14_v1,0.75,0.007750056,4,113,91,22,1,3
8118,D28,RMDQ14_v1,0.6,0.031241051,5,112,90,22,2,3
8134,D42,RMDQ14_v1,1,0.00621115,2,115,92,23,0,2
8135,D43,RMDQ14_v1,1,0.00621115,2,115,92,23,0,2
8148,RMDQ1_v1,RMDQ14_v1,0.482352941,1.92E-12,85,134,126,8,44,41
8149,RMDQ2_v1,RMDQ14_v1,0.5,2.05E-15,90,129,125,4,45,45
8150,RMDQ3_v1,RMDQ14_v1,0.46835443,5.59E-11,79,141,129,12,42,37
8151,RMDQ4_v1,RMDQ14_v1,0.333333333,0.024522305,54,166,135,31,36,18
8152,RMDQ5_v1,RMDQ14_v1,0.513888889,4.50E-13,72,148,136,12,35,37
8153,RMDQ6_v1,RMDQ14_v1,0.607142857,1.17E-15,56,164,149,15,22,34
8154,RMDQ7_v1,RMDQ14_v1,0.897435897,6.07E-29,39,181,167,14,4,35
8155,RMDQ8_v1,RMDQ14_v1,0.875,6.27E-06,8,212,170,42,1,7
8156,RMDQ9_v1,RMDQ14_v1,0.941176471,6.64E-28,34,186,169,17,2,32
8157,RMDQ10_v1,RMDQ14_v1,0.9,5.18E-30,40,180,167,13,4,36
8158,RMDQ11_v1,RMDQ14_v1,0.857142857,4.48E-28,42,178,165,13,6,36
8159,RMDQ12_v1,RMDQ14_v1,0.840909091,3.11E-28,44,176,164,12,7,37
8160,RMDQ13_v1,RMDQ14_v1,0.695652174,4.39E-18,46,174,157,17,14,32
8161,RMDQ14_v1,RMDQ14_v1,1,9.04E-50,49,171,171,0,0,49
8162,RMDQ15_v1,RMDQ14_v1,0.935483871,7.79E-25,31,189,169,20,2,29
8163,RMDQ16_v1,RMDQ14_v1,0.864864865,7.58E-25,37,183,166,17,5,32
8164,RMDQ17_v1,RMDQ14_v1,0.673469388,7.88E-18,49,171,155,16,16,33
8165,RMDQ18_v1,RMDQ14_v1,0.972222222,3.15E-32,36,184,170,14,1,35
8166,RMDQ19_v1,RMDQ14_v1,0.9375,7.57E-26,32,188,169,19,2,30
8167,RMDQ20_v1,RMDQ14_v1,0.894736842,6.92E-28,38,182,167,15,4,34
8168,RMDQ21_v1,RMDQ14_v1,0.75,3.10E-23,48,172,159,13,12,36
8169,RMDQ22_v1,RMDQ14_v1,0.868421053,7.16E-26,38,182,166,16,5,33
8170,RMDQ23_v1,RMDQ14_v1,0.891891892,7.67E-27,37,183,167,16,4,33
8171,RMDQ24_v1,RMDQ14_v1,0.971428571,3.71E-31,35,185,170,15,1,34
8175,DN4 - Formigamento,RMDQ14_v1,0.107142857,0.046473324,56,156,120,36,50,6
8179,DH4 - Hipoestesia ao toque,RMDQ14_v1,0.571428571,0.011735078,7,205,167,38,3,4
8180,DN4 - Hipoestesia a picada de agulha,RMDQ14_v1,0.571428571,0.011735078,7,205,167,38,3,4
8181,DN4 - Escovação,RMDQ14_v1,0.666666667,0.003487269,6,206,168,38,2,4
8187,Aposentado_Invalidez,RMDQ15_v1,0.375,0.049455908,8,171,149,22,5,3
8188,Analgésicos,RMDQ15_v1,0.170212766,0.029041827,141,57,54,3,117,24
8227,D35,RMDQ15_v1,1,0.008821462,1,116,102,14,0,1
8232,D4,RMDQ15_v1,0.666666667,0.004711047,3,114,101,13,1,2
8245,D51,RMDQ15_v1,1,0.008821462,1,116,102,14,0,1
8248,D9,RMDQ15_v1,1,0.008821462,1,116,102,14,0,1
8249,RMDQ1_v1,RMDQ15_v1,0.341176471,1.08E-10,85,134,132,2,56,29
8250,RMDQ2_v1,RMDQ15_v1,0.322222222,1.04E-09,90,129,127,2,61,29
8251,RMDQ3_v1,RMDQ15_v1,0.341772152,1.46E-10,79,141,137,4,52,27
8253,RMDQ5_v1,RMDQ15_v1,0.375,3.39E-12,72,148,144,4,45,27
8254,RMDQ6_v1,RMDQ15_v1,0.482142857,1.89E-17,56,164,160,4,29,27
8255,RMDQ7_v1,RMDQ15_v1,0.692307692,1.02E-27,39,181,177,4,12,27
8256,RMDQ8_v1,RMDQ15_v1,0.5,0.002941893,8,212,185,27,4,4
8257,RMDQ9_v1,RMDQ15_v1,0.794117647,1.10E-32,34,186,182,4,7,27
8258,RMDQ10_v1,RMDQ15_v1,0.675,7.11E-27,40,180,176,4,13,27
8259,RMDQ11_v1,RMDQ15_v1,0.642857143,2.63E-25,42,178,174,4,15,27
8260,RMDQ12_v1,RMDQ15_v1,0.659090909,2.31E-28,44,176,174,2,15,29
8261,RMDQ13_v1,RMDQ15_v1,0.586956522,1.41E-22,46,174,170,4,19,27
8262,RMDQ14_v1,RMDQ15_v1,0.591836735,7.79E-25,49,171,169,2,20,29
8263,RMDQ15_v1,RMDQ15_v1,1,9.04E-50,31,189,189,0,0,31
8264,RMDQ16_v1,RMDQ15_v1,0.72972973,1.52E-29,37,183,179,4,10,27
8265,RMDQ17_v1,RMDQ15_v1,0.551020408,8.06E-21,49,171,167,4,22,27
8266,RMDQ18_v1,RMDQ15_v1,0.75,1.56E-30,36,184,180,4,9,27
8267,RMDQ19_v1,RMDQ15_v1,0.84375,4.22E-35,32,188,184,4,5,27
8268,RMDQ20_v1,RMDQ15_v1,0.710526316,1.31E-28,38,182,178,4,11,27
8269,RMDQ21_v1,RMDQ15_v1,0.5625,2.21E-21,48,172,168,4,21,27
8270,RMDQ22_v1,RMDQ15_v1,0.710526316,1.31E-28,38,182,178,4,11,27
8271,RMDQ23_v1,RMDQ15_v1,0.72972973,1.52E-29,37,183,179,4,10,27
8272,RMDQ24_v1,RMDQ15_v1,0.771428571,1.41E-31,35,185,181,4,8,27
8280,DH4 - Hipoestesia ao toque,RMDQ15_v1,0.571428571,0.000904416,7,205,179,26,3,4
8281,DN4 - Hipoestesia a picada de agulha,RMDQ15_v1,0.571428571,0.000904416,7,205,179,26,3,4
8282,DN4 - Escovação,RMDQ15_v1,0.666666667,0.000181095,6,206,180,26,2,4
8289,Analgésicos,RMDQ16_v1,0.205673759,0.046299011,141,57,52,5,112,29
8291,Dor nas costas,RMDQ16_v1,0.219512195,0.010781828,123,67,62,5,96,27
8328,D35,RMDQ16_v1,1,0.022556252,1,116,98,18,0,1
8333,D4,RMDQ16_v1,0.666666667,0.016431718,3,114,97,17,1,2
8346,D51,RMDQ16_v1,1,0.022556252,1,116,98,18,0,1
8348,D53,RMDQ16_v1,1,0.022556252,1,116,98,18,0,1
8349,D9,RMDQ16_v1,1,0.022556252,1,116,98,18,0,1
8350,RMDQ1_v1,RMDQ16_v1,0.352941176,4.53E-08,85,134,127,7,55,30
8351,RMDQ2_v1,RMDQ16_v1,0.333333333,3.53E-07,90,129,122,7,60,30
8352,RMDQ3_v1,RMDQ16_v1,0.405063291,2.04E-12,79,141,136,5,47,32
8354,RMDQ5_v1,RMDQ16_v1,0.444444444,2.15E-14,72,148,143,5,40,32
8355,RMDQ6_v1,RMDQ16_v1,0.589285714,1.70E-22,56,164,160,4,23,33
8356,RMDQ7_v1,RMDQ16_v1,0.820512821,3.23E-33,39,181,176,5,7,32
8357,RMDQ8_v1,RMDQ16_v1,0.875,5.18E-08,8,212,182,30,1,7
8358,RMDQ9_v1,RMDQ16_v1,0.941176471,3.05E-39,34,186,181,5,2,32
8359,RMDQ10_v1,RMDQ16_v1,0.8,3.42E-32,40,180,175,5,8,32
8360,RMDQ11_v1,RMDQ16_v1,0.761904762,2.74E-30,42,178,173,5,10,32
8361,RMDQ12_v1,RMDQ16_v1,0.727272727,1.47E-28,44,176,171,5,12,32
8362,RMDQ13_v1,RMDQ16_v1,0.760869565,1.27E-33,46,174,172,2,11,35
8363,RMDQ14_v1,RMDQ16_v1,0.653061224,7.58E-25,49,171,166,5,17,32
8364,RMDQ15_v1,RMDQ16_v1,0.870967742,1.52E-29,31,189,179,10,4,27
8365,RMDQ16_v1,RMDQ16_v1,1,9.04E-50,37,183,183,0,0,37
8366,RMDQ17_v1,RMDQ16_v1,0.693877551,6.44E-29,49,171,168,3,15,34
8367,RMDQ18_v1,RMDQ16_v1,0.861111111,5.43E-34,36,184,178,6,5,31
8368,RMDQ19_v1,RMDQ16_v1,0.9375,2.50E-36,32,188,181,7,2,30
8369,RMDQ20_v1,RMDQ16_v1,0.868421053,6.85E-37,38,182,178,4,5,33
8370,RMDQ21_v1,RMDQ16_v1,0.666666667,1.58E-25,48,172,167,5,16,32
8371,RMDQ22_v1,RMDQ16_v1,0.815789474,8.45E-32,38,182,176,6,7,31
8372,RMDQ23_v1,RMDQ16_v1,0.837837838,7.25E-33,37,183,177,6,6,31
8373,RMDQ24_v1,RMDQ16_v1,0.914285714,6.70E-38,35,185,180,5,3,32
8375,DN4 - Sensação de frio dolorosa,RMDQ16_v1,0.063829787,0.03577336,47,161,130,31,44,3
8381,DH4 - Hipoestesia ao toque,RMDQ16_v1,0.571428571,0.002579511,7,205,175,30,3,4
8382,DN4 - Hipoestesia a picada de agulha,RMDQ16_v1,0.571428571,0.002579511,7,205,175,30,3,4
8383,DN4 - Escovação,RMDQ16_v1,0.666666667,0.000607086,6,206,176,30,2,4
8391,OutraDoenca,RMDQ17_v1,0.346666667,0.00084438,75,114,98,16,49,26
8415,D22,RMDQ17_v1,1,0.036891632,1,116,95,21,0,1
8417,D24,RMDQ17_v1,0.041666667,0.039558689,24,93,72,21,23,1
8429,D35,RMDQ17_v1,1,0.036891632,1,116,95,21,0,1
8434,D4,RMDQ17_v1,0.666666667,0.031603187,3,114,94,20,1,2
8447,D51,RMDQ17_v1,1,0.036891632,1,116,95,21,0,1
8450,D9,RMDQ17_v1,1,0.036891632,1,116,95,21,0,1
8451,RMDQ1_v1,RMDQ17_v1,0.411764706,5.99E-07,85,134,120,14,50,35
8452,RMDQ2_v1,RMDQ17_v1,0.411111111,1.62E-07,90,129,117,12,53,37
8453,RMDQ3_v1,RMDQ17_v1,0.518987342,2.67E-15,79,141,133,8,38,41
8454,RMDQ4_v1,RMDQ17_v1,0.351851852,0.008655614,54,166,136,30,35,19
8455,RMDQ5_v1,RMDQ17_v1,0.569444444,6.65E-18,72,148,140,8,31,41
8456,RMDQ6_v1,RMDQ17_v1,0.696428571,5.75E-23,56,164,154,10,17,39
8457,RMDQ7_v1,RMDQ17_v1,0.794871795,2.87E-21,39,181,163,18,8,31
8458,RMDQ8_v1,RMDQ17_v1,0.875,6.27E-06,8,212,170,42,1,7
8459,RMDQ9_v1,RMDQ17_v1,0.911764706,8.47E-26,34,186,168,18,3,31
8460,RMDQ10_v1,RMDQ17_v1,0.825,4.46E-24,40,180,164,16,7,33
8461,RMDQ11_v1,RMDQ17_v1,0.785714286,1.87E-22,42,178,162,16,9,33
8462,RMDQ12_v1,RMDQ17_v1,0.75,5.55E-21,44,176,160,16,11,33
8463,RMDQ13_v1,RMDQ17_v1,0.739130435,2.93E-21,46,174,159,15,12,34
8464,RMDQ14_v1,RMDQ17_v1,0.673469388,7.88E-18,49,171,155,16,16,33
8465,RMDQ15_v1,RMDQ17_v1,0.870967742,8.06E-21,31,189,167,22,4,27
8466,RMDQ16_v1,RMDQ17_v1,0.918918919,6.44E-29,37,183,168,15,3,34
8467,RMDQ17_v1,RMDQ17_v1,1,9.04E-50,49,171,171,0,0,49
8468,RMDQ18_v1,RMDQ17_v1,0.916666667,7.25E-28,36,184,168,16,3,33
8469,RMDQ19_v1,RMDQ17_v1,0.9375,7.57E-26,32,188,169,19,2,30
8470,RMDQ20_v1,RMDQ17_v1,0.921052632,5.57E-30,38,182,168,14,3,35
8471,RMDQ21_v1,RMDQ17_v1,0.75,3.10E-23,48,172,159,13,12,36
8472,RMDQ22_v1,RMDQ17_v1,0.868421053,7.16E-26,38,182,166,16,5,33
8473,RMDQ23_v1,RMDQ17_v1,0.891891892,7.67E-27,37,183,167,16,4,33
8474,RMDQ24_v1,RMDQ17_v1,0.942857143,5.98E-29,35,185,169,16,2,33
8482,DH4 - Hipoestesia ao toque,RMDQ17_v1,0.571428571,0.018116767,7,205,164,41,3,4
8483,DN4 - Hipoestesia a picada de agulha,RMDQ17_v1,0.571428571,0.018116767,7,205,164,41,3,4
8484,DN4 - Escovação,RMDQ17_v1,0.666666667,0.00575623,6,206,165,41,2,4
8491,Analgésicos,RMDQ18_v1,0.212765957,0.006189497,141,57,54,3,111,30
8493,Dor nas costas,RMDQ18_v1,0.219512195,0.00439467,123,67,63,4,96,27
8516,D22,RMDQ18_v1,1,0.026984377,1,116,97,19,0,1
8521,D27,RMDQ18_v1,0.75,0.001746014,4,113,96,17,1,3
8530,D35,RMDQ18_v1,1,0.026984377,1,116,97,19,0,1
8535,D4,RMDQ18_v1,0.666666667,0.020853932,3,114,96,18,1,2
8548,D51,RMDQ18_v1,1,0.026984377,1,116,97,19,0,1
8551,D9,RMDQ18_v1,1,0.026984377,1,116,97,19,0,1
8552,RMDQ1_v1,RMDQ18_v1,0.329411765,9.01E-07,85,134,126,8,57,28
8553,RMDQ2_v1,RMDQ18_v1,0.355555556,1.25E-09,90,129,125,4,58,32
8554,RMDQ3_v1,RMDQ18_v1,0.417721519,2.43E-14,79,141,138,3,46,33
8556,RMDQ5_v1,RMDQ18_v1,0.458333333,1.71E-16,72,148,145,3,39,33
8557,RMDQ6_v1,RMDQ18_v1,0.589285714,2.01E-23,56,164,161,3,23,33
8558,RMDQ7_v1,RMDQ18_v1,0.794871795,7.24E-32,39,181,176,5,8,31
8559,RMDQ8_v1,RMDQ18_v1,0.875,3.02E-08,8,212,183,29,1,7
8560,RMDQ9_v1,RMDQ18_v1,0.911764706,1.20E-37,34,186,181,5,3,31
8561,RMDQ10_v1,RMDQ18_v1,0.875,3.30E-41,40,180,179,1,5,35
8562,RMDQ11_v1,RMDQ18_v1,0.833333333,7.00E-39,42,178,177,1,7,35
8563,RMDQ12_v1,RMDQ18_v1,0.75,6.68E-32,44,176,173,3,11,33
8564,RMDQ13_v1,RMDQ18_v1,0.673913043,7.04E-26,46,174,169,5,15,31
8565,RMDQ14_v1,RMDQ18_v1,0.714285714,3.15E-32,49,171,170,1,14,35
8566,RMDQ15_v1,RMDQ18_v1,0.870967742,1.56E-30,31,189,180,9,4,27
8567,RMDQ16_v1,RMDQ18_v1,0.837837838,5.43E-34,37,183,178,5,6,31
8568,RMDQ17_v1,RMDQ18_v1,0.673469388,7.25E-28,49,171,168,3,16,33
8569,RMDQ18_v1,RMDQ18_v1,1,9.04E-50,36,184,184,0,0,36
8570,RMDQ19_v1,RMDQ18_v1,0.9375,1.62E-37,32,188,182,6,2,30
8571,RMDQ20_v1,RMDQ18_v1,0.868421053,3.86E-38,38,182,179,3,5,33
8572,RMDQ21_v1,RMDQ18_v1,0.729166667,4.63E-33,48,172,171,1,13,35
8573,RMDQ22_v1,RMDQ18_v1,0.868421053,3.86E-38,38,182,179,3,5,33
8574,RMDQ23_v1,RMDQ18_v1,0.891891892,2.24E-39,37,183,180,3,4,33
8575,RMDQ24_v1,RMDQ18_v1,0.942857143,4.66E-42,35,185,182,3,2,33
8580,DN4 - Alfinetada e agulhada,RMDQ18_v1,0.225806452,0.023576208,62,150,134,16,48,14
8581,DN4 - Adormecimento,RMDQ18_v1,0.237288136,0.015341269,59,150,134,16,45,14
8583,DH4 - Hipoestesia ao toque,RMDQ18_v1,0.571428571,0.000904416,7,205,179,26,3,4
8584,DN4 - Hipoestesia a picada de agulha,RMDQ18_v1,0.571428571,0.000904416,7,205,179,26,3,4
8585,DN4 - Escovação,RMDQ18_v1,0.666666667,0.000181095,6,206,180,26,2,4
8591,Aposentado_Invalidez,RMDQ19_v1,0.5,0.003574036,8,171,149,22,4,4
8592,Analgésicos,RMDQ19_v1,0.184397163,0.017581314,141,57,54,3,115,26
8594,Dor nas costas,RMDQ19_v1,0.178861789,0.04928773,123,67,62,5,101,22
8595,Dor nas pernas,RMDQ19_v1,0.215384615,0.041376392,65,123,110,13,51,14
8610,D16,RMDQ19_v1,0.3,0.01961433,20,97,87,10,14,6
8622,D27,RMDQ19_v1,0.5,0.031432613,4,113,99,14,2,2
8626,Lombalgia,D29,0.629032258,1.38E-13,62,74,71,3,23,39
8628,D32,RMDQ19_v1,0.243243243,0.022610031,37,80,73,7,28,9
8631,D35,RMDQ19_v1,1,0.011626735,1,116,101,15,0,1
8633,D37,RMDQ19_v1,0.285714286,0.028282123,21,96,86,10,15,6
8636,D4,RMDQ19_v1,0.666666667,0.00680424,3,114,100,14,1,2
8649,D51,RMDQ19_v1,1,0.011626735,1,116,101,15,0,1
8652,D9,RMDQ19_v1,1,0.011626735,1,116,101,15,0,1
8653,RMDQ1_v1,RMDQ19_v1,0.329411765,6.45E-09,85,134,130,4,57,28
8654,RMDQ2_v1,RMDQ19_v1,0.3,4.39E-07,90,129,124,5,63,27
8655,RMDQ3_v1,RMDQ19_v1,0.379746835,1.61E-13,79,141,139,2,49,30
8657,RMDQ5_v1,RMDQ19_v1,0.430555556,5.96E-17,72,148,147,1,41,31
8658,RMDQ6_v1,RMDQ19_v1,0.553571429,1.09E-23,56,164,163,1,25,31
8659,RMDQ7_v1,RMDQ19_v1,0.794871795,7.42E-37,39,181,180,1,8,31
8660,RMDQ8_v1,RMDQ19_v1,0.875,2.49E-09,8,212,187,25,1,7
8661,RMDQ9_v1,RMDQ19_v1,0.911764706,3.19E-43,34,186,185,1,3,31
8662,RMDQ10_v1,RMDQ19_v1,0.775,8.97E-36,40,180,179,1,9,31
8663,RMDQ11_v1,RMDQ19_v1,0.738095238,9.22E-34,42,178,177,1,11,31
8664,RMDQ12_v1,RMDQ19_v1,0.704545455,6.22E-32,44,176,175,1,13,31
8665,RMDQ13_v1,RMDQ19_v1,0.673913043,2.92E-30,46,174,173,1,15,31
8666,RMDQ14_v1,RMDQ19_v1,0.612244898,7.57E-26,49,171,169,2,19,30
8667,RMDQ15_v1,RMDQ19_v1,0.870967742,4.22E-35,31,189,184,5,4,27
8668,RMDQ16_v1,RMDQ19_v1,0.810810811,2.50E-36,37,183,181,2,7,30
8669,RMDQ17_v1,RMDQ19_v1,0.612244898,7.57E-26,49,171,169,2,19,30
8670,RMDQ18_v1,RMDQ19_v1,0.833333333,1.62E-37,36,184,182,2,6,30
8671,RMDQ19_v1,RMDQ19_v1,1,9.04E-50,32,188,188,0,0,32
8672,RMDQ20_v1,RMDQ19_v1,0.815789474,5.38E-38,38,182,181,1,7,31
8673,RMDQ21_v1,RMDQ19_v1,0.645833333,9.94E-29,48,172,171,1,17,31
8674,RMDQ22_v1,RMDQ19_v1,0.815789474,5.38E-38,38,182,181,1,7,31
8675,RMDQ23_v1,RMDQ19_v1,0.837837838,3.38E-39,37,183,182,1,6,31
8676,RMDQ24_v1,RMDQ19_v1,0.885714286,8.36E-42,35,185,184,1,4,31
8681,DN4 - Alfinetada e agulhada,RMDQ19_v1,0.241935484,0.011224323,62,150,134,16,47,15
8682,DN4 - Adormecimento,RMDQ19_v1,0.254237288,0.006896441,59,150,134,16,44,15
8684,DH4 - Hipoestesia ao toque,RMDQ19_v1,0.571428571,0.001204515,7,205,178,27,3,4
8685,DN4 - Hipoestesia a picada de agulha,RMDQ19_v1,0.571428571,0.001204515,7,205,178,27,3,4
8686,DN4 - Escovação,RMDQ19_v1,0.666666667,0.000252087,6,206,179,27,2,4
8687,Fuma,RMDQ20_v1,0.305555556,0.021260536,36,147,126,21,25,11
8692,Aposentado_Invalidez,RMDQ20_v1,0.5,0.012444048,8,171,144,27,4,4
8693,Analgésicos,RMDQ20_v1,0.219858156,0.004727577,141,57,54,3,110,31
8695,Dor nas costas,RMDQ20_v1,0.219512195,0.010781828,123,67,62,5,96,27
8718,D22,RMDQ20_v1,1,0.031770515,1,116,96,20,0,1
8732,D35,RMDQ20_v1,1,0.031770515,1,116,96,20,0,1
8737,D4,RMDQ20_v1,0.666666667,0.025909421,3,114,95,19,1,2
8741,D43,RMDQ20_v1,1,0.002289209,2,115,96,19,0,2
8750,D51,RMDQ20_v1,1,0.031770515,1,116,96,20,0,1
8752,D53,RMDQ20_v1,1,0.031770515,1,116,96,20,0,1
8753,D9,RMDQ20_v1,1,0.031770515,1,116,96,20,0,1
8754,RMDQ1_v1,RMDQ20_v1,0.364705882,1.73E-08,85,134,127,7,54,31
8755,RMDQ2_v1,RMDQ20_v1,0.355555556,1.82E-08,90,129,123,6,58,32
8756,RMDQ3_v1,RMDQ20_v1,0.417721519,6.22E-13,79,141,136,5,46,33
8758,RMDQ5_v1,RMDQ20_v1,0.472222222,2.47E-16,72,148,144,4,38,34
8759,RMDQ6_v1,RMDQ20_v1,0.660714286,4.62E-29,56,164,163,1,19,37
8760,RMDQ7_v1,RMDQ20_v1,0.846153846,1.39E-34,39,181,176,5,6,33
8761,RMDQ8_v1,RMDQ20_v1,0.875,8.66E-08,8,212,181,31,1,7
8762,RMDQ9_v1,RMDQ20_v1,0.970588235,7.40E-41,34,186,181,5,1,33
8763,RMDQ10_v1,RMDQ20_v1,0.875,1.40E-38,40,180,177,3,5,35
8764,RMDQ11_v1,RMDQ20_v1,0.833333333,2.36E-36,42,178,175,3,7,35
8765,RMDQ12_v1,RMDQ20_v1,0.795454545,2.51E-34,44,176,173,3,9,35
8766,RMDQ13_v1,RMDQ20_v1,0.717391304,4.34E-28,46,174,169,5,13,33
8767,RMDQ14_v1,RMDQ20_v1,0.693877551,6.92E-28,49,171,167,4,15,34
8768,RMDQ15_v1,RMDQ20_v1,0.870967742,1.31E-28,31,189,178,11,4,27
8769,RMDQ16_v1,RMDQ20_v1,0.891891892,6.85E-37,37,183,178,5,4,33
8770,RMDQ17_v1,RMDQ20_v1,0.714285714,5.57E-30,49,171,168,3,14,35
8771,RMDQ18_v1,RMDQ20_v1,0.916666667,3.86E-38,36,184,179,5,3,33
8772,RMDQ19_v1,RMDQ20_v1,0.96875,5.38E-38,32,188,181,7,1,31
8773,RMDQ20_v1,RMDQ20_v1,1,9.04E-50,38,182,182,0,0,38
8774,RMDQ21_v1,RMDQ20_v1,0.729166667,8.89E-31,48,172,169,3,13,35
8775,RMDQ22_v1,RMDQ20_v1,0.894736842,2.50E-38,38,182,178,4,4,34
8776,RMDQ23_v1,RMDQ20_v1,0.918918919,1.39E-39,37,183,179,4,3,34
8777,RMDQ24_v1,RMDQ20_v1,1,2.90E-45,35,185,182,3,0,35
8779,DN4 - Sensação de frio dolorosa,RMDQ20_v1,0.063829787,0.043131928,47,161,131,30,44,3
8782,DN4 - Alfinetada e agulhada,RMDQ20_v1,0.241935484,0.02590076,62,150,132,18,47,15
8783,DN4 - Adormecimento,RMDQ20_v1,0.237288136,0.048369471,59,150,131,19,45,14
8785,DH4 - Hipoestesia ao toque,RMDQ20_v1,0.571428571,0.002031223,7,205,176,29,3,4
8786,DN4 - Hipoestesia a picada de agulha,RMDQ20_v1,0.571428571,0.002031223,7,205,176,29,3,4
8787,DN4 - Escovação,RMDQ20_v1,0.666666667,0.000460768,6,206,177,29,2,4
8793,Aposentado_Invalidez,RMDQ21_v1,0.5,0.047958398,8,171,136,35,4,4
8794,Analgésicos,RMDQ21_v1,0.276595745,0.000482357,141,57,54,3,102,39
8798,Retornar_trabalho,RMDQ21_v1,0.526315789,0.001199768,19,168,135,33,9,10
8819,D22,RMDQ21_v1,1,0.04804517,1,116,93,23,0,1
8824,D27,RMDQ21_v1,0.75,0.006030785,4,113,92,21,1,3
8825,D28,RMDQ21_v1,0.6,0.025421986,5,112,91,21,2,3
8833,D35,RMDQ21_v1,1,0.04804517,1,116,93,23,0,1
8838,D4,RMDQ21_v1,0.666666667,0.044897228,3,114,92,22,1,2
8842,D43,RMDQ21_v1,1,0.004985247,2,115,93,22,0,2
8851,D51,RMDQ21_v1,1,0.04804517,1,116,93,23,0,1
8853,D53,RMDQ21_v1,1,0.04804517,1,116,93,23,0,1
8854,D9,RMDQ21_v1,1,0.04804517,1,116,93,23,0,1
8855,RMDQ1_v1,RMDQ21_v1,0.482352941,4.91E-13,85,134,127,7,44,41
8856,RMDQ2_v1,RMDQ21_v1,0.488888889,6.17E-15,90,129,125,4,46,44
8857,RMDQ3_v1,RMDQ21_v1,0.518987342,6.16E-16,79,141,134,7,38,41
8858,RMDQ4_v1,RMDQ21_v1,0.407407407,0.000106234,54,166,140,26,32,22
8859,RMDQ5_v1,RMDQ21_v1,0.583333333,5.88E-20,72,148,142,6,30,42
8860,RMDQ6_v1,RMDQ21_v1,0.625,1.37E-17,56,164,151,13,21,35
8861,RMDQ7_v1,RMDQ21_v1,0.846153846,1.21E-25,39,181,166,15,6,33
8862,RMDQ8_v1,RMDQ21_v1,0.875,4.60E-06,8,212,171,41,1,7
8863,RMDQ9_v1,RMDQ21_v1,0.970588235,7.15E-31,34,186,171,15,1,33
8864,RMDQ10_v1,RMDQ21_v1,0.925,5.35E-33,40,180,169,11,3,37
8865,RMDQ11_v1,RMDQ21_v1,0.880952381,6.43E-31,42,178,167,11,5,37
8866,RMDQ12_v1,RMDQ21_v1,0.795454545,3.55E-25,44,176,163,13,9,35
8867,RMDQ13_v1,RMDQ21_v1,0.717391304,3.03E-20,46,174,159,15,13,33
8868,RMDQ14_v1,RMDQ21_v1,0.734693878,3.10E-23,49,171,159,12,13,36
8869,RMDQ15_v1,RMDQ21_v1,0.870967742,2.21E-21,31,189,168,21,4,27
8870,RMDQ16_v1,RMDQ21_v1,0.864864865,1.58E-25,37,183,167,16,5,32
8871,RMDQ17_v1,RMDQ21_v1,0.734693878,3.10E-23,49,171,159,12,13,36
8872,RMDQ18_v1,RMDQ21_v1,0.972222222,4.63E-33,36,184,171,13,1,35
8873,RMDQ19_v1,RMDQ21_v1,0.96875,9.94E-29,32,188,171,17,1,31
8874,RMDQ20_v1,RMDQ21_v1,0.921052632,8.89E-31,38,182,169,13,3,35
8875,RMDQ21_v1,RMDQ21_v1,1,9.04E-50,48,172,172,0,0,48
8876,RMDQ22_v1,RMDQ21_v1,0.894736842,1.22E-28,38,182,168,14,4,34
8877,RMDQ23_v1,RMDQ21_v1,0.918918919,1.10E-29,37,183,169,14,3,34
8878,RMDQ24_v1,RMDQ21_v1,1,2.67E-34,35,185,172,13,0,35
8880,DN4 - Sensação de frio dolorosa,RMDQ21_v1,0.063829787,0.009034587,47,161,123,38,44,3
8881,DN4 - Choque elétrico,RMDQ21_v1,0.1,0.030525688,60,152,117,35,54,6
8884,DN4 - Adormecimento,RMDQ21_v1,0.305084746,0.012891839,59,150,127,23,41,18
8886,DH4 - Hipoestesia ao toque,RMDQ21_v1,0.571428571,0.010017545,7,205,168,37,3,4
8887,DN4 - Hipoestesia a picada de agulha,RMDQ21_v1,0.571428571,0.010017545,7,205,168,37,3,4
8888,DN4 - Escovação,RMDQ21_v1,0.666666667,0.002905223,6,206,169,37,2,4
8894,Aposentado_Invalidez,RMDQ22_v1,0.5,0.015262312,8,171,143,28,4,4
8895,Analgésicos,RMDQ22_v1,0.205673759,0.046299011,141,57,52,5,112,29
8920,D22,RMDQ22_v1,1,0.026984377,1,116,97,19,0,1
8934,D35,RMDQ22_v1,1,0.026984377,1,116,97,19,0,1
8939,D4,RMDQ22_v1,0.666666667,0.020853932,3,114,96,18,1,2
8952,D51,RMDQ22_v1,1,0.026984377,1,116,97,19,0,1
8955,D9,RMDQ22_v1,1,0.026984377,1,116,97,19,0,1
8956,RMDQ1_v1,RMDQ22_v1,0.341176471,1.05E-06,85,134,125,9,56,29
8957,RMDQ2_v1,RMDQ22_v1,0.333333333,1.06E-06,90,129,121,8,60,30
8958,RMDQ3_v1,RMDQ22_v1,0.46835443,3.86E-18,79,141,140,1,42,37
8959,RMDQ4_v1,RMDQ22_v1,0.277777778,0.018724428,54,166,143,23,39,15
8960,RMDQ5_v1,RMDQ22_v1,0.527777778,2.55E-22,72,148,148,0,34,38
8961,RMDQ6_v1,RMDQ22_v1,0.678571429,4.20E-31,56,164,164,0,18,38
8962,RMDQ7_v1,RMDQ22_v1,0.820512821,3.97E-32,39,181,175,6,7,32
8963,RMDQ8_v1,RMDQ22_v1,0.875,8.66E-08,8,212,181,31,1,7
8964,RMDQ9_v1,RMDQ22_v1,0.941176471,5.02E-38,34,186,180,6,2,32
8965,RMDQ10_v1,RMDQ22_v1,0.85,5.28E-36,40,180,176,4,6,34
8966,RMDQ11_v1,RMDQ22_v1,0.80952381,6.70E-34,42,178,174,4,8,34
8967,RMDQ12_v1,RMDQ22_v1,0.772727273,5.48E-32,44,176,172,4,10,34
8968,RMDQ13_v1,RMDQ22_v1,0.695652174,5.08E-26,46,174,168,6,14,32
8969,RMDQ14_v1,RMDQ22_v1,0.673469388,7.16E-26,49,171,166,5,16,33
8970,RMDQ15_v1,RMDQ22_v1,0.870967742,1.31E-28,31,189,178,11,4,27
8971,RMDQ16_v1,RMDQ22_v1,0.837837838,8.45E-32,37,183,176,7,6,31
8972,RMDQ17_v1,RMDQ22_v1,0.673469388,7.16E-26,49,171,166,5,16,33
8973,RMDQ18_v1,RMDQ22_v1,0.916666667,3.86E-38,36,184,179,5,3,33
8974,RMDQ19_v1,RMDQ22_v1,0.96875,5.38E-38,32,188,181,7,1,31
8975,RMDQ20_v1,RMDQ22_v1,0.894736842,2.50E-38,38,182,178,4,4,34
8976,RMDQ21_v1,RMDQ22_v1,0.708333333,1.22E-28,48,172,168,4,14,34
8977,RMDQ22_v1,RMDQ22_v1,1,9.04E-50,38,182,182,0,0,38
8978,RMDQ23_v1,RMDQ22_v1,0.918918919,1.39E-39,37,183,179,4,3,34
8979,RMDQ24_v1,RMDQ22_v1,0.971428571,2.61E-42,35,185,181,4,1,34
8984,DN4 - Alfinetada e agulhada,RMDQ22_v1,0.241935484,0.037477913,62,150,131,19,47,15
8985,DN4 - Adormecimento,RMDQ22_v1,0.288135593,0.002056114,59,150,133,17,42,17
8987,DH4 - Hipoestesia ao toque,RMDQ22_v1,0.571428571,0.002579511,7,205,175,30,3,4
8988,DN4 - Hipoestesia a picada de agulha,RMDQ22_v1,0.571428571,0.002579511,7,205,175,30,3,4
8989,DN4 - Escovação,RMDQ22_v1,0.666666667,0.000607086,6,206,176,30,2,4
8995,Aposentado_Invalidez,RMDQ23_v1,0.5,0.012444048,8,171,144,27,4,4
8996,Analgésicos,RMDQ23_v1,0.212765957,0.016003095,141,57,53,4,111,30
8998,Dor nas costas,RMDQ23_v1,0.211382114,0.032035955,123,67,61,6,97,26
9021,D22,RMDQ23_v1,1,0.022556252,1,116,98,18,0,1
9030,Lombalgia,Dor nas pernas,0.655737705,1.12E-06,61,66,51,15,21,40
9035,D35,RMDQ23_v1,1,0.022556252,1,116,98,18,0,1
9040,D4,RMDQ23_v1,0.666666667,0.016431718,3,114,97,17,1,2
9053,D51,RMDQ23_v1,1,0.022556252,1,116,98,18,0,1
9056,D9,RMDQ23_v1,1,0.022556252,1,116,98,18,0,1
9057,RMDQ1_v1,RMDQ23_v1,0.341176471,3.63E-07,85,134,126,8,56,29
9058,RMDQ2_v1,RMDQ23_v1,0.333333333,3.53E-07,90,129,122,7,60,30
9059,RMDQ3_v1,RMDQ23_v1,0.417721519,1.29E-13,79,141,137,4,46,33
9061,RMDQ5_v1,RMDQ23_v1,0.472222222,4.11E-17,72,148,145,3,38,34
9062,RMDQ6_v1,RMDQ23_v1,0.607142857,2.64E-24,56,164,161,3,22,34
9063,RMDQ7_v1,RMDQ23_v1,0.820512821,3.23E-33,39,181,176,5,7,32
9064,RMDQ8_v1,RMDQ23_v1,0.875,5.18E-08,8,212,182,30,1,7
9065,RMDQ9_v1,RMDQ23_v1,0.941176471,3.05E-39,34,186,181,5,2,32
9066,RMDQ10_v1,RMDQ23_v1,0.925,1.92E-45,40,180,180,0,3,37
9067,RMDQ11_v1,RMDQ23_v1,0.80952381,4.63E-35,42,178,175,3,8,34
9068,RMDQ12_v1,RMDQ23_v1,0.772727273,4.16E-33,44,176,173,3,10,34
9069,RMDQ13_v1,RMDQ23_v1,0.695652174,5.61E-27,46,174,169,5,14,32
9070,RMDQ14_v1,RMDQ23_v1,0.673469388,7.67E-27,49,171,167,4,16,33
9071,RMDQ15_v1,RMDQ23_v1,0.870967742,1.52E-29,31,189,179,10,4,27
9072,RMDQ16_v1,RMDQ23_v1,0.837837838,7.25E-33,37,183,177,6,6,31
9073,RMDQ17_v1,RMDQ23_v1,0.673469388,7.67E-27,49,171,167,4,16,33
9074,RMDQ18_v1,RMDQ23_v1,0.916666667,2.24E-39,36,184,180,4,3,33
9075,RMDQ19_v1,RMDQ23_v1,0.96875,3.38E-39,32,188,182,6,1,31
9076,RMDQ20_v1,RMDQ23_v1,0.894736842,1.39E-39,38,182,179,3,4,34
9077,RMDQ21_v1,RMDQ23_v1,0.708333333,1.10E-29,48,172,169,3,14,34
9078,RMDQ22_v1,RMDQ23_v1,0.894736842,1.39E-39,38,182,179,3,4,34
9079,RMDQ23_v1,RMDQ23_v1,1,9.04E-50,37,183,183,0,0,37
9080,RMDQ24_v1,RMDQ23_v1,0.971428571,1.19E-43,35,185,182,3,1,34
9085,DN4 - Alfinetada e agulhada,RMDQ23_v1,0.241935484,0.02590076,62,150,132,18,47,15
9086,DN4 - Adormecimento,RMDQ23_v1,0.237288136,0.048369471,59,150,131,19,45,14
9088,DH4 - Hipoestesia ao toque,RMDQ23_v1,0.571428571,0.002031223,7,205,176,29,3,4
9089,DN4 - Hipoestesia a picada de agulha,RMDQ23_v1,0.571428571,0.002031223,7,205,176,29,3,4
9090,DN4 - Escovação,RMDQ23_v1,0.666666667,0.000460768,6,206,177,29,2,4
9091,Fuma,RMDQ24_v1,0.305555556,0.01509902,36,147,127,20,25,11
9096,Aposentado_Invalidez,RMDQ24_v1,0.5,0.007942392,8,171,146,25,4,4
9097,Analgésicos,RMDQ24_v1,0.205673759,0.008075987,141,57,54,3,112,29
9099,Dor nas costas,RMDQ24_v1,0.203252033,0.020172579,123,67,62,5,98,25
9122,D22,RMDQ24_v1,1,0.022556252,1,116,98,18,0,1
9136,D35,RMDQ24_v1,1,0.022556252,1,116,98,18,0,1
9141,D4,RMDQ24_v1,0.666666667,0.016431718,3,114,97,17,1,2
9145,D43,RMDQ24_v1,1,0.001196854,2,115,98,17,0,2
9154,D51,RMDQ24_v1,1,0.022556252,1,116,98,18,0,1
9156,D53,RMDQ24_v1,1,0.022556252,1,116,98,18,0,1
9157,D9,RMDQ24_v1,1,0.022556252,1,116,98,18,0,1
9158,RMDQ1_v1,RMDQ24_v1,0.352941176,3.54E-09,85,134,129,5,55,30
9159,RMDQ2_v1,RMDQ24_v1,0.344444444,3.20E-09,90,129,125,4,59,31
9160,RMDQ3_v1,RMDQ24_v1,0.417721519,4.14E-15,79,141,139,2,46,33
9162,RMDQ5_v1,RMDQ24_v1,0.472222222,8.24E-19,72,148,147,1,38,34
9163,RMDQ6_v1,RMDQ24_v1,0.625,2.44E-28,56,164,164,0,21,35
9164,RMDQ7_v1,RMDQ24_v1,0.846153846,2.93E-38,39,181,179,2,6,33
9165,RMDQ8_v1,RMDQ24_v1,0.875,1.70E-08,8,212,184,28,1,7
9166,RMDQ9_v1,RMDQ24_v1,0.970588235,5.83E-45,34,186,184,2,1,33
9167,RMDQ10_v1,RMDQ24_v1,0.875,1.24E-42,40,180,180,0,5,35
9168,RMDQ11_v1,RMDQ24_v1,0.833333333,2.97E-40,42,178,178,0,7,35
9169,RMDQ12_v1,RMDQ24_v1,0.795454545,4.33E-38,44,176,176,0,9,35
9170,RMDQ13_v1,RMDQ24_v1,0.717391304,2.55E-31,46,174,172,2,13,33
9171,RMDQ14_v1,RMDQ24_v1,0.693877551,3.71E-31,49,171,170,1,15,34
9172,RMDQ15_v1,RMDQ24_v1,0.870967742,1.41E-31,31,189,181,8,4,27
9173,RMDQ16_v1,RMDQ24_v1,0.864864865,6.70E-38,37,183,180,3,5,32
9174,RMDQ17_v1,RMDQ24_v1,0.673469388,5.98E-29,49,171,169,2,16,33
9175,RMDQ18_v1,RMDQ24_v1,0.916666667,4.66E-42,36,184,182,2,3,33
9176,RMDQ19_v1,RMDQ24_v1,0.96875,8.36E-42,32,188,184,4,1,31
9177,RMDQ20_v1,RMDQ24_v1,0.921052632,2.90E-45,38,182,182,0,3,35
9178,RMDQ21_v1,RMDQ24_v1,0.729166667,2.67E-34,48,172,172,0,13,35
9179,RMDQ22_v1,RMDQ24_v1,0.894736842,2.61E-42,38,182,181,1,4,34
9180,RMDQ23_v1,RMDQ24_v1,0.918918919,1.19E-43,37,183,182,1,3,34
9181,RMDQ24_v1,RMDQ24_v1,1,9.04E-50,35,185,185,0,0,35
9186,DN4 - Alfinetada e agulhada,RMDQ24_v1,0.241935484,0.006993711,62,150,135,15,47,15
9187,DN4 - Adormecimento,RMDQ24_v1,0.237288136,0.015341269,59,150,134,16,45,14
9189,DH4 - Hipoestesia ao toque,RMDQ24_v1,0.571428571,0.000904416,7,205,179,26,3,4
9190,DN4 - Hipoestesia a picada de agulha,RMDQ24_v1,0.571428571,0.000904416,7,205,179,26,3,4
9191,DN4 - Escovação,RMDQ24_v1,0.666666667,0.000181095,6,206,180,26,2,4
9198,Analgésicos,DN4 - Queimação,0.548148148,0.001204309,135,63,44,19,61,74
9200,Dor nas costas,DN4 - Queimação,0.504273504,0.049836366,117,75,48,27,58,59
9201,Dor nas pernas,DN4 - Queimação,0.639344262,0.000252532,61,129,83,46,22,39
9220,D2,DN4 - Queimação,0.857142857,0.025252758,7,111,64,47,1,6
NA.100,NA,NA,NA,NA,NA,NA,NA,NA,NA,NA
9225,D24,DN4 - Queimação,0.25,0.027974988,24,94,47,47,18,6
9232,Lombalgia,Analgésicos,0.85483871,3.44E-05,62,68,33,35,9,53
9247,D44,DN4 - Queimação,0.594594595,0.031815051,37,81,50,31,15,22
9248,D45,DN4 - Queimação,0.833333333,0.004758539,12,106,63,43,2,10
9249,D46,DN4 - Queimação,0.621621622,0.010907577,37,81,51,30,14,23
9250,D47,DN4 - Queimação,0.833333333,0.004758539,12,106,63,43,2,10
9283,DN4 - Queimação,DN4 - Queimação,1,9.04E-50,101,119,119,0,0,101
9284,DN4 - Sensação de frio dolorosa,DN4 - Queimação,0.833333333,1.29E-09,48,168,111,57,8,40
9285,DN4 - Choque elétrico,DN4 - Queimação,0.754098361,5.37E-08,61,159,104,55,15,46
9286,DN4 - Formigamento,DN4 - Queimação,0.842105263,1.57E-11,57,163,110,53,9,48
9287,DN4 - Alfinetada e agulhada,DN4 - Queimação,0.707692308,1.65E-06,65,155,100,55,19,46
9288,DN4 - Adormecimento,DN4 - Queimação,0.741935484,1.34E-07,62,158,103,55,16,46
9289,DN4 - Coceira,DN4 - Queimação,0.818181818,0.014204906,11,209,117,92,2,9
9292,DN4 - Escovação,DN4 - Queimação,0.857142857,0.031727687,7,213,118,95,1,6
9299,Analgésicos,DN4 - Sensação de frio dolorosa,0.268656716,0.044360433,134,64,55,9,98,36
9306,Casado/Amasiaado,DN4 - Sensação de frio dolorosa,0.341772152,0.00050022,79,103,90,13,52,27
9307,Solteiro,DN4 - Sensação de frio dolorosa,0.128205128,0.009774876,78,104,74,30,68,10
9315,D1,DN4 - Sensação de frio dolorosa,1,0.0468674,1,117,94,23,0,1
NA.101,NA,NA,NA,NA,NA,NA,NA,NA,NA,NA
9347,D43,DN4 - Sensação de frio dolorosa,1,0.0468674,1,117,94,23,0,1
9358,D53,DN4 - Sensação de frio dolorosa,1,0.0468674,1,117,94,23,0,1
9360,RMDQ1_v1,DN4 - Sensação de frio dolorosa,0.135802469,0.036360777,81,126,90,36,70,11
9361,RMDQ2_v1,DN4 - Sensação de frio dolorosa,0.134146341,0.030275437,82,125,89,36,71,11
9362,RMDQ3_v1,DN4 - Sensação de frio dolorosa,0.323943662,0.014995913,71,137,113,24,48,23
9363,RMDQ4_v1,DN4 - Sensação de frio dolorosa,0.395348837,0.00286381,43,165,135,30,26,17
9366,RMDQ7_v1,DN4 - Sensação de frio dolorosa,0.083333333,0.024434786,36,172,128,44,33,3
9371,RMDQ12_v1,DN4 - Sensação de frio dolorosa,0.076923077,0.013549261,39,169,125,44,36,3
9375,RMDQ16_v1,DN4 - Sensação de frio dolorosa,0.088235294,0.03577336,34,174,130,44,31,3
9379,RMDQ20_v1,DN4 - Sensação de frio dolorosa,0.090909091,0.043131928,33,175,131,44,30,3
9380,RMDQ21_v1,DN4 - Sensação de frio dolorosa,0.073170732,0.009034587,41,167,123,44,38,3
9384,DN4 - Queimação,DN4 - Sensação de frio dolorosa,0.412371134,1.29E-09,97,119,111,8,57,40
9385,DN4 - Sensação de frio dolorosa,DN4 - Sensação de frio dolorosa,1,1.49E-49,48,171,171,0,0,48
9387,DN4 - Formigamento,DN4 - Sensação de frio dolorosa,0.433962264,1.42E-05,53,166,141,25,30,23
9388,DN4 - Alfinetada e agulhada,DN4 - Sensação de frio dolorosa,0.098360656,0.007243706,61,158,116,42,55,6
9398,Licenca_Medica,DN4 - Choque elétrico,0.470588235,0.032747284,17,167,128,39,9,8
9403,Dor nas pernas,DN4 - Choque elétrico,0.467741935,4.07E-05,62,130,106,24,33,29
9417,D15,DN4 - Choque elétrico,0.714285714,0.014498693,7,112,81,31,2,5
9421,D19,DN4 - Choque elétrico,0.8,0.013352924,5,114,82,32,1,4
9422,D2,DN4 - Choque elétrico,0.714285714,0.014498693,7,112,81,31,2,5
NA.102,NA,NA,NA,NA,NA,NA,NA,NA,NA,NA
9433,D3,DN4 - Choque elétrico,1,0.030339821,2,117,83,34,0,2
9434,Lombalgia,Dor nas costas,0.918032787,8.15E-07,61,67,32,35,5,56
9435,D31,DN4 - Choque elétrico,0.6875,0.000314121,16,103,78,25,5,11
9437,D33,DN4 - Choque elétrico,0.583333333,0.025529852,12,107,78,29,5,7
9444,D4,DN4 - Choque elétrico,1,0.007727575,3,116,83,33,0,3
9450,D45,DN4 - Choque elétrico,0.583333333,0.025529852,12,107,78,29,5,7
9452,D47,DN4 - Choque elétrico,0.75,0.000372577,12,107,80,27,3,9
9454,D49,DN4 - Choque elétrico,0.615384615,0.009268729,13,106,78,28,5,8
9472,RMDQ12_v1,DN4 - Choque elétrico,0.153846154,0.047436981,39,173,119,54,33,6
9473,RMDQ13_v1,DN4 - Choque elétrico,0.139534884,0.019315803,43,169,115,54,37,6
9481,RMDQ21_v1,DN4 - Choque elétrico,0.146341463,0.030525688,41,171,117,54,35,6
9485,DN4 - Queimação,DN4 - Choque elétrico,0.455445545,5.37E-08,101,119,104,15,55,46
9487,DN4 - Choque elétrico,DN4 - Choque elétrico,1,2.00E-50,61,162,162,0,0,61
9488,DN4 - Formigamento,DN4 - Choque elétrico,0.631578947,2.09E-12,57,166,141,25,21,36
9489,DN4 - Alfinetada e agulhada,DN4 - Choque elétrico,0.646153846,1.18E-15,65,158,139,19,23,42
9490,DN4 - Adormecimento,DN4 - Choque elétrico,0.532258065,1.21E-07,62,158,130,28,29,33
9491,DN4 - Coceira,DN4 - Choque elétrico,0.818181818,3.24E-05,11,212,160,52,2,9
9492,DH4 - Hipoestesia ao toque,DN4 - Choque elétrico,0.875,0.000101674,8,215,161,54,1,7
9493,DN4 - Hipoestesia a picada de agulha,DN4 - Choque elétrico,0.666666667,0.006919046,9,214,159,55,3,6
9494,DN4 - Escovação,DN4 - Choque elétrico,0.857142857,0.000432473,7,216,161,55,1,6
9504,Dor nas pernas,DN4 - Formigamento,0.387096774,0.001539604,62,130,107,23,38,24
9515,Livrar_perna,DN4 - Formigamento,0.5,0.027950488,14,106,82,24,7,7
NA.103,NA,NA,NA,NA,NA,NA,NA,NA,NA,NA
9528,D24,DN4 - Formigamento,0.041666667,0.006261147,24,95,65,30,23,1
9538,D33,DN4 - Formigamento,0.75,4.62E-05,12,107,85,22,3,9
9551,D45,DN4 - Formigamento,0.666666667,0.000723216,12,107,84,23,4,8
9553,D47,DN4 - Formigamento,0.666666667,0.000723216,12,107,84,23,4,8
9554,D48,DN4 - Formigamento,0.48,0.004902155,25,94,75,19,13,12
9555,D49,DN4 - Formigamento,0.769230769,9.51E-06,13,106,85,21,3,10
9575,RMDQ14_v1,DN4 - Formigamento,0.142857143,0.046473324,42,170,120,50,36,6
9586,DN4 - Queimação,DN4 - Formigamento,0.475247525,1.57E-11,101,119,110,9,53,48
9587,DN4 - Sensação de frio dolorosa,DN4 - Formigamento,0.479166667,1.42E-05,48,171,141,30,25,23
9588,DN4 - Choque elétrico,DN4 - Formigamento,0.590163934,2.09E-12,61,162,141,21,25,36
9589,DN4 - Formigamento,DN4 - Formigamento,1,2.00E-50,57,166,166,0,0,57
9590,DN4 - Alfinetada e agulhada,DN4 - Formigamento,0.569230769,5.71E-12,65,158,138,20,28,37
9591,DN4 - Adormecimento,DN4 - Formigamento,0.451612903,4.45E-05,62,158,129,29,34,28
9592,DN4 - Coceira,DN4 - Formigamento,0.636363636,0.002985489,11,212,162,50,4,7
9596,Fuma,DN4 - Alfinetada e agulhada,0.435897436,0.018814926,39,147,111,36,22,17
9600,Licenca_Medica,DN4 - Alfinetada e agulhada,0.529411765,0.01473243,17,167,125,42,8,9
9603,OutraDoenca,DN4 - Alfinetada e agulhada,0.397260274,0.034318583,73,119,89,30,44,29
9605,Dor nas pernas,DN4 - Alfinetada e agulhada,0.451612903,0.000758979,62,130,102,28,34,28
9609,Casado/Amasiaado,DN4 - Alfinetada e agulhada,0.222222222,0.048651461,81,104,67,37,63,18
9612,X4,DN4 - Alfinetada e agulhada,1,0.007258773,3,182,130,52,0,3
9619,D15,DN4 - Alfinetada e agulhada,0.714285714,0.014498693,7,112,81,31,2,5
9622,D18,DN4 - Alfinetada e agulhada,0.6,0.032370928,10,109,79,30,4,6
9624,D2,DN4 - Alfinetada e agulhada,0.714285714,0.014498693,7,112,81,31,2,5
NA.104,NA,NA,NA,NA,NA,NA,NA,NA,NA,NA
9632,D27,DN4 - Alfinetada e agulhada,1,0.002007139,4,115,83,32,0,4
9633,D28,DN4 - Alfinetada e agulhada,0.75,0.047489344,4,115,82,33,1,3
9635,D3,DN4 - Alfinetada e agulhada,1,0.030339821,2,117,83,34,0,2
9637,D31,DN4 - Alfinetada e agulhada,0.625,0.002541356,16,103,77,26,6,10
9639,D33,DN4 - Alfinetada e agulhada,0.583333333,0.025529852,12,107,78,29,5,7
9642,D36,DN4 - Alfinetada e agulhada,0.75,0.004332247,8,111,81,30,2,6
9644,D38,DN4 - Alfinetada e agulhada,1,0.007727575,3,116,83,33,0,3
9646,D4,DN4 - Alfinetada e agulhada,1,0.007727575,3,116,83,33,0,3
9647,D40,DN4 - Alfinetada e agulhada,0.8,0.013352924,5,114,82,32,1,4
9648,D41,DN4 - Alfinetada e agulhada,0.714285714,0.014498693,7,112,81,31,2,5
9652,D45,DN4 - Alfinetada e agulhada,0.666666667,0.003779086,12,107,79,28,4,8
9654,D47,DN4 - Alfinetada e agulhada,0.75,0.000372577,12,107,80,27,3,9
9656,D49,DN4 - Alfinetada e agulhada,0.615384615,0.009268729,13,106,78,28,5,8
9667,RMDQ5_v1,DN4 - Alfinetada e agulhada,0.382352941,0.047995804,68,144,108,36,42,26
9668,RMDQ6_v1,DN4 - Alfinetada e agulhada,0.450980392,0.004291836,51,161,122,39,28,23
9669,RMDQ7_v1,DN4 - Alfinetada e agulhada,0.5,0.002660066,36,176,132,44,18,18
9670,RMDQ8_v1,DN4 - Alfinetada e agulhada,1,2.85E-05,7,205,150,55,0,7
9671,RMDQ9_v1,DN4 - Alfinetada e agulhada,0.483870968,0.011224323,31,181,134,47,16,15
9672,RMDQ10_v1,DN4 - Alfinetada e agulhada,0.454545455,0.02590076,33,179,132,47,18,15
9673,RMDQ11_v1,DN4 - Alfinetada e agulhada,0.542857143,0.000365088,35,177,134,43,16,19
9680,RMDQ18_v1,DN4 - Alfinetada e agulhada,0.466666667,0.023576208,30,182,134,48,16,14
9681,RMDQ19_v1,DN4 - Alfinetada e agulhada,0.483870968,0.011224323,31,181,134,47,16,15
9682,RMDQ20_v1,DN4 - Alfinetada e agulhada,0.454545455,0.02590076,33,179,132,47,18,15
9684,RMDQ22_v1,DN4 - Alfinetada e agulhada,0.441176471,0.037477913,34,178,131,47,19,15
9685,RMDQ23_v1,DN4 - Alfinetada e agulhada,0.454545455,0.02590076,33,179,132,47,18,15
9686,RMDQ24_v1,DN4 - Alfinetada e agulhada,0.5,0.006993711,30,182,135,47,15,15
9687,DN4 - Queimação,DN4 - Alfinetada e agulhada,0.455445545,1.65E-06,101,119,100,19,55,46
9688,DN4 - Sensação de frio dolorosa,DN4 - Alfinetada e agulhada,0.125,0.007243706,48,171,116,55,42,6
9689,DN4 - Choque elétrico,DN4 - Alfinetada e agulhada,0.68852459,1.18E-15,61,162,139,23,19,42
9690,DN4 - Formigamento,DN4 - Alfinetada e agulhada,0.649122807,5.71E-12,57,166,138,28,20,37
9691,DN4 - Alfinetada e agulhada,DN4 - Alfinetada e agulhada,1,2.00E-50,65,158,158,0,0,65
9692,DN4 - Adormecimento,DN4 - Alfinetada e agulhada,0.596774194,8.45E-10,62,158,130,28,25,37
9693,DN4 - Coceira,DN4 - Alfinetada e agulhada,1,1.14E-07,11,212,158,54,0,11
9694,DH4 - Hipoestesia ao toque,DN4 - Alfinetada e agulhada,0.875,0.000216673,8,215,157,58,1,7
9695,DN4 - Hipoestesia a picada de agulha,DN4 - Alfinetada e agulhada,1,1.80E-06,9,214,158,56,0,9
9696,DN4 - Escovação,DN4 - Alfinetada e agulhada,1,2.77E-05,7,216,158,58,0,7
9706,Dor nas pernas,DN4 - Adormecimento,0.426229508,0.006262141,61,129,99,30,35,26
9714,X5,DN4 - Adormecimento,0.8,0.012071721,5,178,128,50,1,4
NA.105,NA,NA,NA,NA,NA,NA,NA,NA,NA,NA
9730,D24,DN4 - Adormecimento,0.083333333,0.016353386,24,94,63,31,22,2
9733,D27,DN4 - Adormecimento,0.75,0.032983476,4,114,84,30,1,3
9734,D28,DN4 - Adormecimento,1,0.00109209,4,114,85,29,0,4
9737,Lombalgia,Lombalgia,1,2.00E-31,62,74,74,0,0,62
9738,D31,DN4 - Adormecimento,0.5,0.034680647,16,102,77,25,8,8
9744,D37,DN4 - Adormecimento,0.454545455,0.042743741,22,96,73,23,12,10
9764,RMDQ1_v1,DN4 - Adormecimento,0.382716049,0.008152081,81,127,100,27,50,31
9765,RMDQ2_v1,DN4 - Adormecimento,0.365853659,0.022231549,82,126,98,28,52,30
9768,RMDQ5_v1,DN4 - Adormecimento,0.382352941,0.025634363,68,141,108,33,42,26
9769,RMDQ6_v1,DN4 - Adormecimento,0.431372549,0.006522893,51,158,121,37,29,22
9772,RMDQ9_v1,DN4 - Adormecimento,0.451612903,0.023242032,31,178,133,45,17,14
9773,RMDQ10_v1,DN4 - Adormecimento,0.424242424,0.048369471,33,176,131,45,19,14
9781,RMDQ18_v1,DN4 - Adormecimento,0.466666667,0.015341269,30,179,134,45,16,14
9782,RMDQ19_v1,DN4 - Adormecimento,0.483870968,0.006896441,31,178,134,44,16,15
9783,RMDQ20_v1,DN4 - Adormecimento,0.424242424,0.048369471,33,176,131,45,19,14
9784,RMDQ21_v1,DN4 - Adormecimento,0.43902439,0.012891839,41,168,127,41,23,18
9785,RMDQ22_v1,DN4 - Adormecimento,0.5,0.002056114,34,175,133,42,17,17
9786,RMDQ23_v1,DN4 - Adormecimento,0.424242424,0.048369471,33,176,131,45,19,14
9787,RMDQ24_v1,DN4 - Adormecimento,0.466666667,0.015341269,30,179,134,45,16,14
9788,DN4 - Queimação,DN4 - Adormecimento,0.455445545,1.34E-07,101,119,103,16,55,46
9790,DN4 - Choque elétrico,DN4 - Adormecimento,0.540983607,1.21E-07,61,159,130,29,28,33
9791,DN4 - Formigamento,DN4 - Adormecimento,0.49122807,4.45E-05,57,163,129,34,29,28
9792,DN4 - Alfinetada e agulhada,DN4 - Adormecimento,0.569230769,8.45E-10,65,155,130,25,28,37
9793,DN4 - Adormecimento,DN4 - Adormecimento,1,9.04E-50,62,158,158,0,0,62
9794,DN4 - Coceira,DN4 - Adormecimento,0.818181818,4.97E-05,11,209,156,53,2,9
9795,DH4 - Hipoestesia ao toque,DN4 - Adormecimento,0.625,0.027955137,8,212,155,57,3,5
9796,DN4 - Hipoestesia a picada de agulha,DN4 - Adormecimento,0.777777778,0.000732709,9,211,156,55,2,7
9797,DN4 - Escovação,DN4 - Adormecimento,0.714285714,0.009744321,7,213,156,57,2,5
9798,Fuma,DN4 - Coceira,0.102564103,0.039205208,39,147,143,4,35,4
9800,Aposentado,DN4 - Coceira,0.090909091,0.035505939,33,153,150,3,30,3
9802,Licenca_Medica,DN4 - Coceira,0.176470588,0.000455707,17,167,164,3,14,3
9803,Aposentado_Invalidez,DN4 - Coceira,0.25,0.000437803,8,174,170,4,6,2
9814,X4,DN4 - Coceira,0.333333333,0.006842345,3,182,176,6,2,1
9816,X6,DN4 - Coceira,0.181818182,0.009862403,11,174,169,5,9,2
9826,D2,DN4 - Coceira,0.285714286,0.003361086,7,112,108,4,5,2
NA.106,NA,NA,NA,NA,NA,NA,NA,NA,NA,NA
9837,D3,DN4 - Coceira,0.5,0.003384702,2,117,112,5,1,1
9842,D34,DN4 - Coceira,0.333333333,0.023314143,3,116,111,5,2,1
9843,D35,DN4 - Coceira,1,1.31E-05,1,118,113,5,0,1
9848,D4,DN4 - Coceira,0.666666667,7.78E-07,3,116,112,4,1,2
9859,D5,DN4 - Coceira,0.333333333,0.023314143,3,116,111,5,2,1
9861,D51,DN4 - Coceira,1,1.31E-05,1,118,113,5,0,1
9864,D9,DN4 - Coceira,1,1.31E-05,1,118,113,5,0,1
9889,DN4 - Queimação,DN4 - Coceira,0.089108911,0.014204906,101,119,117,2,92,9
9891,DN4 - Choque elétrico,DN4 - Coceira,0.147540984,3.24E-05,61,162,160,2,52,9
9892,DN4 - Formigamento,DN4 - Coceira,0.122807018,0.002985489,57,166,162,4,50,7
9893,DN4 - Alfinetada e agulhada,DN4 - Coceira,0.169230769,1.14E-07,65,158,158,0,54,11
9894,DN4 - Adormecimento,DN4 - Coceira,0.14516129,4.97E-05,62,158,156,2,53,9
9895,DN4 - Coceira,DN4 - Coceira,1,2.00E-50,11,212,212,0,0,11
9896,DH4 - Hipoestesia ao toque,DN4 - Coceira,0.375,1.48E-05,8,215,207,8,5,3
9897,DN4 - Hipoestesia a picada de agulha,DN4 - Coceira,0.333333333,5.91E-05,9,214,206,8,6,3
9898,DN4 - Escovação,DN4 - Coceira,0.428571429,2.50E-06,7,216,208,8,4,3
9899,Fuma,DH4 - Hipoestesia ao toque,0.102564103,0.016544161,39,147,144,3,35,4
9902,Desempregado,DH4 - Hipoestesia ao toque,0.115384615,0.00294161,26,157,155,2,23,3
9903,Licenca_Medica,DH4 - Hipoestesia ao toque,0.117647059,0.016029306,17,167,164,3,15,2
9904,Aposentado_Invalidez,DH4 - Hipoestesia ao toque,0.25,0.000437803,8,174,170,4,6,2
9908,Dor nas pernas,DH4 - Hipoestesia ao toque,0.080645161,0.006595299,62,130,129,1,57,5
9909,Retornar_trabalho,DH4 - Hipoestesia ao toque,0.176470588,0.001306649,17,174,170,4,14,3
9927,D2,DH4 - Hipoestesia ao toque,0.285714286,0.000924203,7,112,109,3,5,2
NA.107,NA,NA,NA,NA,NA,NA,NA,NA,NA,NA
9938,D3,DH4 - Hipoestesia ao toque,0.5,0.001130826,2,117,113,4,1,1
9943,D34,DH4 - Hipoestesia ao toque,0.666666667,4.71E-08,3,116,113,3,1,2
9944,D35,DH4 - Hipoestesia ao toque,1,1.63E-06,1,118,114,4,0,1
9949,D4,DH4 - Hipoestesia ao toque,0.666666667,4.71E-08,3,116,113,3,1,2
9953,D43,DH4 - Hipoestesia ao toque,1,1.63E-06,1,118,114,4,0,1
9960,D5,DH4 - Hipoestesia ao toque,0.333333333,0.010856066,3,116,112,4,2,1
9961,D50,DH4 - Hipoestesia ao toque,0.5,0.001130826,2,117,113,4,1,1
9962,D51,DH4 - Hipoestesia ao toque,1,1.63E-06,1,118,114,4,0,1
9963,D52,DH4 - Hipoestesia ao toque,0.5,0.001130826,2,117,113,4,1,1
9964,D53,DH4 - Hipoestesia ao toque,1,1.63E-06,1,118,114,4,0,1
9965,D9,DH4 - Hipoestesia ao toque,1,1.63E-06,1,118,114,4,0,1
9968,RMDQ3_v1,DH4 - Hipoestesia ao toque,0.066666667,0.042495037,75,137,135,2,70,5
9971,RMDQ6_v1,DH4 - Hipoestesia ao toque,0.078431373,0.037279133,51,161,158,3,47,4
9972,RMDQ7_v1,DH4 - Hipoestesia ao toque,0.111111111,0.004002903,36,176,173,3,32,4
9974,RMDQ9_v1,DH4 - Hipoestesia ao toque,0.161290323,1.52E-05,31,181,179,2,26,5
9975,RMDQ10_v1,DH4 - Hipoestesia ao toque,0.121212121,0.002031223,33,179,176,3,29,4
9976,RMDQ11_v1,DH4 - Hipoestesia ao toque,0.114285714,0.003232851,35,177,174,3,31,4
9977,RMDQ12_v1,DH4 - Hipoestesia ao toque,0.102564103,0.007131659,39,173,170,3,35,4
9978,RMDQ13_v1,DH4 - Hipoestesia ao toque,0.093023256,0.013650434,43,169,166,3,39,4
9979,RMDQ14_v1,DH4 - Hipoestesia ao toque,0.095238095,0.011735078,42,170,167,3,38,4
9980,RMDQ15_v1,DH4 - Hipoestesia ao toque,0.133333333,0.000904416,30,182,179,3,26,4
9981,RMDQ16_v1,DH4 - Hipoestesia ao toque,0.117647059,0.002579511,34,178,175,3,30,4
9982,RMDQ17_v1,DH4 - Hipoestesia ao toque,0.088888889,0.018116767,45,167,164,3,41,4
9983,RMDQ18_v1,DH4 - Hipoestesia ao toque,0.133333333,0.000904416,30,182,179,3,26,4
9984,RMDQ19_v1,DH4 - Hipoestesia ao toque,0.129032258,0.001204515,31,181,178,3,27,4
9985,RMDQ20_v1,DH4 - Hipoestesia ao toque,0.121212121,0.002031223,33,179,176,3,29,4
9986,RMDQ21_v1,DH4 - Hipoestesia ao toque,0.097560976,0.010017545,41,171,168,3,37,4
9987,RMDQ22_v1,DH4 - Hipoestesia ao toque,0.117647059,0.002579511,34,178,175,3,30,4
9988,RMDQ23_v1,DH4 - Hipoestesia ao toque,0.121212121,0.002031223,33,179,176,3,29,4
9989,RMDQ24_v1,DH4 - Hipoestesia ao toque,0.133333333,0.000904416,30,182,179,3,26,4
9992,DN4 - Choque elétrico,DH4 - Hipoestesia ao toque,0.114754098,0.000101674,61,162,161,1,54,7
9994,DN4 - Alfinetada e agulhada,DH4 - Hipoestesia ao toque,0.107692308,0.000216673,65,158,157,1,58,7
9995,DN4 - Adormecimento,DH4 - Hipoestesia ao toque,0.080645161,0.027955137,62,158,155,3,57,5
9996,DN4 - Coceira,DH4 - Hipoestesia ao toque,0.272727273,1.48E-05,11,212,207,5,8,3
9997,DH4 - Hipoestesia ao toque,DH4 - Hipoestesia ao toque,1,2.00E-50,8,215,215,0,0,8
9998,DN4 - Hipoestesia a picada de agulha,DH4 - Hipoestesia ao toque,0.777777778,2.53E-34,9,214,213,1,2,7
9999,DN4 - Escovação,DH4 - Hipoestesia ao toque,1,3.81E-44,7,216,215,1,0,7
10000,Fuma,DN4 - Hipoestesia a picada de agulha,0.128205128,0.003179349,39,147,144,3,34,5
10003,Desempregado,DN4 - Hipoestesia a picada de agulha,0.115384615,0.010667604,26,157,154,3,23,3
10004,Licenca_Medica,DN4 - Hipoestesia a picada de agulha,0.117647059,0.038250994,17,167,163,4,15,2
10005,Aposentado_Invalidez,DN4 - Hipoestesia a picada de agulha,0.25,0.001462671,8,174,169,5,6,2
10006,Analgésicos,DN4 - Hipoestesia a picada de agulha,0.058394161,0.048512652,137,64,64,0,129,8
10010,Retornar_trabalho,DN4 - Hipoestesia a picada de agulha,0.176470588,0.003705427,17,174,169,5,14,3
10028,D2,DN4 - Hipoestesia a picada de agulha,0.285714286,0.000924203,7,112,109,3,5,2
NA.108,NA,NA,NA,NA,NA,NA,NA,NA,NA,NA
10036,D27,DN4 - Hipoestesia a picada de agulha,0.25,0.034937979,4,115,111,4,3,1
10037,D28,DN4 - Hipoestesia a picada de agulha,0.25,0.034937979,4,115,111,4,3,1
10039,D3,DN4 - Hipoestesia a picada de agulha,0.5,0.001130826,2,117,113,4,1,1
10044,D34,DN4 - Hipoestesia a picada de agulha,0.666666667,4.71E-08,3,116,113,3,1,2
10045,D35,DN4 - Hipoestesia a picada de agulha,1,1.63E-06,1,118,114,4,0,1
10050,D4,DN4 - Hipoestesia a picada de agulha,0.666666667,4.71E-08,3,116,113,3,1,2
10054,D43,DN4 - Hipoestesia a picada de agulha,1,1.63E-06,1,118,114,4,0,1
10061,D5,DN4 - Hipoestesia a picada de agulha,0.333333333,0.010856066,3,116,112,4,2,1
10062,D50,DN4 - Hipoestesia a picada de agulha,0.5,0.001130826,2,117,113,4,1,1
10063,D51,DN4 - Hipoestesia a picada de agulha,1,1.63E-06,1,118,114,4,0,1
10064,D52,DN4 - Hipoestesia a picada de agulha,0.5,0.001130826,2,117,113,4,1,1
10065,D53,DN4 - Hipoestesia a picada de agulha,1,1.63E-06,1,118,114,4,0,1
10066,D9,DN4 - Hipoestesia a picada de agulha,1,1.63E-06,1,118,114,4,0,1
10072,RMDQ6_v1,DN4 - Hipoestesia a picada de agulha,0.078431373,0.037279133,51,161,158,3,47,4
10073,RMDQ7_v1,DN4 - Hipoestesia a picada de agulha,0.111111111,0.004002903,36,176,173,3,32,4
10075,RMDQ9_v1,DN4 - Hipoestesia a picada de agulha,0.129032258,0.001204515,31,181,178,3,27,4
10076,RMDQ10_v1,DN4 - Hipoestesia a picada de agulha,0.121212121,0.002031223,33,179,176,3,29,4
10077,RMDQ11_v1,DN4 - Hipoestesia a picada de agulha,0.114285714,0.003232851,35,177,174,3,31,4
10078,RMDQ12_v1,DN4 - Hipoestesia a picada de agulha,0.102564103,0.007131659,39,173,170,3,35,4
10079,RMDQ13_v1,DN4 - Hipoestesia a picada de agulha,0.093023256,0.013650434,43,169,166,3,39,4
10080,RMDQ14_v1,DN4 - Hipoestesia a picada de agulha,0.095238095,0.011735078,42,170,167,3,38,4
10081,RMDQ15_v1,DN4 - Hipoestesia a picada de agulha,0.133333333,0.000904416,30,182,179,3,26,4
10082,RMDQ16_v1,DN4 - Hipoestesia a picada de agulha,0.117647059,0.002579511,34,178,175,3,30,4
10083,RMDQ17_v1,DN4 - Hipoestesia a picada de agulha,0.088888889,0.018116767,45,167,164,3,41,4
10084,RMDQ18_v1,DN4 - Hipoestesia a picada de agulha,0.133333333,0.000904416,30,182,179,3,26,4
10085,RMDQ19_v1,DN4 - Hipoestesia a picada de agulha,0.129032258,0.001204515,31,181,178,3,27,4
10086,RMDQ20_v1,DN4 - Hipoestesia a picada de agulha,0.121212121,0.002031223,33,179,176,3,29,4
10087,RMDQ21_v1,DN4 - Hipoestesia a picada de agulha,0.097560976,0.010017545,41,171,168,3,37,4
10088,RMDQ22_v1,DN4 - Hipoestesia a picada de agulha,0.117647059,0.002579511,34,178,175,3,30,4
10089,RMDQ23_v1,DN4 - Hipoestesia a picada de agulha,0.121212121,0.002031223,33,179,176,3,29,4
10090,RMDQ24_v1,DN4 - Hipoestesia a picada de agulha,0.133333333,0.000904416,30,182,179,3,26,4
10093,DN4 - Choque elétrico,DN4 - Hipoestesia a picada de agulha,0.098360656,0.006919046,61,162,159,3,55,6
10095,DN4 - Alfinetada e agulhada,DN4 - Hipoestesia a picada de agulha,0.138461538,1.80E-06,65,158,158,0,56,9
10096,DN4 - Adormecimento,DN4 - Hipoestesia a picada de agulha,0.112903226,0.000732709,62,158,156,2,55,7
10097,DN4 - Coceira,DN4 - Hipoestesia a picada de agulha,0.272727273,5.91E-05,11,212,206,6,8,3
10098,DH4 - Hipoestesia ao toque,DN4 - Hipoestesia a picada de agulha,0.875,2.53E-34,8,215,213,2,1,7
10099,DN4 - Hipoestesia a picada de agulha,DN4 - Hipoestesia a picada de agulha,1,2.00E-50,9,214,214,0,0,9
10100,DN4 - Escovação,DN4 - Hipoestesia a picada de agulha,1,2.94E-39,7,216,214,2,0,7
10101,Fuma,DN4 - Escovação,0.102564103,0.005185635,39,147,145,2,35,4
10104,Desempregado,DN4 - Escovação,0.115384615,0.000429574,26,157,156,1,23,3
10105,Licenca_Medica,DN4 - Escovação,0.117647059,0.004423,17,167,165,2,15,2
10106,Aposentado_Invalidez,DN4 - Escovação,0.25,8.21E-05,8,174,171,3,6,2
10110,Dor nas pernas,DN4 - Escovação,0.064516129,0.020790907,62,130,129,1,58,4
10111,Retornar_trabalho,DN4 - Escovação,0.176470588,0.000327726,17,174,171,3,14,3
10128,D19,DN4 - Escovação,0.2,0.034937979,5,114,111,3,4,1
10129,D2,DN4 - Escovação,0.285714286,0.000136371,7,112,110,2,5,2
10130,D20,DN4 - Escovação,0.2,0.034937979,5,114,111,3,4,1
NA.109,NA,NA,NA,NA,NA,NA,NA,NA,NA,NA
10140,D3,DN4 - Escovação,0.5,0.000223631,2,117,114,3,1,1
10145,D34,DN4 - Escovação,0.666666667,7.19E-10,3,116,114,2,1,2
10146,D35,DN4 - Escovação,1,7.26E-08,1,118,115,3,0,1
10151,D4,DN4 - Escovação,0.666666667,7.19E-10,3,116,114,2,1,2
10155,D43,DN4 - Escovação,1,7.26E-08,1,118,115,3,0,1
10162,D5,DN4 - Escovação,0.333333333,0.00353018,3,116,113,3,2,1
10163,D50,DN4 - Escovação,0.5,0.000223631,2,117,114,3,1,1
10164,D51,DN4 - Escovação,1,7.26E-08,1,118,115,3,0,1
10165,D52,DN4 - Escovação,0.5,0.000223631,2,117,114,3,1,1
10166,D53,DN4 - Escovação,1,7.26E-08,1,118,115,3,0,1
10167,D9,DN4 - Escovação,1,7.26E-08,1,118,115,3,0,1
10173,RMDQ6_v1,DN4 - Escovação,0.078431373,0.013242004,51,161,159,2,47,4
10174,RMDQ7_v1,DN4 - Escovação,0.111111111,0.001008032,36,176,174,2,32,4
10176,RMDQ9_v1,DN4 - Escovação,0.129032258,0.000252087,31,181,179,2,27,4
10177,RMDQ10_v1,DN4 - Escovação,0.121212121,0.000460768,33,179,177,2,29,4
10178,RMDQ11_v1,DN4 - Escovação,0.114285714,0.000787769,35,177,175,2,31,4
10179,RMDQ12_v1,DN4 - Escovação,0.102564103,0.001962883,39,173,171,2,35,4
10180,RMDQ13_v1,DN4 - Escovação,0.093023256,0.004152011,43,169,167,2,39,4
10181,RMDQ14_v1,DN4 - Escovação,0.095238095,0.003487269,42,170,168,2,38,4
10182,RMDQ15_v1,DN4 - Escovação,0.133333333,0.000181095,30,182,180,2,26,4
10183,RMDQ16_v1,DN4 - Escovação,0.117647059,0.000607086,34,178,176,2,30,4
10184,RMDQ17_v1,DN4 - Escovação,0.088888889,0.00575623,45,167,165,2,41,4
10185,RMDQ18_v1,DN4 - Escovação,0.133333333,0.000181095,30,182,180,2,26,4
10186,RMDQ19_v1,DN4 - Escovação,0.129032258,0.000252087,31,181,179,2,27,4
10187,RMDQ20_v1,DN4 - Escovação,0.121212121,0.000460768,33,179,177,2,29,4
10188,RMDQ21_v1,DN4 - Escovação,0.097560976,0.002905223,41,171,169,2,37,4
10189,RMDQ22_v1,DN4 - Escovação,0.117647059,0.000607086,34,178,176,2,30,4
10190,RMDQ23_v1,DN4 - Escovação,0.121212121,0.000460768,33,179,177,2,29,4
10191,RMDQ24_v1,DN4 - Escovação,0.133333333,0.000181095,30,182,180,2,26,4
10192,DN4 - Queimação,DN4 - Escovação,0.059405941,0.031727687,101,119,118,1,95,6
10194,DN4 - Choque elétrico,DN4 - Escovação,0.098360656,0.000432473,61,162,161,1,55,6
10196,DN4 - Alfinetada e agulhada,DN4 - Escovação,0.107692308,2.77E-05,65,158,158,0,58,7
10197,DN4 - Adormecimento,DN4 - Escovação,0.080645161,0.009744321,62,158,156,2,57,5
10198,DN4 - Coceira,DN4 - Escovação,0.272727273,2.50E-06,11,212,208,4,8,3
10199,DH4 - Hipoestesia ao toque,DN4 - Escovação,0.875,3.81E-44,8,215,215,0,1,7
10200,DN4 - Hipoestesia a picada de agulha,DN4 - Escovação,0.777777778,2.94E-39,9,214,214,0,2,7
10201,DN4 - Escovação,DN4 - Escovação,1,2.00E-50,7,216,216,0,0,7
