"","denominador","numerador","Frequência","P-value","Qtd_1_Denom","Qtd_0_Demon","D0N0","D0N1","D1N0","D1N1"
"1","Fuma","Fuma",1,2.08848758376253e-45,46,154,154,0,0,46
"2","Cirurgia na coluna","Fuma",0.314285714285714,0.000756144213616695,70,108,96,12,48,22
"3","Aposentado","Fuma",0.323529411764706,0.196513840798873,34,155,121,34,23,11
"4","Desempregado","Fuma",0.392857142857143,0.0451735753747703,28,157,123,34,17,11
"5","Licenca_Medica","Fuma",0.5,0.00677455487104412,18,169,133,36,9,9
"6","Aposentado_Invalidez","Fuma",0.625,0.00961679018338874,8,174,135,39,3,5
"7","Analgésicos","Fuma",0.252032520325203,0.653220190342817,123,63,49,14,92,31
"8","OutraDoenca","Fuma",0.188405797101449,0.212458954373214,69,119,87,32,56,13
"9","Dor nas costas","Fuma",0.284403669724771,0.19385513298324,109,75,60,15,78,31
"10","Dor nas pernas","Fuma",0.344262295081967,0.0405182809725091,61,122,97,25,40,21
"11","Retornar_trabalho","Fuma",0.4,0.144861961303073,20,146,110,36,12,8
"12","Masc","Fuma",0.222222222222222,0.706412141882839,135,65,49,16,105,30
"13","Fem","Fuma",0.246153846153846,0.706412141882839,65,135,105,30,49,16
"14","Casado/Amasiaado","Fuma",0.142857142857143,0.00627369482938942,84,109,75,34,72,12
"15","Solteiro","Fuma",0.289156626506024,0.150085476777339,83,110,88,22,59,24
"16","Separado_Divorciado","Fuma",0.125,0.44218557681651,8,185,140,45,7,1
"17","X4","Fuma",1,0.00180464827369461,3,190,147,43,0,3
"18","X5","Fuma",0.25,0.955899710529858,4,189,144,45,3,1
"19","X6","Fuma",0.454545454545455,0.0830792452204177,11,182,141,41,6,5
"20","Livrar_costas","Fuma",0.278350515463918,0.336155093179132,97,15,9,6,70,27
"21","Livrar_perna","Fuma",0.428571428571429,0.239948315399424,14,98,71,27,8,6
"22","Livrar_perda_sens","Fuma",0,0.516197098269408,1,111,78,33,1,0
"23","D1","Fuma",0,0.452095549051344,1,127,81,46,1,0
"24","D15","Fuma",1,0.0023225674062509,5,123,82,41,0,5
"25","D16","Fuma",0.421052631578947,0.543728778149125,19,109,71,38,11,8
"26","D17","Fuma",0.75,0.0980711909221135,4,124,81,43,1,3
"27","D18","Fuma",0.642857142857143,0.0191586856383373,14,114,77,37,5,9
"28","D19","Fuma",0.571428571428571,0.229120599446101,7,121,79,42,3,4
"29","D2","Fuma",1,9.6111518125377e-05,8,120,82,38,0,8
"30","D20","Fuma",0.375,0.924214003182506,8,120,77,43,5,3
"31","D21","Fuma",0.285714285714286,0.676126454476383,7,121,77,44,5,2
"32","D22","Fuma",0.5,0.676126454476383,2,126,81,45,1,1
"33","D23","Fuma",0,0.452095549051344,1,127,81,46,1,0
"34","D24","Fuma",0.333333333333333,0.768012132089777,24,104,66,38,16,8
"35","D25","Fuma",0.333333333333333,0.924214003182506,3,125,80,45,2,1
"36","D26","Fuma",0,0.285703052977686,2,126,80,46,2,0
"37","D27","Fuma",0.75,0.0980711909221135,4,124,81,43,1,3
"38","D28","Fuma",0.6,0.252649548240488,5,123,80,43,2,3
"39","D29","Fuma",0.325,0.584747959399826,40,88,55,33,27,13
"40","D3","Fuma",1,0.0570268627122226,2,126,82,44,0,2
"41","Lombalgia","Fuma",0.288135593220339,0.120355302225518,59,69,40,29,42,17
"42","D31","Fuma",0.5,0.210109578976528,16,112,74,38,8,8
"43","D32","Fuma",0.305555555555556,0.427296371965607,36,92,57,35,25,11
"44","D33","Fuma",0.363636363636364,0.975421663860221,11,117,75,42,7,4
"45","D34","Fuma",1,0.0192774091404522,3,125,82,43,0,3
"46","D35","Fuma",1,0.0570268627122226,2,126,82,44,0,2
"47","D36","Fuma",0.666666666666667,0.108087059239421,6,122,80,42,2,4
"48","D37","Fuma",0.4,0.680180580869204,20,108,70,38,12,8
"49","D38","Fuma",1,0.0192774091404522,3,125,82,43,0,3
"50","D39","Fuma",0.333333333333333,0.822975388973649,15,113,72,41,10,5
"51","D4","Fuma",1,0.00666741471135697,4,124,82,42,0,4
"52","D40","Fuma",1,0.00666741471135697,4,124,82,42,0,4
"53","D41","Fuma",0.6,0.252649548240488,5,123,80,43,2,3
"54","D42","Fuma",0.333333333333333,0.924214003182506,3,125,80,45,2,1
"55","D43","Fuma",0.666666666666667,0.261650822951307,3,125,81,44,1,2
"56","D44","Fuma",0.297297297297297,0.350638862110726,37,91,56,35,26,11
"57","D45","Fuma",0.545454545454545,0.178516355944478,11,117,77,40,5,6
"58","D46","Fuma",0.297297297297297,0.350638862110726,37,91,56,35,26,11
"59","D47","Fuma",0.583333333333333,0.0894190257337713,12,116,77,39,5,7
"60","D48","Fuma",0.2,0.064111757722669,25,103,62,41,20,5
"61","D49","Fuma",0.307692307692308,0.68200455078705,13,115,73,42,9,4
"62","D5","Fuma",1,0.0192774091404522,3,125,82,43,0,3
"63","D50","Fuma",1,0.0570268627122226,2,126,82,44,0,2
"64","D51","Fuma",1,0.180118629660033,1,127,82,45,0,1
"65","D52","Fuma",0.5,0.676126454476383,2,126,81,45,1,1
"66","D53","Fuma",1,0.0570268627122226,2,126,82,44,0,2
"67","D9","Fuma",1,0.180118629660033,1,127,82,45,0,1
"68","RMDQ1_v1","Fuma",0.162162162162162,0.535626496475847,74,108,84,24,62,12
"69","RMDQ2_v1","Fuma",0.166666666666667,0.581690612423897,78,104,81,23,65,13
"70","RMDQ3_v1","Fuma",0.191176470588235,0.906722143524252,68,116,93,23,55,13
"71","RMDQ4_v1","Fuma",0.173913043478261,0.667801806476608,46,138,110,28,38,8
"72","RMDQ5_v1","Fuma",0.225806451612903,0.462316666993236,62,122,100,22,48,14
"73","RMDQ6_v1","Fuma",0.270833333333333,0.126703511190992,48,136,113,23,35,13
"74","RMDQ7_v1","Fuma",0.342857142857143,0.0155892967516733,35,148,124,24,23,12
"75","RMDQ8_v1","Fuma",0.5,0.0273381213191091,8,175,143,32,4,4
"76","RMDQ9_v1","Fuma",0.333333333333333,0.0395332184219696,30,153,127,26,20,10
"77","RMDQ10_v1","Fuma",0.314285714285714,0.0517070262410556,35,148,123,25,24,11
"78","RMDQ11_v1","Fuma",0.305555555555556,0.0668261736475372,36,147,122,25,25,11
"79","RMDQ12_v1","Fuma",0.289473684210526,0.106127955311832,38,145,120,25,27,11
"80","RMDQ13_v1","Fuma",0.256410256410256,0.290470834302873,39,144,118,26,29,10
"81","RMDQ14_v1","Fuma",0.261904761904762,0.226028990162637,42,141,116,25,31,11
"82","RMDQ15_v1","Fuma",0.24,0.557980095719506,25,158,128,30,19,6
"83","RMDQ16_v1","Fuma",0.3125,0.0697133721004221,32,151,125,26,22,10
"84","RMDQ17_v1","Fuma",0.225,0.610776724454523,40,143,116,27,31,9
"85","RMDQ18_v1","Fuma",0.290322580645161,0.150294452815812,31,152,125,27,22,9
"86","RMDQ19_v1","Fuma",0.285714285714286,0.198035355349415,28,155,127,28,20,8
"87","RMDQ20_v1","Fuma",0.34375,0.0212605359177866,32,151,126,25,21,11
"88","RMDQ21_v1","Fuma",0.268292682926829,0.190621992109653,41,142,117,25,30,11
"89","RMDQ22_v1","Fuma",0.294117647058824,0.11335937634298,34,149,123,26,24,10
"90","RMDQ23_v1","Fuma",0.303030303030303,0.0897216220711249,33,150,124,26,23,10
"91","RMDQ24_v1","Fuma",0.354838709677419,0.0150990196424508,31,152,127,25,20,11
"92","DN4 - Queimação","Fuma",0.192771084337349,0.563773679871448,83,101,78,23,67,16
"93","DN4 - Sensação de frio dolorosa","Fuma",0.119047619047619,0.0898930960292662,42,141,107,34,37,5
"94","DN4 - Choque elétrico","Fuma",0.269230769230769,0.213907084570306,52,134,109,25,38,14
"95","DN4 - Formigamento","Fuma",0.173913043478261,0.492195107558159,46,140,109,31,38,8
"96","DN4 - Alfinetada e agulhada","Fuma",0.320754716981132,0.0188149262656854,53,133,111,22,36,17
"97","DN4 - Adormecimento","Fuma",0.203703703703704,0.85987139323557,54,130,102,28,43,11
"98","DN4 - Coceira","Fuma",0.5,0.0392052080717575,8,178,143,35,4,4
"99","DH4 - Hipoestesia ao toque","Fuma",0.571428571428571,0.0165441606794115,7,179,144,35,3,4
"100","DN4 - Hipoestesia a picada de agulha","Fuma",0.625,0.00317934889476581,8,178,144,34,3,5
"101","DN4 - Escovação","Fuma",0.666666666666667,0.00518563487972528,6,180,145,35,2,4
"102","Fuma","Cirurgia na coluna",0.647058823529412,0.000756144213616695,34,144,96,48,12,22
"103","Cirurgia na coluna","Cirurgia na coluna",1,3.04349358469026e-48,79,134,134,0,0,79
"104","Aposentado","Cirurgia na coluna",0.606060606060606,0.00526436526379383,33,151,99,52,13,20
"105","Desempregado","Cirurgia na coluna",0.625,0.0156538458128831,24,156,99,57,9,15
"106","Licenca_Medica","Cirurgia na coluna",0.769230769230769,0.00425012436767734,13,169,107,62,3,10
"107","Aposentado_Invalidez","Cirurgia na coluna",0.4,0.971343896432104,5,176,107,69,3,2
"108","Analgésicos","Cirurgia na coluna",0.385185185185185,0.954510014019125,135,63,39,24,83,52
"109","OutraDoenca","Cirurgia na coluna",0.383561643835616,0.767481460709041,73,116,69,47,45,28
"110","Dor nas costas","Cirurgia na coluna",0.417391304347826,0.428894661857236,115,75,48,27,67,48
"111","Dor nas pernas","Cirurgia na coluna",0.555555555555556,0.003576257458436,54,132,89,43,24,30
"112","Retornar_trabalho","Cirurgia na coluna",0.5,0.230050240924217,16,169,110,59,8,8
"113","Masc","Cirurgia na coluna",0.397163120567376,0.266666356359924,141,72,49,23,85,56
"114","Fem","Cirurgia na coluna",0.319444444444444,0.266666356359924,72,141,85,56,49,23
"115","Casado/Amasiaado","Cirurgia na coluna",0.353658536585366,0.201538629625116,82,96,53,43,53,29
"116","Solteiro","Cirurgia na coluna",0.424657534246575,0.647656045392028,73,105,64,41,42,31
"117","Separado_Divorciado","Cirurgia na coluna",0.375,0.861921684126111,8,170,101,69,5,3
"118","X4","Cirurgia na coluna",0,0.408527180838061,1,177,105,72,1,0
"119","X5","Cirurgia na coluna",0.5,0.693849595610497,4,174,104,70,2,2
"120","X6","Cirurgia na coluna",0.7,0.0500138051072718,10,168,103,65,3,7
"121","Livrar_costas","Cirurgia na coluna",0.438775510204082,0.839495200184812,98,15,8,7,55,43
"122","Livrar_perna","Cirurgia na coluna",0.461538461538462,0.883064417403572,13,100,56,44,7,6
"123","Livrar_perda_sens","Cirurgia na coluna",0.5,0.868744414179442,2,111,62,49,1,1
"124","D1","Cirurgia na coluna",0,0.348070916478987,1,117,62,55,1,0
"125","D15","Cirurgia na coluna",1,0.0144633272971544,5,113,63,50,0,5
"126","D16","Cirurgia na coluna",0.470588235294118,0.968027946264935,17,101,54,47,9,8
"127","D17","Cirurgia na coluna",0.666666666666667,0.480558585282761,3,115,62,53,1,2
"128","D18","Cirurgia na coluna",0.583333333333333,0.390383343668942,12,106,58,48,5,7
"129","D19","Cirurgia na coluna",0,0.0572747675759925,4,114,59,55,4,0
"130","D2","Cirurgia na coluna",0.6,0.539659987297388,5,113,61,52,2,3
"131","D20","Cirurgia na coluna",0.166666666666667,0.131253173863049,6,112,58,54,5,1
"132","D21","Cirurgia na coluna",0,0.0327610202654722,5,113,58,55,5,0
"133","D22","Cirurgia na coluna",0,0.348070916478987,1,117,62,55,1,0
"134","D23","Cirurgia na coluna",0.5,0.922786031527084,2,116,62,54,1,1
"135","D24","Cirurgia na coluna",0.409090909090909,0.552312931460711,22,96,50,46,13,9
"136","D25","Cirurgia na coluna",0.5,0.890027290247415,4,114,61,53,2,2
"137","D26","Cirurgia na coluna",0,0.348070916478987,1,117,62,55,1,0
"138","D27","Cirurgia na coluna",1,0.0604130830069361,3,115,63,52,0,3
"139","D28","Cirurgia na coluna",0.6,0.539659987297388,5,113,61,52,2,3
"140","D29","Cirurgia na coluna",0.513513513513513,0.485316958495754,37,81,45,36,18,19
"141","D3","Cirurgia na coluna",0,0.348070916478987,1,117,62,55,1,0
"142","Lombalgia","Cirurgia na coluna",0.5,0.497745388138535,54,64,36,28,27,27
"143","D31","Cirurgia na coluna",0.615384615384615,0.25269735986155,13,105,58,47,5,8
"144","D32","Cirurgia na coluna",0.46875,0.9719381907556,32,86,46,40,17,15
"145","D33","Cirurgia na coluna",0.444444444444444,0.892205853201895,9,109,58,51,5,4
"146","D34","Cirurgia na coluna",1,0.126868659625014,2,116,63,53,0,2
"147","D35","Cirurgia na coluna",1,0.126868659625014,2,116,63,53,0,2
"148","D36","Cirurgia na coluna",1,0.00712608896570684,6,112,63,49,0,6
"149","D37","Cirurgia na coluna",0.526315789473684,0.565684335979093,19,99,54,45,9,10
"150","D38","Cirurgia na coluna",1,0.126868659625014,2,116,63,53,0,2
"151","D39","Cirurgia na coluna",0.428571428571429,0.764293505813152,14,104,55,49,8,6
"152","D4","Cirurgia na coluna",0.666666666666667,0.480558585282761,3,115,62,53,1,2
"153","D40","Cirurgia na coluna",1,0.0294248479919993,4,114,63,51,0,4
"154","D41","Cirurgia na coluna",0.833333333333333,0.0641869210190012,6,112,62,50,1,5
"155","D42","Cirurgia na coluna",0,0.182624551928033,2,116,61,55,2,0
"156","D43","Cirurgia na coluna",0.5,0.922786031527084,2,116,62,54,1,1
"157","D44","Cirurgia na coluna",0.514285714285714,0.495650914043256,35,83,46,37,17,18
"158","D45","Cirurgia na coluna",0.7,0.12118016092976,10,108,60,48,3,7
"159","D46","Cirurgia na coluna",0.5,0.638624518771858,34,84,46,38,17,17
"160","D47","Cirurgia na coluna",0.666666666666667,0.209488455027041,9,109,60,49,3,6
"161","D48","Cirurgia na coluna",0.375,0.316152130871299,24,94,48,46,15,9
"162","D49","Cirurgia na coluna",0.454545454545455,0.935692524034151,11,107,57,50,6,5
"163","D5","Cirurgia na coluna",1,0.126868659625014,2,116,63,53,0,2
"164","D50","Cirurgia na coluna",1,0.282453923933158,1,117,63,54,0,1
"165","D51","Cirurgia na coluna",1,0.282453923933158,1,117,63,54,0,1
"166","D52","Cirurgia na coluna",0.5,0.922786031527084,2,116,62,54,1,1
"167","D53","Cirurgia na coluna",0.5,0.922786031527084,2,116,62,54,1,1
"168","D9","Cirurgia na coluna",1,0.282453923933158,1,117,63,54,0,1
"169","RMDQ1_v1","Cirurgia na coluna",0.36,0.745790179650833,75,119,78,41,48,27
"170","RMDQ2_v1","Cirurgia na coluna",0.346153846153846,0.759906498431339,78,116,75,41,51,27
"171","RMDQ3_v1","Cirurgia na coluna",0.333333333333333,0.67605112151853,72,124,79,45,48,24
"172","RMDQ4_v1","Cirurgia na coluna",0.269230769230769,0.144652157982923,52,144,89,55,38,14
"173","RMDQ5_v1","Cirurgia na coluna",0.338461538461538,0.779181831593866,65,131,84,47,43,22
"174","RMDQ6_v1","Cirurgia na coluna",0.387755102040816,0.545564242361793,49,147,97,50,30,19
"175","RMDQ7_v1","Cirurgia na coluna",0.40625,0.45509881513079,32,163,108,55,19,13
"176","RMDQ8_v1","Cirurgia na coluna",0.571428571428571,0.207945629010943,7,188,124,64,3,4
"177","RMDQ9_v1","Cirurgia na coluna",0.464285714285714,0.16556191656699,28,167,112,55,15,13
"178","RMDQ10_v1","Cirurgia na coluna",0.424242424242424,0.317886853296308,33,162,108,54,19,14
"179","RMDQ11_v1","Cirurgia na coluna",0.428571428571429,0.273793510915317,35,160,107,53,20,15
"180","RMDQ12_v1","Cirurgia na coluna",0.378378378378378,0.674064106348984,37,158,104,54,23,14
"181","RMDQ13_v1","Cirurgia na coluna",0.425,0.256171387705129,40,155,104,51,23,17
"182","RMDQ14_v1","Cirurgia na coluna",0.380952380952381,0.620689130722894,42,153,101,52,26,16
"183","RMDQ15_v1","Cirurgia na coluna",0.384615384615385,0.67991840914,26,169,111,58,16,10
"184","RMDQ16_v1","Cirurgia na coluna",0.483870967741935,0.0851074997133805,31,164,111,53,16,15
"185","RMDQ17_v1","Cirurgia na coluna",0.4,0.445253196569288,40,155,103,52,24,16
"186","RMDQ18_v1","Cirurgia na coluna",0.413793103448276,0.425453756427533,29,166,110,56,17,12
"187","RMDQ19_v1","Cirurgia na coluna",0.481481481481481,0.118864274131215,27,168,113,55,14,13
"188","RMDQ20_v1","Cirurgia na coluna",0.433333333333333,0.290413173481526,30,165,110,55,17,13
"189","RMDQ21_v1","Cirurgia na coluna",0.325,0.724050556181161,40,155,100,55,27,13
"190","RMDQ22_v1","Cirurgia na coluna",0.387096774193548,0.624891640611865,31,164,108,56,19,12
"191","RMDQ23_v1","Cirurgia na coluna",0.433333333333333,0.290413173481526,30,165,110,55,17,13
"192","RMDQ24_v1","Cirurgia na coluna",0.428571428571429,0.338013017668139,28,167,111,56,16,12
"193","DN4 - Queimação","Cirurgia na coluna",0.380434782608696,0.896388173692458,92,105,66,39,57,35
"194","DN4 - Sensação de frio dolorosa","Cirurgia na coluna",0.375,0.899280469153179,48,148,94,54,30,18
"195","DN4 - Choque elétrico","Cirurgia na coluna",0.431372549019608,0.292917092159791,51,149,97,52,29,22
"196","DN4 - Formigamento","Cirurgia na coluna",0.458333333333333,0.145943615807705,48,152,100,52,26,22
"197","DN4 - Alfinetada e agulhada","Cirurgia na coluna",0.442307692307692,0.209315704631462,52,148,97,51,29,23
"198","DN4 - Adormecimento","Cirurgia na coluna",0.358490566037736,0.763080231205605,53,144,89,55,34,19
"199","DN4 - Coceira","Cirurgia na coluna",0.444444444444444,0.635964783089406,9,191,121,70,5,4
"200","DH4 - Hipoestesia ao toque","Cirurgia na coluna",0.6,0.280678605211463,5,195,124,71,2,3
"201","DN4 - Hipoestesia a picada de agulha","Cirurgia na coluna",0.4,0.88809703569092,5,195,123,72,3,2
"202","DN4 - Escovação","Cirurgia na coluna",0.5,0.586449856605349,4,196,124,72,2,2
"203","Fuma","Aposentado",0.244444444444444,0.196513840798873,45,144,121,23,34,11
"204","Cirurgia na coluna","Aposentado",0.277777777777778,0.00526436526379383,72,112,99,13,52,20
"205","Aposentado","Aposentado",1,1.26360742535148e-45,37,164,164,0,0,37
"206","Desempregado","Aposentado",0.366666666666667,0.0046365154113666,30,167,142,25,19,11
"207","Licenca_Medica","Aposentado",0.263157894736842,0.327417215834905,19,180,149,31,14,5
"208","Aposentado_Invalidez","Aposentado",0.125,0.677219347858284,8,186,152,34,7,1
"209","Analgésicos","Aposentado",0.181102362204724,0.990231616017593,127,66,54,12,104,23
"210","OutraDoenca","Aposentado",0.267605633802817,0.0358790520062171,71,124,106,18,52,19
"211","Dor nas costas","Aposentado",0.213675213675214,0.229648956990171,117,76,65,11,92,25
"212","Dor nas pernas","Aposentado",0.229508196721311,0.320663558134686,61,130,108,22,47,14
"213","Retornar_trabalho","Aposentado",0.619047619047619,5.69642671267516e-09,21,155,138,17,8,13
"214","Masc","Aposentado",0.21969696969697,0.0715188039001151,132,69,61,8,103,29
"215","Fem","Aposentado",0.115942028985507,0.0715188039001151,69,132,103,29,61,8
"216","Casado/Amasiaado","Aposentado",0.180722891566265,0.955155069707267,83,107,88,19,68,15
"217","Solteiro","Aposentado",0.111111111111111,0.0354740198927289,81,109,84,25,72,9
"218","Separado_Divorciado","Aposentado",0.375,0.139374818308345,8,182,151,31,5,3
"219","X4","Aposentado",0,0.415033450743752,3,187,153,34,3,0
"220","X5","Aposentado",0,0.345330162238084,4,186,152,34,4,0
"221","X6","Aposentado",0.636363636363636,4.54929392710709e-05,11,179,152,27,4,7
"222","Livrar_costas","Aposentado",0.238095238095238,0.15630849088816,105,14,13,1,80,25
"223","Livrar_perna","Aposentado",0.0769230769230769,0.190610733049083,13,106,81,25,12,1
"224","Livrar_perda_sens","Aposentado",0,0.595433050706267,1,118,92,26,1,0
"225","D1","Aposentado",0,0.578126229420996,1,131,100,31,1,0
"226","D15","Aposentado",0.166666666666667,0.686761644479342,6,126,96,30,5,1
"227","D16","Aposentado",0.45,0.0137332931936109,20,112,90,22,11,9
"228","D17","Aposentado",0,0.2066028535923,5,127,96,31,5,0
"229","D18","Aposentado",0.125,0.268848540129623,16,116,87,29,14,2
"230","D19","Aposentado",0.285714285714286,0.744241612082321,7,125,96,29,5,2
"231","D2","Aposentado",0.25,0.916926461823846,8,124,95,29,6,2
"232","D20","Aposentado",0.25,0.916926461823846,8,124,95,29,6,2
"233","D21","Aposentado",0.285714285714286,0.744241612082321,7,125,96,29,5,2
"234","D22","Aposentado",0.5,0.372732044491854,2,130,100,30,1,1
"235","D23","Aposentado",0.5,0.372732044491854,2,130,100,30,1,1
"236","D24","Aposentado",0.153846153846154,0.276902884734919,26,106,79,27,22,4
"237","D25","Aposentado",0.5,0.203944264190864,4,128,99,29,2,2
"238","D26","Aposentado",0.5,0.372732044491854,2,130,100,30,1,1
"239","D27","Aposentado",0.4,0.374461448361999,5,127,98,29,3,2
"240","D28","Aposentado",0.333333333333333,0.560245108322694,6,126,97,29,4,2
"241","D29","Aposentado",0.30952380952381,0.166784306030934,42,90,72,18,29,13
"242","D3","Aposentado",0,0.429821621542201,2,130,99,31,2,0
"243","Lombalgia","Aposentado",0.32258064516129,0.0252328425788867,62,70,59,11,42,20
"244","D31","Aposentado",0.1875,0.633645101438005,16,116,88,28,13,3
"245","D32","Aposentado",0.27027027027027,0.549079018955791,37,95,74,21,27,10
"246","D33","Aposentado",0.0909090909090909,0.239491685490066,11,121,91,30,10,1
"247","D34","Aposentado",0.333333333333333,0.683966586356629,3,129,99,30,2,1
"248","D35","Aposentado",0.5,0.372732044491854,2,130,100,30,1,1
"249","D36","Aposentado",0.285714285714286,0.744241612082321,7,125,96,29,5,2
"250","D37","Aposentado",0.409090909090909,0.0346888053005873,22,110,88,22,13,9
"251","D38","Aposentado",0,0.429821621542201,2,130,99,31,2,0
"252","D39","Aposentado",0.466666666666667,0.0244696577425095,15,117,93,24,8,7
"253","D4","Aposentado",0.25,0.942129239847893,4,128,98,30,3,1
"254","D40","Aposentado",0,0.260501644567837,4,128,97,31,4,0
"255","D41","Aposentado",0.285714285714286,0.744241612082321,7,125,96,29,5,2
"256","D42","Aposentado",0.333333333333333,0.683966586356629,3,129,99,30,2,1
"257","D43","Aposentado",0.333333333333333,0.683966586356629,3,129,99,30,2,1
"258","D44","Aposentado",0.315789473684211,0.163072476144281,38,94,75,19,26,12
"259","D45","Aposentado",0.181818181818182,0.664754482552757,11,121,92,29,9,2
"260","D46","Aposentado",0.289473684210526,0.34653758378734,38,94,74,20,27,11
"261","D47","Aposentado",0.0909090909090909,0.239491685490066,11,121,91,30,10,1
"262","D48","Aposentado",0.384615384615385,0.0443954950387607,26,106,85,21,16,10
"263","D49","Aposentado",0.0833333333333333,0.194081208290354,12,120,90,30,11,1
"264","D5","Aposentado",0.666666666666667,0.0742960957152981,3,129,100,29,1,2
"265","D50","Aposentado",0,0.429821621542201,2,130,99,31,2,0
"266","D51","Aposentado",1,0.0700036270740707,1,131,101,30,0,1
"267","D52","Aposentado",0,0.429821621542201,2,130,99,31,2,0
"268","D53","Aposentado",0,0.429821621542201,2,130,99,31,2,0
"269","D9","Aposentado",1,0.0700036270740707,1,131,101,30,0,1
"270","RMDQ1_v1","Aposentado",0.202898550724638,0.751508811349967,69,113,94,19,55,14
"271","RMDQ2_v1","Aposentado",0.202702702702703,0.73822898221603,74,108,90,18,59,15
"272","RMDQ3_v1","Aposentado",0.217391304347826,0.377357110657859,69,115,96,19,54,15
"273","RMDQ4_v1","Aposentado",0.28,0.0420746840668553,50,134,114,20,36,14
"274","RMDQ5_v1","Aposentado",0.241935483870968,0.15446007396301,62,122,103,19,47,15
"275","RMDQ6_v1","Aposentado",0.224489795918367,0.403116298009275,49,135,112,23,38,11
"276","RMDQ7_v1","Aposentado",0.212121212121212,0.599782928377044,33,150,124,26,26,7
"277","RMDQ8_v1","Aposentado",0.375,0.143044114661345,8,175,145,30,5,3
"278","RMDQ9_v1","Aposentado",0.178571428571429,0.979043887998176,28,155,127,28,23,5
"279","RMDQ10_v1","Aposentado",0.205882352941176,0.667541902034753,34,149,123,26,27,7
"280","RMDQ11_v1","Aposentado",0.2,0.736409983699538,35,148,122,26,28,7
"281","RMDQ12_v1","Aposentado",0.184210526315789,0.944243302163813,38,145,119,26,31,7
"282","RMDQ13_v1","Aposentado",0.256410256410256,0.163563432130849,39,144,121,23,29,10
"283","RMDQ14_v1","Aposentado",0.219512195121951,0.458780370781703,41,142,118,24,32,9
"284","RMDQ15_v1","Aposentado",0.125,0.449437055094453,24,159,129,30,21,3
"285","RMDQ16_v1","Aposentado",0.266666666666667,0.178552570613183,30,153,128,25,22,8
"286","RMDQ17_v1","Aposentado",0.2,0.714298197771417,40,143,118,25,32,8
"287","RMDQ18_v1","Aposentado",0.2,0.759218672015919,30,153,126,27,24,6
"288","RMDQ19_v1","Aposentado",0.192307692307692,0.863800455842768,26,157,129,28,21,5
"289","RMDQ20_v1","Aposentado",0.225806451612903,0.469882667138764,31,152,126,26,24,7
"290","RMDQ21_v1","Aposentado",0.25,0.194780065813509,40,143,120,23,30,10
"291","RMDQ22_v1","Aposentado",0.25,0.259088984797628,32,151,126,25,24,8
"292","RMDQ23_v1","Aposentado",0.193548387096774,0.833606420633307,31,152,125,27,25,6
"293","RMDQ24_v1","Aposentado",0.206896551724138,0.684978356364437,29,154,127,27,23,6
"294","DN4 - Queimação","Aposentado",0.123456790123457,0.0796952734974277,81,103,80,23,71,10
"295","DN4 - Sensação de frio dolorosa","Aposentado",0.162790697674419,0.732364119386545,43,140,114,26,36,7
"296","DN4 - Choque elétrico","Aposentado",0.229166666666667,0.275924204970753,48,138,116,22,37,11
"297","DN4 - Formigamento","Aposentado",0.155555555555556,0.659249403441332,45,141,115,26,38,7
"298","DN4 - Alfinetada e agulhada","Aposentado",0.173076923076923,0.923066685263061,52,134,110,24,43,9
"299","DN4 - Adormecimento","Aposentado",0.192307692307692,0.773649074651853,52,132,109,23,42,10
"300","DN4 - Coceira","Aposentado",0.5,0.0355059389885742,6,180,150,30,3,3
"301","DH4 - Hipoestesia ao toque","Aposentado",0.333333333333333,0.309520825184632,6,180,149,31,4,2
"302","DN4 - Hipoestesia a picada de agulha","Aposentado",0.285714285714286,0.444548495977596,7,179,148,31,5,2
"303","DN4 - Escovação","Aposentado",0.4,0.186605811676443,5,181,150,31,3,2
"304","Fuma","Desempregado",0.244444444444444,0.0451735753747703,45,140,123,17,34,11
"305","Cirurgia na coluna","Desempregado",0.208333333333333,0.0156538458128831,72,108,99,9,57,15
"306","Aposentado","Desempregado",0.305555555555556,0.0046365154113666,36,161,142,19,25,11
"307","Desempregado","Desempregado",1,9.43025074517101e-45,30,167,167,0,0,30
"308","Licenca_Medica","Desempregado",0.421052631578947,0.000639852650193431,19,177,155,22,11,8
"309","Aposentado_Invalidez","Desempregado",0.375,0.0723382861371128,8,183,157,26,5,3
"310","Analgésicos","Desempregado",0.144,0.82248740219614,125,64,54,10,107,18
"311","OutraDoenca","Desempregado",0.2,0.214878642361632,70,121,105,16,56,14
"312","Dor nas costas","Desempregado",0.234782608695652,0.000319401817353689,115,75,72,3,88,27
"313","Dor nas pernas","Desempregado",0.166666666666667,0.855737959119117,60,128,108,20,50,10
"314","Retornar_trabalho","Desempregado",0.368421052631579,0.00480133528504024,19,154,135,19,12,7
"315","Masc","Desempregado",0.140625,0.535031836195367,128,69,57,12,110,18
"316","Fem","Desempregado",0.173913043478261,0.535031836195367,69,128,110,18,57,12
"317","Casado/Amasiaado","Desempregado",0.109756097560976,0.294315746278617,82,104,87,17,73,9
"318","Solteiro","Desempregado",0.177215189873418,0.205895827839192,79,107,95,12,65,14
"319","Separado_Divorciado","Desempregado",0.142857142857143,0.980936923098029,7,179,154,25,6,1
"320","X4","Desempregado",0,0.481487710817077,3,183,157,26,3,0
"321","X5","Desempregado",0.25,0.520467118506384,4,182,157,25,3,1
"322","X6","Desempregado",0.0909090909090909,0.629847413624636,11,175,150,25,10,1
"323","Livrar_costas","Desempregado",0.211538461538462,0.529583371206293,104,14,10,4,82,22
"324","Livrar_perna","Desempregado",0.307692307692308,0.420495532343745,13,105,83,22,9,4
"325","Livrar_perda_sens","Desempregado",0,0.593426957598424,1,117,91,26,1,0
"326","D1","Desempregado",0,0.624248775981322,1,129,104,25,1,0
"327","D15","Desempregado",0.333333333333333,0.369475560195933,6,124,101,23,4,2
"328","D16","Desempregado",0.1,0.254830925062737,20,110,87,23,18,2
"329","D17","Desempregado",0.2,0.964499561927088,5,125,101,24,4,1
"330","D18","Desempregado",0.25,0.531786062941489,16,114,93,21,12,4
"331","D19","Desempregado",0.285714285714286,0.519153654398101,7,123,100,23,5,2
"332","D2","Desempregado",0.375,0.175918382739605,8,122,100,22,5,3
"333","D20","Desempregado",0.25,0.669088834458672,8,122,99,23,6,2
"334","D21","Desempregado",0.142857142857143,0.732888589755174,7,123,99,24,6,1
"335","D22","Desempregado",0.5,0.265838463903265,2,128,104,24,1,1
"336","D23","Desempregado",0.5,0.265838463903265,2,128,104,24,1,1
"337","D24","Desempregado",0.269230769230769,0.265838463903265,26,104,86,18,19,7
"338","D25","Desempregado",0.5,0.11273222362829,4,126,103,23,2,2
"339","D26","Desempregado",0.5,0.265838463903265,2,128,104,24,1,1
"340","D27","Desempregado",0.2,0.964499561927088,5,125,101,24,4,1
"341","D28","Desempregado",0.333333333333333,0.369475560195933,6,124,101,23,4,2
"342","D29","Desempregado",0.166666666666667,0.608321591123927,42,88,70,18,35,7
"343","D3","Desempregado",0.5,0.265838463903265,2,128,104,24,1,1
"344","Lombalgia","Desempregado",0.209677419354839,0.631350353730321,62,68,56,12,49,13
"345","D31","Desempregado",0.25,0.531786062941489,16,114,93,21,12,4
"346","D32","Desempregado",0.0810810810810811,0.04239340512222,37,93,71,22,34,3
"347","D33","Desempregado",0.0909090909090909,0.372458603077569,11,119,95,24,10,1
"348","D34","Desempregado",0.666666666666667,0.0349279503975996,3,127,104,23,1,2
"349","D35","Desempregado",1,0.00349099856431804,2,128,105,23,0,2
"350","D36","Desempregado",0.285714285714286,0.519153654398101,7,123,100,23,5,2
"351","D37","Desempregado",0.136363636363636,0.465101502813925,22,108,86,22,19,3
"352","D38","Desempregado",0,0.486782231372189,2,128,103,25,2,0
"353","D39","Desempregado",0.0666666666666667,0.18927073883889,15,115,91,24,14,1
"354","D4","Desempregado",0.75,0.00404435093370527,4,126,104,22,1,3
"355","D40","Desempregado",0.25,0.766175756831519,4,126,102,24,3,1
"356","D41","Desempregado",0.142857142857143,0.732888589755174,7,123,99,24,6,1
"357","D42","Desempregado",0.333333333333333,0.530621679607463,3,127,103,24,2,1
"358","D43","Desempregado",0.333333333333333,0.530621679607463,3,127,103,24,2,1
"359","D44","Desempregado",0.0789473684210526,0.0350567197360951,38,92,70,22,35,3
"360","D45","Desempregado",0.0909090909090909,0.372458603077569,11,119,95,24,10,1
"361","D46","Desempregado",0.105263157894737,0.105573295117912,38,92,71,21,34,4
"362","D47","Desempregado",0.181818181818182,0.926488935095709,11,119,96,23,9,2
"363","D48","Desempregado",0.115384615384615,0.265838463903265,26,104,82,22,23,3
"364","D49","Desempregado",0.0833333333333333,0.314720508202041,12,118,94,24,11,1
"365","D5","Desempregado",0.666666666666667,0.0349279503975996,3,127,104,23,1,2
"366","D50","Desempregado",0.5,0.265838463903265,2,128,104,24,1,1
"367","D51","Desempregado",1,0.0396556286496397,1,129,105,24,0,1
"368","D52","Desempregado",0,0.486782231372189,2,128,103,25,2,0
"369","D53","Desempregado",0,0.486782231372189,2,128,103,25,2,0
"370","D9","Desempregado",1,0.0396556286496397,1,129,105,24,0,1
"371","RMDQ1_v1","Desempregado",0.194029850746269,0.339318193116568,67,111,98,13,54,13
"372","RMDQ2_v1","Desempregado",0.208333333333333,0.139003452575216,72,106,95,11,57,15
"373","RMDQ3_v1","Desempregado",0.115942028985507,0.391089734556973,69,111,93,18,61,8
"374","RMDQ4_v1","Desempregado",0.12,0.562879972724213,50,130,110,20,44,6
"375","RMDQ5_v1","Desempregado",0.112903225806452,0.382903243430447,62,118,99,19,55,7
"376","RMDQ6_v1","Desempregado",0.122448979591837,0.60767039152446,49,131,111,20,43,6
"377","RMDQ7_v1","Desempregado",0.151515151515152,0.909971950371168,33,146,125,21,28,5
"378","RMDQ8_v1","Desempregado",0,0.232897378529783,8,171,145,26,8,0
"379","RMDQ9_v1","Desempregado",0.142857142857143,0.968772513757998,28,151,129,22,24,4
"380","RMDQ10_v1","Desempregado",0.205882352941176,0.264936056633861,34,145,126,19,27,7
"381","RMDQ11_v1","Desempregado",0.171428571428571,0.62411264050878,35,144,124,20,29,6
"382","RMDQ12_v1","Desempregado",0.184210526315789,0.442510901603368,38,141,122,19,31,7
"383","RMDQ13_v1","Desempregado",0.179487179487179,0.49264179642995,39,140,121,19,32,7
"384","RMDQ14_v1","Desempregado",0.219512195121951,0.124306058800395,41,138,121,17,32,9
"385","RMDQ15_v1","Desempregado",0.166666666666667,0.748990389880421,24,155,133,22,20,4
"386","RMDQ16_v1","Desempregado",0.166666666666667,0.715208419026586,30,149,128,21,25,5
"387","RMDQ17_v1","Desempregado",0.179487179487179,0.49264179642995,39,140,121,19,32,7
"388","RMDQ18_v1","Desempregado",0.233333333333333,0.133426357263689,30,149,130,19,23,7
"389","RMDQ19_v1","Desempregado",0.115384615384615,0.640146102216178,26,153,130,23,23,3
"390","RMDQ20_v1","Desempregado",0.161290322580645,0.780457597294657,31,148,127,21,26,5
"391","RMDQ21_v1","Desempregado",0.179487179487179,0.49264179642995,39,140,121,19,32,7
"392","RMDQ22_v1","Desempregado",0.15625,0.845510164180753,32,147,126,21,27,5
"393","RMDQ23_v1","Desempregado",0.193548387096774,0.401300991479518,31,148,128,20,25,6
"394","RMDQ24_v1","Desempregado",0.172413793103448,0.650195269338077,29,150,129,21,24,5
"395","DN4 - Queimação","Desempregado",0.126582278481013,0.564578895312484,79,102,86,16,69,10
"396","DN4 - Sensação de frio dolorosa","Desempregado",0.119047619047619,0.592843634069639,42,138,117,21,37,5
"397","DN4 - Choque elétrico","Desempregado",0.0851063829787234,0.194398212406589,47,136,114,22,43,4
"398","DN4 - Formigamento","Desempregado",0.113636363636364,0.535258633638523,44,139,118,21,39,5
"399","DN4 - Alfinetada e agulhada","Desempregado",0.1,0.317489966798219,50,133,112,21,45,5
"400","DN4 - Adormecimento","Desempregado",0.0784313725490196,0.117150541976059,51,130,108,22,47,4
"401","DN4 - Coceira","Desempregado",0.333333333333333,0.172437389057117,6,177,153,24,4,2
"402","DH4 - Hipoestesia ao toque","Desempregado",0.6,0.00294160960349787,5,178,155,23,2,3
"403","DN4 - Hipoestesia a picada de agulha","Desempregado",0.5,0.010667603730983,6,177,154,23,3,3
"404","DN4 - Escovação","Desempregado",0.75,0.000429574147144764,4,179,156,23,1,3
"405","Fuma","Licenca_Medica",0.2,0.00677455487104412,45,142,133,9,36,9
"406","Cirurgia na coluna","Licenca_Medica",0.138888888888889,0.00425012436767734,72,110,107,3,62,10
"407","Aposentado","Licenca_Medica",0.138888888888889,0.327417215834905,36,163,149,14,31,5
"408","Desempregado","Licenca_Medica",0.266666666666667,0.000639852650193431,30,166,155,11,22,8
"409","Licenca_Medica","Licenca_Medica",1,3.45189001884612e-45,19,180,180,0,0,19
"410","Aposentado_Invalidez","Licenca_Medica",0.375,0.00530589193071073,8,184,169,15,5,3
"411","Analgésicos","Licenca_Medica",0.088,0.465825325570309,125,66,58,8,114,11
"412","OutraDoenca","Licenca_Medica",0.0985915492957746,0.99585727365643,71,122,110,12,64,7
"413","Dor nas costas","Licenca_Medica",0.137931034482759,0.0272242331728375,116,75,72,3,100,16
"414","Dor nas pernas","Licenca_Medica",0.2,0.00192559245462296,60,129,122,7,48,12
"415","Retornar_trabalho","Licenca_Medica",0.15,0.396371582643094,20,155,141,14,17,3
"416","Masc","Licenca_Medica",0.0923076923076923,0.834566600291896,130,69,62,7,118,12
"417","Fem","Licenca_Medica",0.101449275362319,0.834566600291896,69,130,118,12,62,7
"418","Casado/Amasiaado","Licenca_Medica",0.0617283950617284,0.119502335929167,81,107,93,14,76,5
"419","Solteiro","Licenca_Medica",0.148148148148148,0.0623834293303646,81,107,100,7,69,12
"420","Separado_Divorciado","Licenca_Medica",0.125,0.818440342361416,8,180,162,18,7,1
"421","X4","Licenca_Medica",0,0.558247600677103,3,185,166,19,3,0
"422","X5","Licenca_Medica",0,0.497866946944463,4,184,165,19,4,0
"423","X6","Licenca_Medica",0.0909090909090909,0.908319682917262,11,177,159,18,10,1
"424","Livrar_costas","Licenca_Medica",0.142857142857143,0.461784641670014,105,14,13,1,90,15
"425","Livrar_perna","Licenca_Medica",0.0769230769230769,0.51940770850611,13,106,91,15,12,1
"426","Livrar_perda_sens","Licenca_Medica",0,0.69225387709932,1,118,102,16,1,0
"427","D1","Licenca_Medica",0,0.689986442818079,1,131,113,18,1,0
"428","D15","Licenca_Medica",0.5,0.00789277254493988,6,126,111,15,3,3
"429","D16","Licenca_Medica",0.15,0.847021786519567,20,112,97,15,17,3
"430","D17","Licenca_Medica",0.4,0.0798941607124705,5,127,111,16,3,2
"431","D18","Licenca_Medica",0.1875,0.524894826481102,16,116,101,15,13,3
"432","D19","Licenca_Medica",0.142857142857143,0.95897070656557,7,125,108,17,6,1
"433","D2","Licenca_Medica",0.25,0.333881043695306,8,124,108,16,6,2
"434","D20","Licenca_Medica",0.25,0.333881043695306,8,124,108,16,6,2
"435","D21","Licenca_Medica",0.142857142857143,0.95897070656557,7,125,108,17,6,1
"436","D22","Licenca_Medica",0.5,0.131038190578192,2,130,113,17,1,1
"437","D23","Licenca_Medica",0,0.571218616780325,2,130,112,18,2,0
"438","D24","Licenca_Medica",0.153846153846154,0.771912292067862,26,106,92,14,22,4
"439","D25","Licenca_Medica",0,0.419642642987081,4,128,110,18,4,0
"440","D26","Licenca_Medica",0.5,0.131038190578192,2,130,113,17,1,1
"441","D27","Licenca_Medica",0.2,0.672493937177567,5,127,110,17,4,1
"442","D28","Licenca_Medica",0.166666666666667,0.824792496504831,6,126,109,17,5,1
"443","D29","Licenca_Medica",0.19047619047619,0.215871453602474,42,90,80,10,34,8
"444","D3","Licenca_Medica",0,0.571218616780325,2,130,112,18,2,0
"445","Lombalgia","Licenca_Medica",0.161290322580645,0.432226825910745,62,70,62,8,52,10
"446","D31","Licenca_Medica",0.25,0.157676405918824,16,116,102,14,12,4
"447","D32","Licenca_Medica",0.162162162162162,0.589871951342166,37,95,83,12,31,6
"448","D33","Licenca_Medica",0,0.168668618887815,11,121,103,18,11,0
"449","D34","Licenca_Medica",0.666666666666667,0.0067800176274091,3,129,113,16,1,2
"450","D35","Licenca_Medica",0.5,0.131038190578192,2,130,113,17,1,1
"451","D36","Licenca_Medica",0.428571428571429,0.0206108814462578,7,125,110,15,4,3
"452","D37","Licenca_Medica",0.272727272727273,0.0411841631553894,22,110,98,12,16,6
"453","D38","Licenca_Medica",0.5,0.131038190578192,2,130,113,17,1,1
"454","D39","Licenca_Medica",0.0666666666666667,0.40344451989591,15,117,100,17,14,1
"455","D4","Licenca_Medica",0.25,0.501243494852576,4,128,111,17,3,1
"456","D40","Licenca_Medica",0.75,0.000281575371963658,4,128,113,15,1,3
"457","D41","Licenca_Medica",0.428571428571429,0.0206108814462578,7,125,110,15,4,3
"458","D42","Licenca_Medica",0.333333333333333,0.314594493319487,3,129,112,17,2,1
"459","D43","Licenca_Medica",0.333333333333333,0.314594493319487,3,129,112,17,2,1
"460","D44","Licenca_Medica",0.157894736842105,0.646724446099857,38,94,82,12,32,6
"461","D45","Licenca_Medica",0.0909090909090909,0.64635519553949,11,121,104,17,10,1
"462","D46","Licenca_Medica",0.105263157894737,0.507962262298833,38,94,80,14,34,4
"463","D47","Licenca_Medica",0.0909090909090909,0.64635519553949,11,121,104,17,10,1
"464","D48","Licenca_Medica",0.115384615384615,0.727953336727627,26,106,91,15,23,3
"465","D49","Licenca_Medica",0.0833333333333333,0.574503810234665,12,120,103,17,11,1
"466","D5","Licenca_Medica",0.666666666666667,0.0067800176274091,3,129,113,16,1,2
"467","D50","Licenca_Medica",0.5,0.131038190578192,2,130,113,17,1,1
"468","D51","Licenca_Medica",1,0.0115304277292318,1,131,114,17,0,1
"469","D52","Licenca_Medica",0,0.571218616780325,2,130,112,18,2,0
"470","D53","Licenca_Medica",0,0.571218616780325,2,130,112,18,2,0
"471","D9","Licenca_Medica",1,0.0115304277292318,1,131,114,17,0,1
"472","RMDQ1_v1","Licenca_Medica",0.072463768115942,0.491131753247267,69,111,97,14,64,5
"473","RMDQ2_v1","Licenca_Medica",0.0810810810810811,0.631572469358286,74,106,93,13,68,6
"474","RMDQ3_v1","Licenca_Medica",0.0579710144927536,0.109476106898028,69,113,98,15,65,4
"475","RMDQ4_v1","Licenca_Medica",0.04,0.080360001397994,50,132,115,17,48,2
"476","RMDQ5_v1","Licenca_Medica",0.0645161290322581,0.205975110924668,62,120,105,15,58,4
"477","RMDQ6_v1","Licenca_Medica",0.0816326530612245,0.542133963304453,49,133,118,15,45,4
"478","RMDQ7_v1","Licenca_Medica",0.0909090909090909,0.770690562200125,33,148,132,16,30,3
"479","RMDQ8_v1","Licenca_Medica",0.125,0.85006787188331,8,173,155,18,7,1
"480","RMDQ9_v1","Licenca_Medica",0.107142857142857,0.967491810108547,28,153,137,16,25,3
"481","RMDQ10_v1","Licenca_Medica",0.117647058823529,0.789047381656993,34,147,132,15,30,4
"482","RMDQ11_v1","Licenca_Medica",0.114285714285714,0.841366533014604,35,146,131,15,31,4
"483","RMDQ12_v1","Licenca_Medica",0.105263157894737,0.994750570752259,38,143,128,15,34,4
"484","RMDQ13_v1","Licenca_Medica",0.0789473684210526,0.55596780094511,38,143,127,16,35,3
"485","RMDQ14_v1","Licenca_Medica",0.0975609756097561,0.860262402046614,41,140,125,15,37,4
"486","RMDQ15_v1","Licenca_Medica",0.125,0.731078307964245,24,157,141,16,21,3
"487","RMDQ16_v1","Licenca_Medica",0.1,0.922504735469014,30,151,135,16,27,3
"488","RMDQ17_v1","Licenca_Medica",0.1,0.907459721336339,40,141,126,15,36,4
"489","RMDQ18_v1","Licenca_Medica",0.133333333333333,0.578996382117435,30,151,136,15,26,4
"490","RMDQ19_v1","Licenca_Medica",0.153846153846154,0.379630163175822,26,155,140,15,22,4
"491","RMDQ20_v1","Licenca_Medica",0.129032258064516,0.631171563746075,31,150,135,15,27,4
"492","RMDQ21_v1","Licenca_Medica",0.1,0.907459721336339,40,141,126,15,36,4
"493","RMDQ22_v1","Licenca_Medica",0.125,0.683732260466205,32,149,134,15,28,4
"494","RMDQ23_v1","Licenca_Medica",0.129032258064516,0.631171563746075,31,150,135,15,27,4
"495","RMDQ24_v1","Licenca_Medica",0.137931034482759,0.527469400140656,29,152,137,15,25,4
"496","DN4 - Queimação","Licenca_Medica",0.125,0.194587992107932,80,102,95,7,70,10
"497","DN4 - Sensação de frio dolorosa","Licenca_Medica",0.0476190476190476,0.240464948395338,42,139,124,15,40,2
"498","DN4 - Choque elétrico","Licenca_Medica",0.170212765957447,0.0327472837765836,47,137,128,9,39,8
"499","DN4 - Formigamento","Licenca_Medica",0.0909090909090909,0.968951007462745,44,140,127,13,40,4
"500","DN4 - Alfinetada e agulhada","Licenca_Medica",0.176470588235294,0.0147324298305629,51,133,125,8,42,9
"501","DN4 - Adormecimento","Licenca_Medica",0.0980392156862745,0.893399602049962,51,131,119,12,46,5
"502","DN4 - Coceira","Licenca_Medica",0.5,0.000455707231909072,6,178,164,14,3,3
"503","DH4 - Hipoestesia ao toque","Licenca_Medica",0.4,0.0160293064749318,5,179,164,15,3,2
"504","DN4 - Hipoestesia a picada de agulha","Licenca_Medica",0.333333333333333,0.0382509940907734,6,178,163,15,4,2
"505","DN4 - Escovação","Licenca_Medica",0.5,0.00442300038628143,4,180,165,15,2,2
"506","Fuma","Aposentado_Invalidez",0.113636363636364,0.00961679018338874,44,138,135,3,39,5
"507","Cirurgia na coluna","Aposentado_Invalidez",0.028169014084507,0.971343896432104,71,110,107,3,69,2
"508","Aposentado","Aposentado_Invalidez",0.0285714285714286,0.677219347858284,35,159,152,7,34,1
"509","Desempregado","Aposentado_Invalidez",0.103448275862069,0.0723382861371128,29,162,157,5,26,3
"510","Licenca_Medica","Aposentado_Invalidez",0.166666666666667,0.00530589193071073,18,174,169,5,15,3
"511","Aposentado_Invalidez","Aposentado_Invalidez",1,9.43025074517101e-45,8,189,189,0,0,8
"512","Analgésicos","Aposentado_Invalidez",0.0555555555555556,0.195210218509698,126,64,63,1,119,7
"513","OutraDoenca","Aposentado_Invalidez",0.0694444444444444,0.135697128550724,72,120,117,3,67,5
"514","Dor nas costas","Aposentado_Invalidez",0.0608695652173913,0.110761738949136,115,75,74,1,108,7
"515","Dor nas pernas","Aposentado_Invalidez",0.11864406779661,0.000473032366164506,59,129,128,1,52,7
"516","Retornar_trabalho","Aposentado_Invalidez",0.19047619047619,0.000186475912400959,21,153,150,3,17,4
"517","Masc","Aposentado_Invalidez",0.03125,0.36470231540255,128,69,65,4,124,4
"518","Fem","Aposentado_Invalidez",0.0579710144927536,0.36470231540255,69,128,124,4,65,4
"519","Casado/Amasiaado","Aposentado_Invalidez",0.036144578313253,0.678630137763169,83,103,98,5,80,3
"520","Solteiro","Aposentado_Invalidez",0.051948051948052,0.613590313131274,77,109,105,4,73,4
"521","Separado_Divorciado","Aposentado_Invalidez",0,0.539908087525517,8,178,170,8,8,0
"522","X4","Aposentado_Invalidez",0,0.711239743217805,3,183,175,8,3,0
"523","X5","Aposentado_Invalidez",0,0.668190209618591,4,182,174,8,4,0
"524","X6","Aposentado_Invalidez",0.0909090909090909,0.419518039672779,11,175,168,7,10,1
"525","Livrar_costas","Aposentado_Invalidez",0.0588235294117647,0.285717336283617,102,15,13,2,96,6
"526","Livrar_perna","Aposentado_Invalidez",0.153846153846154,0.195299732576803,13,104,98,6,11,2
"527","Livrar_perda_sens","Aposentado_Invalidez",0,0.699165111851179,2,115,107,8,2,0
"528","D1","Aposentado_Invalidez",0,0.797943352456733,1,130,122,8,1,0
"529","D15","Aposentado_Invalidez",0.166666666666667,0.268803203207311,6,125,118,7,5,1
"530","D16","Aposentado_Invalidez",0.157894736842105,0.0566237703305408,19,112,107,5,16,3
"531","D17","Aposentado_Invalidez",0,0.560923278469121,5,126,118,8,5,0
"532","D18","Aposentado_Invalidez",0.0625,0.979641612736218,16,115,108,7,15,1
"533","D19","Aposentado_Invalidez",0.142857142857143,0.352973574776444,7,124,117,7,6,1
"534","D2","Aposentado_Invalidez",0.125,0.435791732583084,8,123,116,7,7,1
"535","D20","Aposentado_Invalidez",0.125,0.435791732583084,8,123,116,7,7,1
"536","D21","Aposentado_Invalidez",0,0.487975992982874,7,124,116,8,7,0
"537","D22","Aposentado_Invalidez",0,0.71626653488051,2,129,121,8,2,0
"538","D23","Aposentado_Invalidez",0,0.71626653488051,2,129,121,8,2,0
"539","D24","Aposentado_Invalidez",0.115384615384615,0.196392184446184,26,105,100,5,23,3
"540","D25","Aposentado_Invalidez",0,0.604436248364823,4,127,119,8,4,0
"541","D26","Aposentado_Invalidez",0,0.71626653488051,2,129,121,8,2,0
"542","D27","Aposentado_Invalidez",0.2,0.185886669411596,5,126,119,7,4,1
"543","D28","Aposentado_Invalidez",0,0.522489903787232,6,125,117,8,6,0
"544","D29","Aposentado_Invalidez",0.119047619047619,0.0569431985251796,42,89,86,3,37,5
"545","D3","Aposentado_Invalidez",0.5,0.00899304927632024,2,129,122,7,1,1
"546","Lombalgia","Aposentado_Invalidez",0.114754098360656,0.0166013910290389,61,70,69,1,54,7
"547","D31","Aposentado_Invalidez",0.0625,0.979641612736218,16,115,108,7,15,1
"548","D32","Aposentado_Invalidez",0.111111111111111,0.140902609084574,36,95,91,4,32,4
"549","D33","Aposentado_Invalidez",0,0.401389692847172,10,121,113,8,10,0
"550","D34","Aposentado_Invalidez",0,0.654967047400161,3,128,120,8,3,0
"551","D35","Aposentado_Invalidez",0,0.71626653488051,2,129,121,8,2,0
"552","D36","Aposentado_Invalidez",0,0.487975992982874,7,124,116,8,7,0
"553","D37","Aposentado_Invalidez",0.0909090909090909,0.521662740748473,22,109,103,6,20,2
"554","D38","Aposentado_Invalidez",0,0.71626653488051,2,129,121,8,2,0
"555","D39","Aposentado_Invalidez",0.0666666666666667,0.923347464369672,15,116,109,7,14,1
"556","D4","Aposentado_Invalidez",0.25,0.109009707129246,4,127,120,7,3,1
"557","D40","Aposentado_Invalidez",0,0.604436248364823,4,127,119,8,4,0
"558","D41","Aposentado_Invalidez",0.142857142857143,0.352973574776444,7,124,117,7,6,1
"559","D42","Aposentado_Invalidez",0,0.654967047400161,3,128,120,8,3,0
"560","D43","Aposentado_Invalidez",0,0.654967047400161,3,128,120,8,3,0
"561","D44","Aposentado_Invalidez",0.108108108108108,0.158358492930817,37,94,90,4,33,4
"562","D45","Aposentado_Invalidez",0.1,0.592682390026818,10,121,114,7,9,1
"563","D46","Aposentado_Invalidez",0.131578947368421,0.0312144132833846,38,93,90,3,33,5
"564","D47","Aposentado_Invalidez",0.181818181818182,0.0805623632313889,11,120,114,6,9,2
"565","D48","Aposentado_Invalidez",0.0769230769230769,0.706103161103857,26,105,99,6,24,2
"566","D49","Aposentado_Invalidez",0,0.353964775299636,12,119,111,8,12,0
"567","D5","Aposentado_Invalidez",0,0.654967047400161,3,128,120,8,3,0
"568","D50","Aposentado_Invalidez",0,0.71626653488051,2,129,121,8,2,0
"569","D51","Aposentado_Invalidez",0,0.797943352456733,1,130,122,8,1,0
"570","D52","Aposentado_Invalidez",0,0.71626653488051,2,129,121,8,2,0
"571","D53","Aposentado_Invalidez",0,0.71626653488051,2,129,121,8,2,0
"572","D9","Aposentado_Invalidez",0,0.797943352456733,1,130,122,8,1,0
"573","RMDQ1_v1","Aposentado_Invalidez",0.0895522388059701,0.0798744623061704,67,111,109,2,61,6
"574","RMDQ2_v1","Aposentado_Invalidez",0.0684931506849315,0.43725636344294,73,105,102,3,68,5
"575","RMDQ3_v1","Aposentado_Invalidez",0.0434782608695652,0.960446555128132,69,111,106,5,66,3
"576","RMDQ4_v1","Aposentado_Invalidez",0,0.0688637980419037,51,129,121,8,51,0
"577","RMDQ5_v1","Aposentado_Invalidez",0.0634920634920635,0.36284882192333,63,117,113,4,59,4
"578","RMDQ6_v1","Aposentado_Invalidez",0.08,0.15112853728011,50,130,126,4,46,4
"579","RMDQ7_v1","Aposentado_Invalidez",0.121212121212121,0.0184963401733147,33,146,142,4,29,4
"580","RMDQ8_v1","Aposentado_Invalidez",0,0.531365937649463,8,171,163,8,8,0
"581","RMDQ9_v1","Aposentado_Invalidez",0.142857142857143,0.00619948306247476,28,151,147,4,24,4
"582","RMDQ10_v1","Aposentado_Invalidez",0.117647058823529,0.0221722220036869,34,145,141,4,30,4
"583","RMDQ11_v1","Aposentado_Invalidez",0.111111111111111,0.0309446301208362,36,143,139,4,32,4
"584","RMDQ12_v1","Aposentado_Invalidez",0.105263157894737,0.0417496234732317,38,141,137,4,34,4
"585","RMDQ13_v1","Aposentado_Invalidez",0.1,0.0547239609846476,40,139,135,4,36,4
"586","RMDQ14_v1","Aposentado_Invalidez",0.0731707317073171,0.314860947951503,41,138,133,5,38,3
"587","RMDQ15_v1","Aposentado_Invalidez",0.12,0.0494559079512997,25,154,149,5,22,3
"588","RMDQ16_v1","Aposentado_Invalidez",0.0967741935483871,0.122741415423386,31,148,143,5,28,3
"589","RMDQ17_v1","Aposentado_Invalidez",0.075,0.292477195226406,40,139,134,5,37,3
"590","RMDQ18_v1","Aposentado_Invalidez",0.1,0.108078495180126,30,149,144,5,27,3
"591","RMDQ19_v1","Aposentado_Invalidez",0.153846153846154,0.00357403624347196,26,153,149,4,22,4
"592","RMDQ20_v1","Aposentado_Invalidez",0.129032258064516,0.0124440481664514,31,148,144,4,27,4
"593","RMDQ21_v1","Aposentado_Invalidez",0.102564102564103,0.0479583982745571,39,140,136,4,35,4
"594","RMDQ22_v1","Aposentado_Invalidez",0.125,0.0152623123117159,32,147,143,4,28,4
"595","RMDQ23_v1","Aposentado_Invalidez",0.129032258064516,0.0124440481664514,31,148,144,4,27,4
"596","RMDQ24_v1","Aposentado_Invalidez",0.137931034482759,0.00794239239755861,29,150,146,4,25,4
"597","DN4 - Queimação","Aposentado_Invalidez",0.0632911392405063,0.277857634711698,79,101,98,3,74,5
"598","DN4 - Sensação de frio dolorosa","Aposentado_Invalidez",0.0238095238095238,0.449459500118411,42,136,129,7,41,1
"599","DN4 - Choque elétrico","Aposentado_Invalidez",0.0625,0.465148484458466,48,134,129,5,45,3
"600","DN4 - Formigamento","Aposentado_Invalidez",0.0217391304347826,0.395149097485649,46,136,129,7,45,1
"601","DN4 - Alfinetada e agulhada","Aposentado_Invalidez",0.0769230769230769,0.170020943487372,52,130,126,4,48,4
"602","DN4 - Adormecimento","Aposentado_Invalidez",0.0784313725490196,0.164153020002218,51,129,125,4,47,4
"603","DN4 - Coceira","Aposentado_Invalidez",0.333333333333333,0.000437802717886862,6,176,170,6,4,2
"604","DH4 - Hipoestesia ao toque","Aposentado_Invalidez",0.333333333333333,0.000437802717886862,6,176,170,6,4,2
"605","DN4 - Hipoestesia a picada de agulha","Aposentado_Invalidez",0.285714285714286,0.00146267097872286,7,175,169,6,5,2
"606","DN4 - Escovação","Aposentado_Invalidez",0.4,8.21209548319804e-05,5,177,171,6,3,2
"607","Fuma","Analgésicos",0.688888888888889,0.653220190342817,45,141,49,92,14,31
"608","Cirurgia na coluna","Analgésicos",0.684210526315789,0.954510014019125,76,122,39,83,24,52
"609","Aposentado","Analgésicos",0.657142857142857,0.990231616017593,35,158,54,104,12,23
"610","Desempregado","Analgésicos",0.642857142857143,0.82248740219614,28,161,54,107,10,18
"611","Licenca_Medica","Analgésicos",0.578947368421053,0.465825325570309,19,172,58,114,8,11
"612","Aposentado_Invalidez","Analgésicos",0.875,0.195210218509698,8,182,63,119,1,7
"613","Analgésicos","Analgésicos",1,1.11446650118645e-48,147,68,68,0,0,147
"614","OutraDoenca","Analgésicos",0.706666666666667,0.314229489783317,75,124,45,79,22,53
"615","Dor nas costas","Analgésicos",0.811475409836066,6.19708737412872e-07,122,78,41,37,23,99
"616","Dor nas pernas","Analgésicos",0.84375,0.00051684607801849,64,134,54,80,10,54
"617","Retornar_trabalho","Analgésicos",0.857142857142857,0.0835175028777959,21,171,56,115,3,18
"618","Masc","Analgésicos",0.713286713286713,0.188906934421814,143,72,27,45,41,102
"619","Fem","Analgésicos",0.625,0.188906934421814,72,143,41,102,27,45
"620","Casado/Amasiaado","Analgésicos",0.691358024691358,0.328183557524011,81,106,40,66,25,56
"621","Solteiro","Analgésicos",0.6,0.193170181416443,80,107,33,74,32,48
"622","Separado_Divorciado","Analgésicos",0.75,0.553536642041824,8,179,63,116,2,6
"623","X4","Analgésicos",0.666666666666667,0.958298962814995,3,184,64,120,1,2
"624","X5","Analgésicos",0.25,0.0875580612118638,4,183,62,121,3,1
"625","X6","Analgésicos",0.818181818181818,0.234004444368344,11,176,63,113,2,9
"626","Livrar_costas","Analgésicos",0.796296296296296,0.575712767923035,108,15,4,11,22,86
"627","Livrar_perna","Analgésicos",0.785714285714286,0.977449561913696,14,109,23,86,3,11
"628","Livrar_perda_sens","Analgésicos",0,0.0524502369042994,1,122,25,97,1,0
"629","D1","Analgésicos",1,0.487982136848066,1,129,42,87,0,1
"630","D15","Analgésicos",0.428571428571429,0.148603043072552,7,123,38,85,4,3
"631","D16","Analgésicos",0.9,0.0203887833797969,20,110,40,70,2,18
"632","D17","Analgésicos",0.8,0.548410082507464,5,125,41,84,1,4
"633","D18","Analgésicos",0.866666666666667,0.0947700044635554,15,115,40,75,2,13
"634","D19","Analgésicos",0.833333333333333,0.401559180987227,6,124,41,83,1,5
"635","D2","Analgésicos",0.875,0.216215774783406,8,122,41,81,1,7
"636","D20","Analgésicos",0.857142857142857,0.29454223267992,7,123,41,82,1,6
"637","D21","Analgésicos",0.857142857142857,0.29454223267992,7,123,41,82,1,6
"638","D22","Analgésicos",1,0.487982136848066,1,129,42,87,0,1
"639","D23","Analgésicos",1,0.324814833547299,2,128,42,86,0,2
"640","D24","Analgésicos",0.653846153846154,0.778466787355829,26,104,33,71,9,17
"641","D25","Analgésicos",0.75,0.750902898480624,4,126,41,85,1,3
"642","D26","Analgésicos",1,0.324814833547299,2,128,42,86,0,2
"643","D27","Analgésicos",0.8,0.548410082507464,5,125,41,84,1,4
"644","D28","Analgésicos",0.666666666666667,0.956133769531025,6,124,40,84,2,4
"645","D29","Analgésicos",0.833333333333333,0.00842622352289202,42,88,35,53,7,35
"646","D3","Analgésicos",1,0.324814833547299,2,128,42,86,0,2
"647","Lombalgia","Analgésicos",0.854838709677419,3.4436982135305e-05,62,68,33,35,9,53
"648","D31","Analgésicos",0.529411764705882,0.163029976970274,17,113,34,79,8,9
"649","D32","Analgésicos",0.891891891891892,0.000946868254264692,37,93,38,55,4,33
"650","D33","Analgésicos",0.666666666666667,0.936441443032889,12,118,38,80,4,8
"651","D34","Analgésicos",0.666666666666667,0.969342526948564,3,127,41,86,1,2
"652","D35","Analgésicos",1,0.324814833547299,2,128,42,86,0,2
"653","D36","Analgésicos",0.375,0.0594303771813325,8,122,37,85,5,3
"654","D37","Analgésicos",0.818181818181818,0.120088133755193,22,108,38,70,4,18
"655","D38","Analgésicos",0.333333333333333,0.197919276854603,3,127,40,87,2,1
"656","D39","Analgésicos",0.933333333333333,0.023959531816871,15,115,41,74,1,14
"657","D4","Analgésicos",1,0.160480030593858,4,126,42,84,0,4
"658","D40","Analgésicos",0.4,0.176911873194487,5,125,39,86,3,2
"659","D41","Analgésicos",0.714285714285714,0.827965468160177,7,123,40,83,2,5
"660","D42","Analgésicos",0.5,0.589754290789669,2,128,41,87,1,1
"661","D43","Analgésicos",1,0.226034761081789,3,127,42,85,0,3
"662","D44","Analgésicos",0.868421052631579,0.00269429836471756,38,92,37,55,5,33
"663","D45","Analgésicos",0.75,0.569918988554808,12,118,39,79,3,9
"664","D46","Analgésicos",0.868421052631579,0.00269429836471756,38,92,37,55,5,33
"665","D47","Analgésicos",0.666666666666667,0.936441443032889,12,118,38,80,4,8
"666","D48","Analgésicos",0.846153846153846,0.0391130108691627,26,104,38,66,4,22
"667","D49","Analgésicos",0.615384615384615,0.61699041838055,13,117,37,80,5,8
"668","D5","Analgésicos",0.666666666666667,0.969342526948564,3,127,41,86,1,2
"669","D50","Analgésicos",0.5,0.589754290789669,2,128,41,87,1,1
"670","D51","Analgésicos",1,0.487982136848066,1,129,42,87,0,1
"671","D52","Analgésicos",0.5,0.589754290789669,2,128,41,87,1,1
"672","D53","Analgésicos",1,0.324814833547299,2,128,42,86,0,2
"673","D9","Analgésicos",1,0.487982136848066,1,129,42,87,0,1
"674","RMDQ1_v1","Analgésicos",0.783783783783784,0.173977862534876,74,123,41,82,16,58
"675","RMDQ2_v1","Analgésicos",0.79746835443038,0.0722802109307247,79,118,41,77,16,63
"676","RMDQ3_v1","Analgésicos",0.830985915492958,0.00635828553423594,71,128,45,83,12,59
"677","RMDQ4_v1","Analgésicos",0.816326530612245,0.0668612567988796,49,150,48,102,9,40
"678","RMDQ5_v1","Analgésicos",0.846153846153846,0.00395942573176394,65,134,47,87,10,55
"679","RMDQ6_v1","Analgésicos",0.823529411764706,0.0439931173903649,51,148,48,100,9,42
"680","RMDQ7_v1","Analgésicos",0.888888888888889,0.00960630295187735,36,162,53,109,4,32
"681","RMDQ8_v1","Analgésicos",0.875,0.298951634436328,8,190,56,134,1,7
"682","RMDQ9_v1","Analgésicos",0.903225806451613,0.010501955672672,31,167,54,113,3,28
"683","RMDQ10_v1","Analgésicos",0.891891891891892,0.00739991372741452,37,161,53,108,4,33
"684","RMDQ11_v1","Analgésicos",0.894736842105263,0.00567835904530934,38,160,53,107,4,34
"685","RMDQ12_v1","Analgésicos",0.853658536585366,0.024586892795058,41,157,51,106,6,35
"686","RMDQ13_v1","Analgésicos",0.785714285714286,0.235336113507785,42,156,48,108,9,33
"687","RMDQ14_v1","Analgésicos",0.866666666666667,0.0091938852823191,45,153,51,102,6,39
"688","RMDQ15_v1","Analgésicos",0.888888888888889,0.0290418269366636,27,171,54,117,3,24
"689","RMDQ16_v1","Analgésicos",0.852941176470588,0.0462990106372058,34,164,52,112,5,29
"690","RMDQ17_v1","Analgésicos",0.813953488372093,0.0955380427032517,43,155,49,106,8,35
"691","RMDQ18_v1","Analgésicos",0.909090909090909,0.00618949664597304,33,165,54,111,3,30
"692","RMDQ19_v1","Analgésicos",0.896551724137931,0.0175813141576387,29,169,54,115,3,26
"693","RMDQ20_v1","Analgésicos",0.911764705882353,0.00472757738008209,34,164,54,110,3,31
"694","RMDQ21_v1","Analgésicos",0.928571428571429,0.000482356511369728,42,156,54,102,3,39
"695","RMDQ22_v1","Analgésicos",0.852941176470588,0.0462990106372058,34,164,52,112,5,29
"696","RMDQ23_v1","Analgésicos",0.882352941176471,0.0160030952767158,34,164,53,111,4,30
"697","RMDQ24_v1","Analgésicos",0.90625,0.00807598686623394,32,166,54,112,3,29
"698","DN4 - Queimação","Analgésicos",0.795698924731183,0.00120430910508866,93,105,44,61,19,74
"699","DN4 - Sensação de frio dolorosa","Analgésicos",0.8,0.0443604331434067,45,153,55,98,9,36
"700","DN4 - Choque elétrico","Analgésicos",0.696428571428571,0.779017935677809,56,145,47,98,17,39
"701","DN4 - Formigamento","Analgésicos",0.725490196078431,0.435988065551561,51,150,50,100,14,37
"702","DN4 - Alfinetada e agulhada","Analgésicos",0.7,0.714783320721274,60,141,46,95,18,42
"703","DN4 - Adormecimento","Analgésicos",0.711864406779661,0.55426354494039,59,139,46,93,17,42
"704","DN4 - Coceira","Analgésicos",0.9,0.128289386014827,10,191,63,128,1,9
"705","DH4 - Hipoestesia ao toque","Analgésicos",1,0.0656699619495896,7,194,64,130,0,7
"706","DN4 - Hipoestesia a picada de agulha","Analgésicos",1,0.0485126520663351,8,193,64,129,0,8
"707","DN4 - Escovação","Analgésicos",1,0.0891772222388207,6,195,64,131,0,6
"708","Fuma","OutraDoenca",0.288888888888889,0.212458954373214,45,143,87,56,32,13
"709","Cirurgia na coluna","OutraDoenca",0.373333333333333,0.767481460709041,75,114,69,45,47,28
"710","Aposentado","OutraDoenca",0.513513513513513,0.0358790520062171,37,158,106,52,18,19
"711","Desempregado","OutraDoenca",0.466666666666667,0.214878642361632,30,161,105,56,16,14
"712","Licenca_Medica","OutraDoenca",0.368421052631579,0.99585727365643,19,174,110,64,12,7
"713","Aposentado_Invalidez","OutraDoenca",0.625,0.135697128550724,8,184,117,67,3,5
"714","Analgésicos","OutraDoenca",0.401515151515151,0.314229489783317,132,67,45,22,79,53
"715","OutraDoenca","OutraDoenca",1,6.20015755310928e-47,80,127,127,0,0,80
"716","Dor nas costas","OutraDoenca",0.415254237288136,0.18049051901881,118,78,53,25,69,49
"717","Dor nas pernas","OutraDoenca",0.444444444444444,0.183654936319851,63,133,87,46,35,28
"718","Retornar_trabalho","OutraDoenca",0.571428571428571,0.0507664448353277,21,162,105,57,9,12
"719","Masc","OutraDoenca",0.391304347826087,0.840025066217822,138,69,43,26,84,54
"720","Fem","OutraDoenca",0.376811594202899,0.840025066217822,69,138,84,54,43,26
"721","Casado/Amasiaado","OutraDoenca",0.333333333333333,0.417482424373421,84,105,64,41,56,28
"722","Solteiro","OutraDoenca",0.375,0.808246910411594,80,109,70,39,50,30
"723","Separado_Divorciado","OutraDoenca",0.714285714285714,0.0505160267416713,7,182,118,64,2,5
"724","X4","OutraDoenca",0.333333333333333,0.908345730160861,3,186,118,68,2,1
"725","X5","OutraDoenca",0,0.125304730406278,4,185,116,69,4,0
"726","X6","OutraDoenca",0.454545454545455,0.525382059585057,11,178,114,64,6,5
"727","Livrar_costas","OutraDoenca",0.411214953271028,0.526970982615792,107,14,7,7,63,44
"728","Livrar_perna","OutraDoenca",0.538461538461538,0.365968452548214,13,108,64,44,6,7
"729","Livrar_perda_sens","OutraDoenca",0,0.39138238494486,1,120,69,51,1,0
"730","D1","OutraDoenca",0,0.427412188827125,1,129,79,50,1,0
"731","D15","OutraDoenca",0.285714285714286,0.580300480306315,7,123,75,48,5,2
"732","D16","OutraDoenca",0.35,0.72940452739515,20,110,67,43,13,7
"733","D17","OutraDoenca",0,0.0714234577298519,5,125,75,50,5,0
"734","D18","OutraDoenca",0.3125,0.526622450513313,16,114,69,45,11,5
"735","D19","OutraDoenca",0.428571428571429,0.805872886488264,7,123,76,47,4,3
"736","D2","OutraDoenca",0.5,0.488645167772786,8,122,76,46,4,4
"737","D20","OutraDoenca",0.25,0.419161860625561,8,122,74,48,6,2
"738","D21","OutraDoenca",0.142857142857143,0.17648876461611,7,123,74,49,6,1
"739","D22","OutraDoenca",0,0.259854635493349,2,128,78,50,2,0
"740","D23","OutraDoenca",0,0.259854635493349,2,128,78,50,2,0
"741","D24","OutraDoenca",0.384615384615385,1,26,104,64,40,16,10
"742","D25","OutraDoenca",0.25,0.574038305978992,4,126,77,49,3,1
"743","D26","OutraDoenca",0.5,0.73534779052376,2,128,79,49,1,1
"744","D27","OutraDoenca",0.2,0.386856424005249,5,125,76,49,4,1
"745","D28","OutraDoenca",0.5,0.551952663689994,6,124,77,47,3,3
"746","D29","OutraDoenca",0.439024390243902,0.386780078685942,41,89,57,32,23,18
"747","D3","OutraDoenca",1,0.0714234577298519,2,128,80,48,0,2
"748","Lombalgia","OutraDoenca",0.426229508196721,0.359146156585886,61,69,45,24,35,26
"749","D31","OutraDoenca",0.470588235294118,0.434505708431121,17,113,71,42,9,8
"750","D32","OutraDoenca",0.416666666666667,0.642035101825467,36,94,59,35,21,15
"751","D33","OutraDoenca",0.333333333333333,0.701522711884324,12,118,72,46,8,4
"752","D34","OutraDoenca",0.333333333333333,0.853450236972764,3,127,78,49,2,1
"753","D35","OutraDoenca",0.5,0.73534779052376,2,128,79,49,1,1
"754","D36","OutraDoenca",0.375,0.953983258857795,8,122,75,47,5,3
"755","D37","OutraDoenca",0.363636363636364,0.824386794072651,22,108,66,42,14,8
"756","D38","OutraDoenca",0.333333333333333,0.853450236972764,3,127,78,49,2,1
"757","D39","OutraDoenca",0.466666666666667,0.487373850357657,15,115,72,43,8,7
"758","D4","OutraDoenca",0.75,0.127075082781751,4,126,79,47,1,3
"759","D40","OutraDoenca",0.2,0.386856424005249,5,125,76,49,4,1
"760","D41","OutraDoenca",0.285714285714286,0.580300480306315,7,123,75,48,5,2
"761","D42","OutraDoenca",0,0.165934803789697,3,127,77,50,3,0
"762","D43","OutraDoenca",0,0.165934803789697,3,127,77,50,3,0
"763","D44","OutraDoenca",0.378378378378378,0.926540879075171,37,93,57,36,23,14
"764","D45","OutraDoenca",0.416666666666667,0.810686022760786,12,118,73,45,7,5
"765","D46","OutraDoenca",0.459459459459459,0.268564802443693,37,93,60,33,20,17
"766","D47","OutraDoenca",0.416666666666667,0.810686022760786,12,118,73,45,7,5
"767","D48","OutraDoenca",0.538461538461538,0.0714234577298519,26,104,68,36,12,14
"768","D49","OutraDoenca",0.307692307692308,0.54788979951689,13,117,71,46,9,4
"769","D5","OutraDoenca",0.666666666666667,0.309653706055374,3,127,79,48,1,2
"770","D50","OutraDoenca",0.5,0.73534779052376,2,128,79,49,1,1
"771","D51","OutraDoenca",0,0.427412188827125,1,129,79,50,1,0
"772","D52","OutraDoenca",0,0.259854635493349,2,128,78,50,2,0
"773","D53","OutraDoenca",0,0.259854635493349,2,128,78,50,2,0
"774","D9","OutraDoenca",0,0.427412188827125,1,129,79,50,1,0
"775","RMDQ1_v1","OutraDoenca",0.445945945945946,0.408991699503199,74,114,72,42,41,33
"776","RMDQ2_v1","OutraDoenca",0.443037974683544,0.41300301959749,79,109,69,40,44,35
"777","RMDQ3_v1","OutraDoenca",0.442857142857143,0.357057998962371,70,120,75,45,39,31
"778","RMDQ4_v1","OutraDoenca",0.48,0.178565363964427,50,140,88,52,26,24
"779","RMDQ5_v1","OutraDoenca",0.46875,0.168008008369529,64,126,80,46,34,30
"780","RMDQ6_v1","OutraDoenca",0.5,0.0926693739313007,50,140,89,51,25,25
"781","RMDQ7_v1","OutraDoenca",0.485714285714286,0.233740762886372,35,154,96,58,18,17
"782","RMDQ8_v1","OutraDoenca",0.75,0.0369392541349894,8,181,112,69,2,6
"783","RMDQ9_v1","OutraDoenca",0.533333333333333,0.0956716871434678,30,159,100,59,14,16
"784","RMDQ10_v1","OutraDoenca",0.472222222222222,0.304088866143312,36,153,95,58,19,17
"785","RMDQ11_v1","OutraDoenca",0.5,0.145833663109846,38,151,95,56,19,19
"786","RMDQ12_v1","OutraDoenca",0.475,0.25504396518131,40,149,93,56,21,19
"787","RMDQ13_v1","OutraDoenca",0.5,0.121212851914524,42,147,93,54,21,21
"788","RMDQ14_v1","OutraDoenca",0.418604651162791,0.739789741005978,43,146,89,57,25,18
"789","RMDQ15_v1","OutraDoenca",0.461538461538462,0.467676973650704,26,163,100,63,14,12
"790","RMDQ16_v1","OutraDoenca",0.515151515151515,0.12619685298872,33,156,98,58,16,17
"791","RMDQ17_v1","OutraDoenca",0.619047619047619,0.000844379623581643,42,147,98,49,16,26
"792","RMDQ18_v1","OutraDoenca",0.53125,0.0881291314127013,32,157,99,58,15,17
"793","RMDQ19_v1","OutraDoenca",0.5,0.226639067524949,28,161,100,61,14,14
"794","RMDQ20_v1","OutraDoenca",0.5,0.190567051079525,32,157,98,59,16,16
"795","RMDQ21_v1","OutraDoenca",0.5,0.121212851914524,42,147,93,54,21,21
"796","RMDQ22_v1","OutraDoenca",0.515151515151515,0.12619685298872,33,156,98,58,16,17
"797","RMDQ23_v1","OutraDoenca",0.484848484848485,0.255275141212203,33,156,97,59,17,16
"798","RMDQ24_v1","OutraDoenca",0.516129032258065,0.137553628057166,31,158,99,59,15,16
"799","DN4 - Queimação","OutraDoenca",0.36046511627907,0.540596634506449,86,104,62,42,55,31
"800","DN4 - Sensação de frio dolorosa","OutraDoenca",0.357142857142857,0.755631602484096,42,146,90,56,27,15
"801","DN4 - Choque elétrico","OutraDoenca",0.4,0.720381968743229,55,137,86,51,33,22
"802","DN4 - Formigamento","OutraDoenca",0.365384615384615,0.796502239231962,52,140,86,54,33,19
"803","DN4 - Alfinetada e agulhada","OutraDoenca",0.491525423728814,0.0343185834306142,59,133,89,44,30,29
"804","DN4 - Adormecimento","OutraDoenca",0.410714285714286,0.627293249693758,56,134,84,50,33,23
"805","DN4 - Coceira","OutraDoenca",0.636363636363636,0.0714654272968782,11,181,115,66,4,7
"806","DH4 - Hipoestesia ao toque","OutraDoenca",0.428571428571429,0.788290736702024,7,185,115,70,4,3
"807","DN4 - Hipoestesia a picada de agulha","OutraDoenca",0.375,0.975270103701947,8,184,114,70,5,3
"808","DN4 - Escovação","OutraDoenca",0.333333333333333,0.810087574384097,6,186,115,71,4,2
"809","Fuma","Dor nas costas",0.673913043478261,0.19385513298324,46,138,60,78,15,31
"810","Cirurgia na coluna","Dor nas costas",0.64,0.428894661857236,75,115,48,67,27,48
"811","Aposentado","Dor nas costas",0.694444444444444,0.229648956990171,36,157,65,92,11,25
"812","Desempregado","Dor nas costas",0.9,0.000319401817353689,30,160,72,88,3,27
"813","Licenca_Medica","Dor nas costas",0.842105263157895,0.0272242331728375,19,172,72,100,3,16
"814","Aposentado_Invalidez","Dor nas costas",0.875,0.110761738949136,8,182,74,108,1,7
"815","Analgésicos","Dor nas costas",0.727941176470588,6.19708737412872e-07,136,64,41,23,37,99
"816","OutraDoenca","Dor nas costas",0.662162162162162,0.18049051901881,74,122,53,69,25,49
"817","Dor nas costas","Dor nas costas",1,6.20015755310937e-47,128,79,79,0,0,128
"818","Dor nas pernas","Dor nas costas",0.84375,5.85912419612062e-06,64,139,68,71,10,54
"819","Retornar_trabalho","Dor nas costas",0.9,0.00859017464793131,20,165,66,99,2,18
"820","Masc","Dor nas costas",0.652173913043478,0.156664377132565,138,69,31,38,48,90
"821","Fem","Dor nas costas",0.550724637681159,0.156664377132565,69,138,48,90,31,38
"822","Casado/Amasiaado","Dor nas costas",0.614457831325301,0.479682498903562,83,103,45,58,32,51
"823","Solteiro","Dor nas costas",0.558441558441558,0.520967895173565,77,109,43,66,34,43
"824","Separado_Divorciado","Dor nas costas",0.75,0.335762946847116,8,178,75,103,2,6
"825","X4","Dor nas costas",0.666666666666667,0.774949647916623,3,183,76,107,1,2
"826","X5","Dor nas costas",0.25,0.167789118226844,4,182,74,108,3,1
"827","X6","Dor nas costas",0.545454545454545,0.7782363490356,11,175,72,103,5,6
"828","Livrar_costas","Dor nas costas",0.918918918918919,5.90344938486379e-05,111,16,7,9,9,102
"829","Livrar_perna","Dor nas costas",0.571428571428571,0.000297932765117485,14,113,10,103,6,8
"830","Livrar_perda_sens","Dor nas costas",0.5,0.108120853726359,2,125,15,110,1,1
"831","D1","Dor nas costas",1,0.522073609395411,1,127,37,90,0,1
"832","D15","Dor nas costas",0.714285714285714,0.983964821465572,7,121,35,86,2,5
"833","D16","Dor nas costas",0.95,0.0102439119688552,20,108,36,72,1,19
"834","D17","Dor nas costas",1,0.145804141252675,5,123,37,86,0,5
"835","D18","Dor nas costas",0.9375,0.0325868338154857,16,112,36,76,1,15
"836","D19","Dor nas costas",1,0.0827110839918079,7,121,37,84,0,7
"837","D2","Dor nas costas",1,0.0625065347527681,8,120,37,83,0,8
"838","D20","Dor nas costas",1,0.0625065347527681,8,120,37,83,0,8
"839","D21","Dor nas costas",1,0.0827110839918079,7,121,37,84,0,7
"840","D22","Dor nas costas",1,0.363404269902099,2,126,37,89,0,2
"841","D23","Dor nas costas",1,0.363404269902099,2,126,37,89,0,2
"842","D24","Dor nas costas",0.846153846153846,0.0884253744878379,26,102,33,69,4,22
"843","D25","Dor nas costas",1,0.195079020743251,4,124,37,87,0,4
"844","D26","Dor nas costas",1,0.363404269902099,2,126,37,89,0,2
"845","D27","Dor nas costas",0.8,0.654046937992094,5,123,36,87,1,4
"846","D28","Dor nas costas",0.833333333333333,0.498141763008267,6,122,36,86,1,5
"847","D29","Dor nas costas",0.902439024390244,0.00103462733480009,41,87,33,54,4,37
"848","D3","Dor nas costas",1,0.363404269902099,2,126,37,89,0,2
"849","Lombalgia","Dor nas costas",0.918032786885246,8.1543225775394e-07,61,67,32,35,5,56
"850","D31","Dor nas costas",0.823529411764706,0.271474624108083,17,111,34,77,3,14
"851","D32","Dor nas costas",0.916666666666667,0.00131912599647501,36,92,34,58,3,33
"852","D33","Dor nas costas",0.75,0.753858312966399,12,116,34,82,3,9
"853","D34","Dor nas costas",0.666666666666667,0.8640934850506,3,125,36,89,1,2
"854","D35","Dor nas costas",1,0.363404269902099,2,126,37,89,0,2
"855","D36","Dor nas costas",0.5,0.17406518157812,8,120,33,87,4,4
"856","D37","Dor nas costas",0.863636363636364,0.082537057868517,22,106,34,72,3,19
"857","D38","Dor nas costas",0,0.00598285423779513,3,125,34,91,3,0
"858","D39","Dor nas costas",0.8,0.418037003967513,15,113,34,79,3,12
"859","D4","Dor nas costas",1,0.195079020743251,4,124,37,87,0,4
"860","D40","Dor nas costas",0.4,0.117680431791087,5,123,34,89,3,2
"861","D41","Dor nas costas",0.714285714285714,0.983964821465572,7,121,35,86,2,5
"862","D42","Dor nas costas",1,0.263733054433354,3,125,37,88,0,3
"863","D43","Dor nas costas",0.666666666666667,0.8640934850506,3,125,36,89,1,2
"864","D44","Dor nas costas",0.891891891891892,0.00398091877647235,37,91,33,58,4,33
"865","D45","Dor nas costas",0.75,0.753858312966399,12,116,34,82,3,9
"866","D46","Dor nas costas",0.837837837837838,0.0434389068415285,37,91,31,60,6,31
"867","D47","Dor nas costas",0.666666666666667,0.722317348868749,12,116,33,83,4,8
"868","D48","Dor nas costas",0.84,0.112539183962999,25,103,33,70,4,21
"869","D49","Dor nas costas",0.769230769230769,0.624741479704726,13,115,34,81,3,10
"870","D5","Dor nas costas",1,0.263733054433354,3,125,37,88,0,3
"871","D50","Dor nas costas",0.5,0.507170788539898,2,126,36,90,1,1
"872","D51","Dor nas costas",1,0.522073609395411,1,127,37,90,0,1
"873","D52","Dor nas costas",0.5,0.507170788539898,2,126,36,90,1,1
"874","D53","Dor nas costas",0.5,0.507170788539898,2,126,36,90,1,1
"875","D9","Dor nas costas",1,0.522073609395411,1,127,37,90,0,1
"876","RMDQ1_v1","Dor nas costas",0.689189189189189,0.45740839548198,74,115,44,71,23,51
"877","RMDQ2_v1","Dor nas costas",0.721518987341772,0.136458250890013,79,110,45,65,22,57
"878","RMDQ3_v1","Dor nas costas",0.690140845070423,0.361938081946207,71,120,45,75,22,49
"879","RMDQ4_v1","Dor nas costas",0.647058823529412,0.969940903729132,51,140,49,91,18,33
"880","RMDQ5_v1","Dor nas costas",0.671875,0.64131499335514,64,127,46,81,21,43
"881","RMDQ6_v1","Dor nas costas",0.770833333333333,0.0412921038496754,48,143,56,87,11,37
"882","RMDQ7_v1","Dor nas costas",0.823529411764706,0.0176626439468487,34,156,61,95,6,28
"883","RMDQ8_v1","Dor nas costas",0.875,0.168562916891474,8,182,66,116,1,7
"884","RMDQ9_v1","Dor nas costas",0.827586206896552,0.0273418247313347,29,161,62,99,5,24
"885","RMDQ10_v1","Dor nas costas",0.828571428571429,0.0129869015417078,35,155,61,94,6,29
"886","RMDQ11_v1","Dor nas costas",0.828571428571429,0.0129869015417078,35,155,61,94,6,29
"887","RMDQ12_v1","Dor nas costas",0.794871794871795,0.030568113837077,39,151,59,92,8,31
"888","RMDQ13_v1","Dor nas costas",0.75,0.126265896680955,40,150,57,93,10,30
"889","RMDQ14_v1","Dor nas costas",0.813953488372093,0.00934211538495321,43,147,59,88,8,35
"890","RMDQ15_v1","Dor nas costas",0.807692307692308,0.0655286404567252,26,164,62,102,5,21
"891","RMDQ16_v1","Dor nas costas",0.84375,0.0107818276470636,32,158,62,96,5,27
"892","RMDQ17_v1","Dor nas costas",0.738095238095238,0.163213774684252,42,148,56,92,11,31
"893","RMDQ18_v1","Dor nas costas",0.870967741935484,0.00439466950630126,31,159,63,96,4,27
"894","RMDQ19_v1","Dor nas costas",0.814814814814815,0.0492877297742991,27,163,62,101,5,22
"895","RMDQ20_v1","Dor nas costas",0.84375,0.0107818276470636,32,158,62,96,5,27
"896","RMDQ21_v1","Dor nas costas",0.767441860465116,0.0609938629334045,43,147,57,90,10,33
"897","RMDQ22_v1","Dor nas costas",0.78125,0.0821699604389636,32,158,60,98,7,25
"898","RMDQ23_v1","Dor nas costas",0.8125,0.0320359554146977,32,158,61,97,6,26
"899","RMDQ24_v1","Dor nas costas",0.833333333333333,0.0201725786429304,30,160,62,98,5,25
"900","DN4 - Queimação","Dor nas costas",0.686046511627907,0.0498363660707855,86,106,48,58,27,59
"901","DN4 - Sensação de frio dolorosa","Dor nas costas",0.636363636363636,0.675997484317467,44,148,59,89,16,28
"902","DN4 - Choque elétrico","Dor nas costas",0.692307692307692,0.146653671327541,52,142,60,82,16,36
"903","DN4 - Formigamento","Dor nas costas",0.695652173913043,0.164409258371794,46,148,62,86,14,32
"904","DN4 - Alfinetada e agulhada","Dor nas costas",0.654545454545455,0.405984173461354,55,139,57,82,19,36
"905","DN4 - Adormecimento","Dor nas costas",0.642857142857143,0.541735023725154,56,136,55,81,20,36
"906","DN4 - Coceira","Dor nas costas",0.625,0.921031456932321,8,186,73,113,3,5
"907","DH4 - Hipoestesia ao toque","Dor nas costas",0.833333333333333,0.251232754975307,6,188,75,113,1,5
"908","DN4 - Hipoestesia a picada de agulha","Dor nas costas",0.571428571428571,0.83893133358566,7,187,73,114,3,4
"909","DN4 - Escovação","Dor nas costas",0.8,0.373509792553173,5,189,75,114,1,4
"910","Fuma","Dor nas pernas",0.456521739130435,0.0405182809725091,46,137,97,40,25,21
"911","Cirurgia na coluna","Dor nas pernas",0.410958904109589,0.003576257458436,73,113,89,24,43,30
"912","Aposentado","Dor nas pernas",0.388888888888889,0.320663558134686,36,155,108,47,22,14
"913","Desempregado","Dor nas pernas",0.333333333333333,0.855737959119117,30,158,108,50,20,10
"914","Licenca_Medica","Dor nas pernas",0.631578947368421,0.00192559245462296,19,170,122,48,7,12
"915","Aposentado_Invalidez","Dor nas pernas",0.875,0.000473032366164506,8,180,128,52,1,7
"916","Analgésicos","Dor nas pernas",0.402985074626866,0.00051684607801849,134,64,54,10,80,54
"917","OutraDoenca","Dor nas pernas",0.378378378378378,0.183654936319851,74,122,87,35,46,28
"918","Dor nas costas","Dor nas pernas",0.432,5.85912419612062e-06,125,78,68,10,71,54
"919","Dor nas pernas","Dor nas pernas",1,2.7988808376563e-46,65,139,139,0,0,65
"920","Retornar_trabalho","Dor nas pernas",0.65,0.000968017031860393,20,162,116,46,7,13
"921","Masc","Dor nas pernas",0.326086956521739,0.740914474740368,138,66,46,20,93,45
"922","Fem","Dor nas pernas",0.303030303030303,0.740914474740368,66,138,93,45,46,20
"923","Casado/Amasiaado","Dor nas pernas",0.313253012048193,0.569511411530924,83,102,66,36,57,26
"924","Solteiro","Dor nas pernas",0.355263157894737,0.628181375399607,76,109,74,35,49,27
"925","Separado_Divorciado","Dor nas pernas",0.375,0.807070619087169,8,177,118,59,5,3
"926","X4","Dor nas pernas",0.333333333333333,0.994681636859168,3,182,121,61,2,1
"927","X5","Dor nas pernas",0,0.151128983532938,4,181,119,62,4,0
"928","X6","Dor nas pernas",0.454545454545455,0.386976844012474,11,174,117,57,6,5
"929","Livrar_costas","Dor nas pernas",0.4,0.000663642262154395,110,15,2,13,66,44
"930","Livrar_perna","Dor nas pernas",0.928571428571429,0.000164948611540917,14,111,67,44,1,13
"931","Livrar_perda_sens","Dor nas pernas",0,0.357972021988728,1,124,67,57,1,0
"932","D1","Dor nas pernas",0,0.380232056877916,1,126,71,55,1,0
"933","D15","Dor nas pernas",0.857142857142857,0.0198345060885519,7,120,71,49,1,6
"934","D16","Dor nas pernas",0.95,3.71703020242853e-07,20,107,71,36,1,19
"935","D17","Dor nas pernas",0.4,0.878975562520298,5,122,69,53,3,2
"936","D18","Dor nas pernas",0.3125,0.297821992365247,16,111,61,50,11,5
"937","D19","Dor nas pernas",0.428571428571429,0.980281654914855,7,120,68,52,4,3
"938","D2","Dor nas pernas",0.5,0.693079342054927,8,119,68,51,4,4
"939","D20","Dor nas pernas",0.25,0.280335999058053,8,119,66,53,6,2
"940","D21","Dor nas pernas",0.285714285714286,0.418260753637334,7,120,67,53,5,2
"941","D22","Dor nas pernas",0,0.212807680324934,2,125,70,55,2,0
"942","D23","Dor nas pernas",0.5,0.847314996250213,2,125,71,54,1,1
"943","D24","Dor nas pernas",0.269230769230769,0.0586751327171484,26,101,53,48,19,7
"944","D25","Dor nas pernas",0.25,0.452741394658823,4,123,69,54,3,1
"945","D26","Dor nas pernas",0,0.212807680324934,2,125,70,55,2,0
"946","D27","Dor nas pernas",0.2,0.283214200884168,5,122,68,54,4,1
"947","D28","Dor nas pernas",0.166666666666667,0.177267085933399,6,121,67,54,5,1
"948","D29","Dor nas pernas",0.731707317073171,2.73628343171399e-06,41,86,61,25,11,30
"949","D3","Dor nas pernas",0.5,0.847314996250213,2,125,71,54,1,1
"950","Lombalgia","Dor nas pernas",0.655737704918033,1.12376429601106e-06,61,66,51,15,21,40
"951","D31","Dor nas pernas",0.647058823529412,0.0557139595987118,17,110,66,44,6,11
"952","D32","Dor nas pernas",0.833333333333333,1.02969545357968e-08,36,91,66,25,6,30
"953","D33","Dor nas pernas",0.75,0.0198896607881082,12,115,69,46,3,9
"954","D34","Dor nas pernas",0.333333333333333,0.724215349818446,3,124,70,54,2,1
"955","D35","Dor nas pernas",0.5,0.847314996250213,2,125,71,54,1,1
"956","D36","Dor nas pernas",0.625,0.257717744087945,8,119,69,50,3,5
"957","D37","Dor nas pernas",0.863636363636364,7.37964654446395e-06,22,105,69,36,3,19
"958","D38","Dor nas pernas",1,0.0449027745456645,3,124,72,52,0,3
"959","D39","Dor nas pernas",0.866666666666667,0.000307450582078348,15,112,70,42,2,13
"960","D4","Dor nas pernas",0.5,0.783696380152113,4,123,70,53,2,2
"961","D40","Dor nas pernas",0.8,0.0911332797643791,5,122,71,51,1,4
"962","D41","Dor nas pernas",0.857142857142857,0.0198345060885519,7,120,71,49,1,6
"963","D42","Dor nas pernas",0,0.125515491370081,3,124,69,55,3,0
"964","D43","Dor nas pernas",0,0.125515491370081,3,124,69,55,3,0
"965","D44","Dor nas pernas",0.837837837837838,3.57837444266334e-09,37,90,66,24,6,31
"966","D45","Dor nas pernas",1,3.11176432970382e-05,12,115,72,43,0,12
"967","D46","Dor nas pernas",0.864864864864865,3.04014927402761e-10,37,90,67,23,5,32
"968","D47","Dor nas pernas",1,3.11176432970382e-05,12,115,72,43,0,12
"969","D48","Dor nas pernas",0.92,4.18907422610402e-08,25,102,70,32,2,23
"970","D49","Dor nas pernas",0.769230769230769,0.00982855903596777,13,114,69,45,3,10
"971","D5","Dor nas pernas",0.666666666666667,0.408596111613207,3,124,71,53,1,2
"972","D50","Dor nas pernas",0,0.212807680324934,2,125,70,55,2,0
"973","D51","Dor nas pernas",1,0.250685302469518,1,126,72,54,0,1
"974","D52","Dor nas pernas",0,0.212807680324934,2,125,70,55,2,0
"975","D53","Dor nas pernas",0,0.212807680324934,2,125,70,55,2,0
"976","D9","Dor nas pernas",1,0.250685302469518,1,126,72,54,0,1
"977","RMDQ1_v1","Dor nas pernas",0.364864864864865,0.707240280554545,74,113,75,38,47,27
"978","RMDQ2_v1","Dor nas pernas",0.367088607594937,0.683484612687491,79,108,72,36,50,29
"979","RMDQ3_v1","Dor nas pernas",0.328571428571429,0.733409291050627,70,119,77,42,47,23
"980","RMDQ4_v1","Dor nas pernas",0.235294117647059,0.0559905895730544,51,138,85,53,39,12
"981","RMDQ5_v1","Dor nas pernas",0.34375,0.997267956586687,64,125,82,43,42,22
"982","RMDQ6_v1","Dor nas pernas",0.375,0.599647884962992,48,141,94,47,30,18
"983","RMDQ7_v1","Dor nas pernas",0.441176470588235,0.196112821438704,34,154,104,50,19,15
"984","RMDQ8_v1","Dor nas pernas",0.375,0.858877036374012,8,180,118,62,5,3
"985","RMDQ9_v1","Dor nas pernas",0.482758620689655,0.0916200474716384,29,159,108,51,15,14
"986","RMDQ10_v1","Dor nas pernas",0.428571428571429,0.253431775477885,35,153,103,50,20,15
"987","RMDQ11_v1","Dor nas pernas",0.457142857142857,0.124536027938523,35,153,104,49,19,16
"988","RMDQ12_v1","Dor nas pernas",0.384615384615385,0.566435176918238,39,149,99,50,24,15
"989","RMDQ13_v1","Dor nas pernas",0.35,0.949148408669351,40,148,97,51,26,14
"990","RMDQ14_v1","Dor nas pernas",0.357142857142857,0.86010327939387,42,146,96,50,27,15
"991","RMDQ15_v1","Dor nas pernas",0.44,0.287253249877641,25,163,109,54,14,11
"992","RMDQ16_v1","Dor nas pernas",0.375,0.70247329917042,32,156,103,53,20,12
"993","RMDQ17_v1","Dor nas pernas",0.333333333333333,0.847813712224347,42,146,95,51,28,14
"994","RMDQ18_v1","Dor nas pernas",0.451612903225806,0.175035103529074,31,157,106,51,17,14
"995","RMDQ19_v1","Dor nas pernas",0.518518518518518,0.0413763918885079,27,161,110,51,13,14
"996","RMDQ20_v1","Dor nas pernas",0.4375,0.230901271720972,32,156,105,51,18,14
"997","RMDQ21_v1","Dor nas pernas",0.418604651162791,0.252688384451229,43,145,98,47,25,18
"998","RMDQ22_v1","Dor nas pernas",0.46875,0.108258813232636,32,156,106,50,17,15
"999","RMDQ23_v1","Dor nas pernas",0.4375,0.230901271720972,32,156,105,51,18,14
"1000","RMDQ24_v1","Dor nas pernas",0.466666666666667,0.128756227165614,30,158,107,51,16,14
"1001","DN4 - Queimação","Dor nas pernas",0.458823529411765,0.000252531915555172,85,105,83,22,46,39
"1002","DN4 - Sensação de frio dolorosa","Dor nas pernas",0.302325581395349,0.764916733861298,43,147,99,48,30,13
"1003","DN4 - Choque elétrico","Dor nas pernas",0.547169811320755,4.06963731872765e-05,53,139,106,33,24,29
"1004","DN4 - Formigamento","Dor nas pernas",0.51063829787234,0.00153960439967824,47,145,107,38,23,24
"1005","DN4 - Alfinetada e agulhada","Dor nas pernas",0.5,0.000758979055352931,56,136,102,34,28,28
"1006","DN4 - Adormecimento","Dor nas pernas",0.464285714285714,0.0062621414728558,56,134,99,35,30,26
"1007","DN4 - Coceira","Dor nas pernas",0.555555555555556,0.126303842853706,9,183,126,57,4,5
"1008","DH4 - Hipoestesia ao toque","Dor nas pernas",0.833333333333333,0.0065952994083608,6,186,129,57,1,5
"1009","DN4 - Hipoestesia a picada de agulha","Dor nas pernas",0.571428571428571,0.15200073527304,7,185,127,58,3,4
"1010","DN4 - Escovação","Dor nas pernas",0.8,0.0207909066765475,5,187,129,58,1,4
"1011","Fuma","Retornar_trabalho",0.181818181818182,0.144861961303073,44,122,110,12,36,8
"1012","Cirurgia na coluna","Retornar_trabalho",0.119402985074627,0.230050240924217,67,118,110,8,59,8
"1013","Aposentado","Retornar_trabalho",0.433333333333333,5.69642671267516e-09,30,146,138,8,17,13
"1014","Desempregado","Retornar_trabalho",0.269230769230769,0.00480133528504024,26,147,135,12,19,7
"1015","Licenca_Medica","Retornar_trabalho",0.176470588235294,0.396371582643094,17,158,141,17,14,3
"1016","Aposentado_Invalidez","Retornar_trabalho",0.571428571428571,0.000186475912400959,7,167,150,17,3,4
"1017","Analgésicos","Retornar_trabalho",0.135338345864662,0.0835175028777959,133,59,56,3,115,18
"1018","OutraDoenca","Retornar_trabalho",0.173913043478261,0.0507664448353277,69,114,105,9,57,12
"1019","Dor nas costas","Retornar_trabalho",0.153846153846154,0.00859017464793131,117,68,66,2,99,18
"1020","Dor nas pernas","Retornar_trabalho",0.220338983050847,0.000968017031860393,59,123,116,7,46,13
"1021","Retornar_trabalho","Retornar_trabalho",1,2.79888083765622e-46,21,183,183,0,0,21
"1022","Masc","Retornar_trabalho",0.111111111111111,0.591185020400678,135,69,63,6,120,15
"1023","Fem","Retornar_trabalho",0.0869565217391304,0.591185020400678,69,135,120,15,63,6
"1024","Casado/Amasiaado","Retornar_trabalho",0.0985915492957746,0.362687858881282,71,96,82,14,64,7
"1025","Solteiro","Retornar_trabalho",0.111111111111111,0.619430775692473,72,95,82,13,64,8
"1026","Separado_Divorciado","Retornar_trabalho",0.285714285714286,0.192205773791894,7,160,141,19,5,2
"1027","X4","Retornar_trabalho",0,0.507412062901068,3,164,143,21,3,0
"1028","X5","Retornar_trabalho",0,0.389220792601805,5,162,141,21,5,0
"1029","X6","Retornar_trabalho",0.444444444444444,0.00303132058526851,9,158,141,17,5,4
"1030","Livrar_costas","Retornar_trabalho",0.168224299065421,0.810101589700952,107,14,12,2,89,18
"1031","Livrar_perna","Retornar_trabalho",0.166666666666667,0.989201338532159,12,109,91,18,10,2
"1032","Livrar_perda_sens","Retornar_trabalho",0,0.525700342438451,2,119,99,20,2,0
"1033","D1","Retornar_trabalho",0,0.651725008243142,1,118,98,20,1,0
"1034","D15","Retornar_trabalho",0,0.220283219050709,7,112,92,20,7,0
"1035","D16","Retornar_trabalho",0.411764705882353,0.00370268020046657,17,102,89,13,10,7
"1036","D17","Retornar_trabalho",0,0.304495053929834,5,114,94,20,5,0
"1037","D18","Retornar_trabalho",0.125,0.620462573606016,16,103,85,18,14,2
"1038","D19","Retornar_trabalho",0.428571428571429,0.0574394426312504,7,112,95,17,4,3
"1039","D2","Retornar_trabalho",0.25,0.521070900456866,8,111,93,18,6,2
"1040","D20","Retornar_trabalho",0.375,0.105083597731138,8,111,94,17,5,3
"1041","D21","Retornar_trabalho",0.285714285714286,0.390868853825774,7,112,94,18,5,2
"1042","D22","Retornar_trabalho",0.5,0.205485590404682,2,117,98,19,1,1
"1043","D23","Retornar_trabalho",0.5,0.205485590404682,2,117,98,19,1,1
"1044","D24","Retornar_trabalho",0.291666666666667,0.0699282056256247,24,95,82,13,17,7
"1045","D25","Retornar_trabalho",0.75,0.00154431425368105,4,115,98,17,1,3
"1046","D26","Retornar_trabalho",0.5,0.205485590404682,2,117,98,19,1,1
"1047","D27","Retornar_trabalho",0.6,0.00831551678443962,5,114,97,17,2,3
"1048","D28","Retornar_trabalho",0.333333333333333,0.266574970439957,6,113,95,18,4,2
"1049","D29","Retornar_trabalho",0.256410256410256,0.0719425090297561,39,80,70,10,29,10
"1050","D3","Retornar_trabalho",0.5,0.205485590404682,2,117,98,19,1,1
"1051","Lombalgia","Retornar_trabalho",0.303571428571429,0.000193739782631283,56,63,60,3,39,17
"1052","D31","Retornar_trabalho",0.1875,0.82319184115033,16,103,86,17,13,3
"1053","D32","Retornar_trabalho",0.212121212121212,0.425959883996565,33,86,73,13,26,7
"1054","D33","Retornar_trabalho",0.1,0.547528200173061,10,109,90,19,9,1
"1055","D34","Retornar_trabalho",0,0.43040343200463,3,116,96,20,3,0
"1056","D35","Retornar_trabalho",0,0.52148919720768,2,117,97,20,2,0
"1057","D36","Retornar_trabalho",0,0.188073875208292,8,111,91,20,8,0
"1058","D37","Retornar_trabalho",0.35,0.017051652435814,20,99,86,13,13,7
"1059","D38","Retornar_trabalho",0,0.43040343200463,3,116,96,20,3,0
"1060","D39","Retornar_trabalho",0.357142857142857,0.043993319423529,14,105,90,15,9,5
"1061","D4","Retornar_trabalho",0.25,0.655751723264071,4,115,96,19,3,1
"1062","D40","Retornar_trabalho",0,0.304495053929834,5,114,94,20,5,0
"1063","D41","Retornar_trabalho",0.285714285714286,0.390868853825774,7,112,94,18,5,2
"1064","D42","Retornar_trabalho",0.333333333333333,0.438127087910104,3,116,97,19,2,1
"1065","D43","Retornar_trabalho",0.333333333333333,0.438127087910104,3,116,97,19,2,1
"1066","D44","Retornar_trabalho",0.205882352941176,0.485350084205755,34,85,72,13,27,7
"1067","D45","Retornar_trabalho",0.2,0.777812963766478,10,109,91,18,8,2
"1068","D46","Retornar_trabalho",0.257142857142857,0.0934608995444157,35,84,73,11,26,9
"1069","D47","Retornar_trabalho",0.272727272727273,0.329840199948571,11,108,91,17,8,3
"1070","D48","Retornar_trabalho",0.391304347826087,0.0014339061016768,23,96,85,11,14,9
"1071","D49","Retornar_trabalho",0.166666666666667,0.989082709194739,12,107,89,18,10,2
"1072","D5","Retornar_trabalho",0.333333333333333,0.438127087910104,3,116,97,19,2,1
"1073","D50","Retornar_trabalho",0,0.52148919720768,2,117,97,20,2,0
"1074","D51","Retornar_trabalho",0,0.651725008243142,1,118,98,20,1,0
"1075","D52","Retornar_trabalho",0,0.52148919720768,2,117,97,20,2,0
"1076","D53","Retornar_trabalho",0,0.52148919720768,2,117,97,20,2,0
"1077","D9","Retornar_trabalho",0,0.651725008243142,1,118,98,20,1,0
"1078","RMDQ1_v1","Retornar_trabalho",0.128571428571429,0.615063094370002,70,116,106,10,61,9
"1079","RMDQ2_v1","Retornar_trabalho",0.144736842105263,0.263558784410674,76,110,102,8,65,11
"1080","RMDQ3_v1","Retornar_trabalho",0.157142857142857,0.0821079303381303,70,118,109,9,59,11
"1081","RMDQ4_v1","Retornar_trabalho",0.183673469387755,0.0412784706079568,49,139,128,11,40,9
"1082","RMDQ5_v1","Retornar_trabalho",0.19047619047619,0.00793388580791674,63,125,117,8,51,12
"1083","RMDQ6_v1","Retornar_trabalho",0.1875,0.0346690099072591,48,140,129,11,39,9
"1084","RMDQ7_v1","Retornar_trabalho",0.176470588235294,0.110178653160073,34,153,140,13,28,6
"1085","RMDQ8_v1","Retornar_trabalho",0.25,0.155624355704656,8,179,162,17,6,2
"1086","RMDQ9_v1","Retornar_trabalho",0.166666666666667,0.197998001862274,30,157,143,14,25,5
"1087","RMDQ10_v1","Retornar_trabalho",0.194444444444444,0.0401915700856117,36,151,139,12,29,7
"1088","RMDQ11_v1","Retornar_trabalho",0.189189189189189,0.0489688269629625,37,150,138,12,30,7
"1089","RMDQ12_v1","Retornar_trabalho",0.179487179487179,0.0703630461763821,39,148,136,12,32,7
"1090","RMDQ13_v1","Retornar_trabalho",0.184210526315789,0.0590022930973136,38,149,137,12,31,7
"1091","RMDQ14_v1","Retornar_trabalho",0.136363636363636,0.382830931936709,44,143,130,13,38,6
"1092","RMDQ15_v1","Retornar_trabalho",0.0740740740740741,0.608739840807284,27,160,143,17,25,2
"1093","RMDQ16_v1","Retornar_trabalho",0.137931034482759,0.481174922431539,29,158,143,15,25,4
"1094","RMDQ17_v1","Retornar_trabalho",0.15,0.253188258722443,40,147,134,13,34,6
"1095","RMDQ18_v1","Retornar_trabalho",0.1875,0.0773133645580507,32,155,142,13,26,6
"1096","RMDQ19_v1","Retornar_trabalho",0.148148148148148,0.38682096479595,27,160,145,15,23,4
"1097","RMDQ20_v1","Retornar_trabalho",0.1875,0.0773133645580507,32,155,142,13,26,6
"1098","RMDQ21_v1","Retornar_trabalho",0.232558139534884,0.00119976828482172,43,144,135,9,33,10
"1099","RMDQ22_v1","Retornar_trabalho",0.181818181818182,0.0928309549108063,33,154,141,13,27,6
"1100","RMDQ23_v1","Retornar_trabalho",0.181818181818182,0.0928309549108063,33,154,141,13,27,6
"1101","RMDQ24_v1","Retornar_trabalho",0.193548387096774,0.0635782280420257,31,156,143,13,25,6
"1102","DN4 - Queimação","Retornar_trabalho",0.0795454545454545,0.625575503807537,88,100,90,10,81,7
"1103","DN4 - Sensação de frio dolorosa","Retornar_trabalho",0.0476190476190476,0.272348348007432,42,146,131,15,40,2
"1104","DN4 - Choque elétrico","Retornar_trabalho",0.132075471698113,0.195158915345752,53,138,128,10,46,7
"1105","DN4 - Formigamento","Retornar_trabalho",0.108695652173913,0.59039013813298,46,145,133,12,41,5
"1106","DN4 - Alfinetada e agulhada","Retornar_trabalho",0.137931034482759,0.116855005104781,58,133,124,9,50,8
"1107","DN4 - Adormecimento","Retornar_trabalho",0.142857142857143,0.102525688376637,56,132,123,9,48,8
"1108","DN4 - Coceira","Retornar_trabalho",0.2,0.205429107867913,10,181,166,15,8,2
"1109","DH4 - Hipoestesia ao toque","Retornar_trabalho",0.428571428571429,0.00130664873956548,7,184,170,14,4,3
"1110","DN4 - Hipoestesia a picada de agulha","Retornar_trabalho",0.375,0.00370542718338043,8,183,169,14,5,3
"1111","DN4 - Escovação","Retornar_trabalho",0.5,0.000327726219129346,6,185,171,14,3,3
"1112","Fuma","Masc",0.652173913043478,0.706412141882839,46,154,49,105,16,30
"1113","Cirurgia na coluna","Masc",0.708860759493671,0.266666356359924,79,134,49,85,23,56
"1114","Aposentado","Masc",0.783783783783784,0.0715188039001151,37,164,61,103,8,29
"1115","Desempregado","Masc",0.6,0.535031836195367,30,167,57,110,12,18
"1116","Licenca_Medica","Masc",0.631578947368421,0.834566600291896,19,180,62,118,7,12
"1117","Aposentado_Invalidez","Masc",0.5,0.36470231540255,8,189,65,124,4,4
"1118","Analgésicos","Masc",0.693877551020408,0.188906934421814,147,68,27,41,45,102
"1119","OutraDoenca","Masc",0.675,0.840025066217822,80,127,43,84,26,54
"1120","Dor nas costas","Masc",0.703125,0.156664377132565,128,79,31,48,38,90
"1121","Dor nas pernas","Masc",0.692307692307692,0.740914474740368,65,139,46,93,20,45
"1122","Retornar_trabalho","Masc",0.714285714285714,0.591185020400678,21,183,63,120,6,15
"1123","Masc","Masc",1,3.93283317934845e-54,161,79,79,0,0,161
"1124","Fem","Masc",0,3.93283317934845e-54,79,161,0,161,79,0
"1125","Casado/Amasiaado","Masc",0.588235294117647,0.0541044497258265,85,117,33,84,35,50
"1126","Solteiro","Masc",0.693181818181818,0.430776599778904,88,114,41,73,27,61
"1127","Separado_Divorciado","Masc",0.625,0.81473433983609,8,194,65,129,3,5
"1128","X4","Masc",0.666666666666667,0.990276089123858,3,199,67,132,1,2
"1129","X5","Masc",0.666666666666667,0.98614382403195,6,196,66,130,2,4
"1130","X6","Masc",1,0.0109454307198087,12,190,68,122,0,12
"1131","Livrar_costas","Masc",0.705357142857143,0.099605876029224,112,16,8,8,33,79
"1132","Livrar_perna","Masc",0.5,0.126801388816998,14,114,34,80,7,7
"1133","Livrar_perda_sens","Masc",0.5,0.58305867218302,2,126,40,86,1,1
"1134","D1","Masc",1,0.458524130935477,1,135,48,87,0,1
"1135","D15","Masc",0.571428571428571,0.66724773570396,7,129,45,84,3,4
"1136","D16","Masc",0.7,0.591650357484209,20,116,42,74,6,14
"1137","D17","Masc",1,0.0924396383197938,5,131,48,83,0,5
"1138","D18","Masc",0.8125,0.14042502806385,16,120,45,75,3,13
"1139","D19","Masc",1,0.0448207879789162,7,129,48,81,0,7
"1140","D2","Masc",0.75,0.529988878117519,8,128,46,82,2,6
"1141","D20","Masc",0.625,0.892946837110376,8,128,45,83,3,5
"1142","D21","Masc",0.714285714285714,0.702343753340064,7,129,46,83,2,5
"1143","D22","Masc",1,0.292693309963762,2,134,48,86,0,2
"1144","D23","Masc",0.5,0.661074727453963,2,134,47,87,1,1
"1145","D24","Masc",0.615384615384615,0.707074768398805,26,110,38,72,10,16
"1146","D25","Masc",0.75,0.661894461378815,4,132,47,85,1,3
"1147","D26","Masc",1,0.292693309963762,2,134,48,86,0,2
"1148","D27","Masc",0.8,0.465906514793997,5,131,47,84,1,4
"1149","D28","Masc",0.5,0.440720541547737,6,130,45,85,3,3
"1150","D29","Masc",0.714285714285714,0.272814178064602,42,94,36,58,12,30
"1151","D3","Masc",1,0.292693309963762,2,134,48,86,0,2
"1152","Lombalgia","Masc",0.67741935483871,0.497666697348367,62,74,28,46,20,42
"1153","D31","Masc",0.588235294117647,0.58743218885099,17,119,41,78,7,10
"1154","D32","Masc",0.756756756756757,0.101725444761412,37,99,39,60,9,28
"1155","D33","Masc",0.583333333333333,0.628548760174048,12,124,43,81,5,7
"1156","D34","Masc",0.333333333333333,0.250216747845471,3,133,46,87,2,1
"1157","D35","Masc",1,0.292693309963762,2,134,48,86,0,2
"1158","D36","Masc",0.625,0.892946837110376,8,128,45,83,3,5
"1159","D37","Masc",0.772727272727273,0.177916323257352,22,114,43,71,5,17
"1160","D38","Masc",0.333333333333333,0.250216747845471,3,133,46,87,2,1
"1161","D39","Masc",0.733333333333333,0.458524130935477,15,121,44,77,4,11
"1162","D4","Masc",1,0.133792934611541,4,132,48,84,0,4
"1163","D40","Masc",0.6,0.822480650855677,5,131,46,85,2,3
"1164","D41","Masc",1,0.0448207879789162,7,129,48,81,0,7
"1165","D42","Masc",1,0.195820569825375,3,133,48,85,0,3
"1166","D43","Masc",0.333333333333333,0.250216747845471,3,133,46,87,2,1
"1167","D44","Masc",0.763157894736842,0.0776941451478986,38,98,39,59,9,29
"1168","D45","Masc",0.666666666666667,0.881670055755965,12,124,44,80,4,8
"1169","D46","Masc",0.736842105263158,0.172462527341592,38,98,38,60,10,28
"1170","D47","Masc",0.666666666666667,0.881670055755965,12,124,44,80,4,8
"1171","D48","Masc",0.730769230769231,0.320635359680323,26,110,41,69,7,19
"1172","D49","Masc",0.615384615384615,0.801591655827893,13,123,43,80,5,8
"1173","D5","Masc",0.666666666666667,0.942710185623704,3,133,47,86,1,2
"1174","D50","Masc",0,0.0537195355854463,2,134,46,88,2,0
"1175","D51","Masc",1,0.458524130935477,1,135,48,87,0,1
"1176","D52","Masc",0.5,0.661074727453963,2,134,47,87,1,1
"1177","D53","Masc",0,0.0537195355854463,2,134,46,88,2,0
"1178","D9","Masc",1,0.458524130935477,1,135,48,87,0,1
"1179","RMDQ1_v1","Masc",0.705882352941177,0.590410991765288,85,134,46,88,25,60
"1180","RMDQ2_v1","Masc",0.711111111111111,0.509070526339633,90,129,45,84,26,64
"1181","RMDQ3_v1","Masc",0.7,0.610064253127636,80,141,47,94,24,56
"1182","RMDQ4_v1","Masc",0.672727272727273,0.912365951801742,55,166,53,113,18,37
"1183","RMDQ5_v1","Masc",0.698630136986301,0.656412994827159,73,148,49,99,22,51
"1184","RMDQ6_v1","Masc",0.701754385964912,0.665686296372905,57,164,54,110,17,40
"1185","RMDQ7_v1","Masc",0.692307692307692,0.824769269525231,39,181,59,122,12,27
"1186","RMDQ8_v1","Masc",0.625,0.747335802149721,8,212,68,144,3,5
"1187","RMDQ9_v1","Masc",0.676470588235294,0.991318878305776,34,186,60,126,11,23
"1188","RMDQ10_v1","Masc",0.675,0.972885024164127,40,180,58,122,13,27
"1189","RMDQ11_v1","Masc",0.666666666666667,0.870165460476907,42,178,57,121,14,28
"1190","RMDQ12_v1","Masc",0.681818181818182,0.942519185502165,44,176,57,119,14,30
"1191","RMDQ13_v1","Masc",0.695652173913043,0.764320864519931,46,174,57,117,14,32
"1192","RMDQ14_v1","Masc",0.653061224489796,0.680939537637105,49,171,54,117,17,32
"1193","RMDQ15_v1","Masc",0.741935483870968,0.406065670574831,31,189,63,126,8,23
"1194","RMDQ16_v1","Masc",0.675675675675676,0.981823574961799,37,183,59,124,12,25
"1195","RMDQ17_v1","Masc",0.755102040816326,0.186245757731077,49,171,59,112,12,37
"1196","RMDQ18_v1","Masc",0.666666666666667,0.881682998146209,36,184,59,125,12,24
"1197","RMDQ19_v1","Masc",0.6875,0.89350918762575,32,188,61,127,10,22
"1198","RMDQ20_v1","Masc",0.710526315789474,0.629759193064311,38,182,60,122,11,27
"1199","RMDQ21_v1","Masc",0.666666666666667,0.858915264924219,48,172,55,117,16,32
"1200","RMDQ22_v1","Masc",0.710526315789474,0.629759193064311,38,182,60,122,11,27
"1201","RMDQ23_v1","Masc",0.702702702702703,0.716775702121014,37,183,60,123,11,26
"1202","RMDQ24_v1","Masc",0.685714285714286,0.907265516814864,35,185,60,125,11,24
"1203","DN4 - Queimação","Masc",0.643564356435644,0.561561699150641,101,119,38,81,36,65
"1204","DN4 - Sensação de frio dolorosa","Masc",0.666666666666667,0.939250945897119,48,171,56,115,16,32
"1205","DN4 - Choque elétrico","Masc",0.754098360655738,0.0944489894177433,61,162,59,103,15,46
"1206","DN4 - Formigamento","Masc",0.701754385964912,0.532443320790802,57,166,57,109,17,40
"1207","DN4 - Alfinetada e agulhada","Masc",0.692307692307692,0.623310672677408,65,158,54,104,20,45
"1208","DN4 - Adormecimento","Masc",0.661290322580645,0.96320145437287,62,158,53,105,21,41
"1209","DN4 - Coceira","Masc",0.818181818181818,0.278478014292514,11,212,72,140,2,9
"1210","DH4 - Hipoestesia ao toque","Masc",0.75,0.616619212122889,8,215,72,143,2,6
"1211","DN4 - Hipoestesia a picada de agulha","Masc",0.777777777777778,0.475898128680994,9,214,72,142,2,7
"1212","DN4 - Escovação","Masc",0.714285714285714,0.792296379331768,7,216,72,144,2,5
"1213","Fuma","Fem",0.347826086956522,0.706412141882839,46,154,105,49,30,16
"1214","Cirurgia na coluna","Fem",0.291139240506329,0.266666356359924,79,134,85,49,56,23
"1215","Aposentado","Fem",0.216216216216216,0.0715188039001151,37,164,103,61,29,8
"1216","Desempregado","Fem",0.4,0.535031836195367,30,167,110,57,18,12
"1217","Licenca_Medica","Fem",0.368421052631579,0.834566600291896,19,180,118,62,12,7
"1218","Aposentado_Invalidez","Fem",0.5,0.36470231540255,8,189,124,65,4,4
"1219","Analgésicos","Fem",0.306122448979592,0.188906934421814,147,68,41,27,102,45
"1220","OutraDoenca","Fem",0.325,0.840025066217822,80,127,84,43,54,26
"1221","Dor nas costas","Fem",0.296875,0.156664377132565,128,79,48,31,90,38
"1222","Dor nas pernas","Fem",0.307692307692308,0.740914474740368,65,139,93,46,45,20
"1223","Retornar_trabalho","Fem",0.285714285714286,0.591185020400678,21,183,120,63,15,6
"1224","Masc","Fem",0,3.93283317934845e-54,161,79,0,79,161,0
"1225","Fem","Fem",1,3.93283317934845e-54,79,161,161,0,0,79
"1226","Casado/Amasiaado","Fem",0.411764705882353,0.0541044497258265,85,117,84,33,50,35
"1227","Solteiro","Fem",0.306818181818182,0.430776599778904,88,114,73,41,61,27
"1228","Separado_Divorciado","Fem",0.375,0.81473433983609,8,194,129,65,5,3
"1229","X4","Fem",0.333333333333333,0.990276089123858,3,199,132,67,2,1
"1230","X5","Fem",0.333333333333333,0.98614382403195,6,196,130,66,4,2
"1231","X6","Fem",0,0.0109454307198087,12,190,122,68,12,0
"1232","Livrar_costas","Fem",0.294642857142857,0.099605876029224,112,16,8,8,79,33
"1233","Livrar_perna","Fem",0.5,0.126801388816998,14,114,80,34,7,7
"1234","Livrar_perda_sens","Fem",0.5,0.58305867218302,2,126,86,40,1,1
"1235","D1","Fem",0,0.458524130935477,1,135,87,48,1,0
"1236","D15","Fem",0.428571428571429,0.66724773570396,7,129,84,45,4,3
"1237","D16","Fem",0.3,0.591650357484209,20,116,74,42,14,6
"1238","D17","Fem",0,0.0924396383197938,5,131,83,48,5,0
"1239","D18","Fem",0.1875,0.14042502806385,16,120,75,45,13,3
"1240","D19","Fem",0,0.0448207879789162,7,129,81,48,7,0
"1241","D2","Fem",0.25,0.529988878117519,8,128,82,46,6,2
"1242","D20","Fem",0.375,0.892946837110376,8,128,83,45,5,3
"1243","D21","Fem",0.285714285714286,0.702343753340064,7,129,83,46,5,2
"1244","D22","Fem",0,0.292693309963762,2,134,86,48,2,0
"1245","D23","Fem",0.5,0.661074727453963,2,134,87,47,1,1
"1246","D24","Fem",0.384615384615385,0.707074768398805,26,110,72,38,16,10
"1247","D25","Fem",0.25,0.661894461378815,4,132,85,47,3,1
"1248","D26","Fem",0,0.292693309963762,2,134,86,48,2,0
"1249","D27","Fem",0.2,0.465906514793997,5,131,84,47,4,1
"1250","D28","Fem",0.5,0.440720541547737,6,130,85,45,3,3
"1251","D29","Fem",0.285714285714286,0.272814178064602,42,94,58,36,30,12
"1252","D3","Fem",0,0.292693309963762,2,134,86,48,2,0
"1253","Lombalgia","Fem",0.32258064516129,0.497666697348367,62,74,46,28,42,20
"1254","D31","Fem",0.411764705882353,0.58743218885099,17,119,78,41,10,7
"1255","D32","Fem",0.243243243243243,0.101725444761412,37,99,60,39,28,9
"1256","D33","Fem",0.416666666666667,0.628548760174048,12,124,81,43,7,5
"1257","D34","Fem",0.666666666666667,0.250216747845471,3,133,87,46,1,2
"1258","D35","Fem",0,0.292693309963762,2,134,86,48,2,0
"1259","D36","Fem",0.375,0.892946837110376,8,128,83,45,5,3
"1260","D37","Fem",0.227272727272727,0.177916323257352,22,114,71,43,17,5
"1261","D38","Fem",0.666666666666667,0.250216747845471,3,133,87,46,1,2
"1262","D39","Fem",0.266666666666667,0.458524130935477,15,121,77,44,11,4
"1263","D4","Fem",0,0.133792934611541,4,132,84,48,4,0
"1264","D40","Fem",0.4,0.822480650855677,5,131,85,46,3,2
"1265","D41","Fem",0,0.0448207879789162,7,129,81,48,7,0
"1266","D42","Fem",0,0.195820569825375,3,133,85,48,3,0
"1267","D43","Fem",0.666666666666667,0.250216747845471,3,133,87,46,1,2
"1268","D44","Fem",0.236842105263158,0.0776941451478986,38,98,59,39,29,9
"1269","D45","Fem",0.333333333333333,0.881670055755965,12,124,80,44,8,4
"1270","D46","Fem",0.263157894736842,0.172462527341592,38,98,60,38,28,10
"1271","D47","Fem",0.333333333333333,0.881670055755965,12,124,80,44,8,4
"1272","D48","Fem",0.269230769230769,0.320635359680323,26,110,69,41,19,7
"1273","D49","Fem",0.384615384615385,0.801591655827893,13,123,80,43,8,5
"1274","D5","Fem",0.333333333333333,0.942710185623704,3,133,86,47,2,1
"1275","D50","Fem",1,0.0537195355854463,2,134,88,46,0,2
"1276","D51","Fem",0,0.458524130935477,1,135,87,48,1,0
"1277","D52","Fem",0.5,0.661074727453963,2,134,87,47,1,1
"1278","D53","Fem",1,0.0537195355854463,2,134,88,46,0,2
"1279","D9","Fem",0,0.458524130935477,1,135,87,48,1,0
"1280","RMDQ1_v1","Fem",0.294117647058824,0.590410991765288,85,134,88,46,60,25
"1281","RMDQ2_v1","Fem",0.288888888888889,0.509070526339633,90,129,84,45,64,26
"1282","RMDQ3_v1","Fem",0.3,0.610064253127636,80,141,94,47,56,24
"1283","RMDQ4_v1","Fem",0.327272727272727,0.912365951801742,55,166,113,53,37,18
"1284","RMDQ5_v1","Fem",0.301369863013699,0.656412994827159,73,148,99,49,51,22
"1285","RMDQ6_v1","Fem",0.298245614035088,0.665686296372905,57,164,110,54,40,17
"1286","RMDQ7_v1","Fem",0.307692307692308,0.824769269525231,39,181,122,59,27,12
"1287","RMDQ8_v1","Fem",0.375,0.747335802149721,8,212,144,68,5,3
"1288","RMDQ9_v1","Fem",0.323529411764706,0.991318878305776,34,186,126,60,23,11
"1289","RMDQ10_v1","Fem",0.325,0.972885024164127,40,180,122,58,27,13
"1290","RMDQ11_v1","Fem",0.333333333333333,0.870165460476907,42,178,121,57,28,14
"1291","RMDQ12_v1","Fem",0.318181818181818,0.942519185502165,44,176,119,57,30,14
"1292","RMDQ13_v1","Fem",0.304347826086957,0.764320864519931,46,174,117,57,32,14
"1293","RMDQ14_v1","Fem",0.346938775510204,0.680939537637105,49,171,117,54,32,17
"1294","RMDQ15_v1","Fem",0.258064516129032,0.406065670574831,31,189,126,63,23,8
"1295","RMDQ16_v1","Fem",0.324324324324324,0.981823574961799,37,183,124,59,25,12
"1296","RMDQ17_v1","Fem",0.244897959183673,0.186245757731077,49,171,112,59,37,12
"1297","RMDQ18_v1","Fem",0.333333333333333,0.881682998146209,36,184,125,59,24,12
"1298","RMDQ19_v1","Fem",0.3125,0.89350918762575,32,188,127,61,22,10
"1299","RMDQ20_v1","Fem",0.289473684210526,0.629759193064311,38,182,122,60,27,11
"1300","RMDQ21_v1","Fem",0.333333333333333,0.858915264924219,48,172,117,55,32,16
"1301","RMDQ22_v1","Fem",0.289473684210526,0.629759193064311,38,182,122,60,27,11
"1302","RMDQ23_v1","Fem",0.297297297297297,0.716775702121014,37,183,123,60,26,11
"1303","RMDQ24_v1","Fem",0.314285714285714,0.907265516814864,35,185,125,60,24,11
"1304","DN4 - Queimação","Fem",0.356435643564356,0.561561699150641,101,119,81,38,65,36
"1305","DN4 - Sensação de frio dolorosa","Fem",0.333333333333333,0.939250945897119,48,171,115,56,32,16
"1306","DN4 - Choque elétrico","Fem",0.245901639344262,0.0944489894177433,61,162,103,59,46,15
"1307","DN4 - Formigamento","Fem",0.298245614035088,0.532443320790802,57,166,109,57,40,17
"1308","DN4 - Alfinetada e agulhada","Fem",0.307692307692308,0.623310672677408,65,158,104,54,45,20
"1309","DN4 - Adormecimento","Fem",0.338709677419355,0.96320145437287,62,158,105,53,41,21
"1310","DN4 - Coceira","Fem",0.181818181818182,0.278478014292514,11,212,140,72,9,2
"1311","DH4 - Hipoestesia ao toque","Fem",0.25,0.616619212122889,8,215,143,72,6,2
"1312","DN4 - Hipoestesia a picada de agulha","Fem",0.222222222222222,0.475898128680994,9,214,142,72,7,2
"1313","DN4 - Escovação","Fem",0.285714285714286,0.792296379331768,7,216,144,72,5,2
"1314","Fuma","Casado/Amasiaado",0.260869565217391,0.00627369482938942,46,147,75,72,34,12
"1315","Cirurgia na coluna","Casado/Amasiaado",0.402777777777778,0.201538629625116,72,106,53,53,43,29
"1316","Aposentado","Casado/Amasiaado",0.441176470588235,0.955155069707267,34,156,88,68,19,15
"1317","Desempregado","Casado/Amasiaado",0.346153846153846,0.294315746278617,26,160,87,73,17,9
"1318","Licenca_Medica","Casado/Amasiaado",0.263157894736842,0.119502335929167,19,169,93,76,14,5
"1319","Aposentado_Invalidez","Casado/Amasiaado",0.375,0.678630137763169,8,178,98,80,5,3
"1320","Analgésicos","Casado/Amasiaado",0.459016393442623,0.328183557524011,122,65,40,25,66,56
"1321","OutraDoenca","Casado/Amasiaado",0.405797101449275,0.417482424373421,69,120,64,56,41,28
"1322","Dor nas costas","Casado/Amasiaado",0.467889908256881,0.479682498903562,109,77,45,32,58,51
"1323","Dor nas pernas","Casado/Amasiaado",0.419354838709677,0.569511411530924,62,123,66,57,36,26
"1324","Retornar_trabalho","Casado/Amasiaado",0.333333333333333,0.362687858881282,21,146,82,64,14,7
"1325","Masc","Casado/Amasiaado",0.373134328358209,0.0541044497258265,134,68,33,35,84,50
"1326","Fem","Casado/Amasiaado",0.514705882352941,0.0541044497258265,68,134,84,50,33,35
"1327","Casado/Amasiaado","Casado/Amasiaado",1,7.64535599642336e-46,85,117,117,0,0,85
"1328","Solteiro","Casado/Amasiaado",0,1.87135563690313e-26,88,114,29,85,88,0
"1329","Separado_Divorciado","Casado/Amasiaado",0,0.013893430078747,8,194,109,85,8,0
"1330","X4","Casado/Amasiaado",0,0.136910526981618,3,199,114,85,3,0
"1331","X5","Casado/Amasiaado",0,0.034045603038968,6,196,111,85,6,0
"1332","X6","Casado/Amasiaado",0,0.00233121422126153,12,190,105,85,12,0
"1333","Livrar_costas","Casado/Amasiaado",0.422680412371134,0.512731165344762,97,15,10,5,56,41
"1334","Livrar_perna","Casado/Amasiaado",0.357142857142857,0.66314699553797,14,98,57,41,9,5
"1335","Livrar_perda_sens","Casado/Amasiaado",0,0.401694231299615,1,111,65,46,1,0
"1336","D1","Casado/Amasiaado",1,0.2232064450424,1,135,81,54,0,1
"1337","D15","Casado/Amasiaado",0.428571428571429,0.893615907253868,7,129,77,52,4,3
"1338","D16","Casado/Amasiaado",0.5,0.345610640795716,20,116,71,45,10,10
"1339","D17","Casado/Amasiaado",0.4,0.983659855025523,5,131,78,53,3,2
"1340","D18","Casado/Amasiaado",0.375,0.798571222618273,16,120,71,49,10,6
"1341","D19","Casado/Amasiaado",0.428571428571429,0.893615907253868,7,129,77,52,4,3
"1342","D2","Casado/Amasiaado",0.125,0.0969443534176441,8,128,74,54,7,1
"1343","D20","Casado/Amasiaado",0.5,0.570140971181601,8,128,77,51,4,4
"1344","D21","Casado/Amasiaado",0.714285714285714,0.0863020701366355,7,129,79,50,2,5
"1345","D22","Casado/Amasiaado",1,0.0838103603534032,2,134,81,53,0,2
"1346","D23","Casado/Amasiaado",0,0.240392003376903,2,134,79,55,2,0
"1347","D24","Casado/Amasiaado",0.423076923076923,0.829277200319907,26,110,66,44,15,11
"1348","D25","Casado/Amasiaado",0.25,0.523007578389965,4,132,78,54,3,1
"1349","D26","Casado/Amasiaado",1,0.0838103603534032,2,134,81,53,0,2
"1350","D27","Casado/Amasiaado",0,0.0604627999322679,5,131,76,55,5,0
"1351","D28","Casado/Amasiaado",0.333333333333333,0.716717460270094,6,130,77,53,4,2
"1352","D29","Casado/Amasiaado",0.523809523809524,0.0579005623592612,42,94,61,33,20,22
"1353","D3","Casado/Amasiaado",0,0.240392003376903,2,134,79,55,2,0
"1354","Lombalgia","Casado/Amasiaado",0.467741935483871,0.16837384044546,62,74,48,26,33,29
"1355","D31","Casado/Amasiaado",0.294117647058824,0.321892619823972,17,119,69,50,12,5
"1356","D32","Casado/Amasiaado",0.486486486486487,0.233152621693,37,99,62,37,19,18
"1357","D33","Casado/Amasiaado",0.333333333333333,0.599295017189989,12,124,73,51,8,4
"1358","D34","Casado/Amasiaado",0.333333333333333,0.799755909415403,3,133,79,54,2,1
"1359","D35","Casado/Amasiaado",0,0.240392003376903,2,134,79,55,2,0
"1360","D36","Casado/Amasiaado",0.5,0.570140971181601,8,128,77,51,4,4
"1361","D37","Casado/Amasiaado",0.5,0.318371483495956,22,114,70,44,11,11
"1362","D38","Casado/Amasiaado",0,0.148948627194368,3,133,78,55,3,0
"1363","D39","Casado/Amasiaado",0.533333333333333,0.280763181731797,15,121,74,47,7,8
"1364","D4","Casado/Amasiaado",0,0.0943611379889567,4,132,77,55,4,0
"1365","D40","Casado/Amasiaado",0.2,0.342650021269306,5,131,77,54,4,1
"1366","D41","Casado/Amasiaado",0.428571428571429,0.893615907253868,7,129,77,52,4,3
"1367","D42","Casado/Amasiaado",0.666666666666667,0.349309716311897,3,133,80,53,1,2
"1368","D43","Casado/Amasiaado",1,0.0335431532333285,3,133,81,52,0,3
"1369","D44","Casado/Amasiaado",0.5,0.157248824101103,38,98,62,36,19,19
"1370","D45","Casado/Amasiaado",0.166666666666667,0.0788460431367428,12,124,71,53,10,2
"1371","D46","Casado/Amasiaado",0.5,0.157248824101103,38,98,62,36,19,19
"1372","D47","Casado/Amasiaado",0.166666666666667,0.0788460431367428,12,124,71,53,10,2
"1373","D48","Casado/Amasiaado",0.461538461538462,0.509283068985424,26,110,67,43,14,12
"1374","D49","Casado/Amasiaado",0.384615384615385,0.878454387341184,13,123,73,50,8,5
"1375","D5","Casado/Amasiaado",0,0.148948627194368,3,133,78,55,3,0
"1376","D50","Casado/Amasiaado",0.5,0.781401816104309,2,134,80,54,1,1
"1377","D51","Casado/Amasiaado",0,0.408198318237489,1,135,80,55,1,0
"1378","D52","Casado/Amasiaado",0.5,0.781401816104309,2,134,80,54,1,1
"1379","D53","Casado/Amasiaado",1,0.0838103603534032,2,134,81,53,0,2
"1380","D9","Casado/Amasiaado",0,0.408198318237489,1,135,80,55,1,0
"1381","RMDQ1_v1","Casado/Amasiaado",0.542857142857143,0.0817742839999999,70,111,68,43,32,38
"1382","RMDQ2_v1","Casado/Amasiaado",0.546666666666667,0.0522302309605921,75,106,66,40,34,41
"1383","RMDQ3_v1","Casado/Amasiaado",0.515151515151515,0.137910233949832,66,117,70,47,32,34
"1384","RMDQ4_v1","Casado/Amasiaado",0.531914893617021,0.15282122386249,47,136,80,56,22,25
"1385","RMDQ5_v1","Casado/Amasiaado",0.491803278688525,0.343571574727339,61,122,71,51,31,30
"1386","RMDQ6_v1","Casado/Amasiaado",0.458333333333333,0.798616793856344,48,135,76,59,26,22
"1387","RMDQ7_v1","Casado/Amasiaado",0.484848484848485,0.611193575320539,33,149,84,65,17,16
"1388","RMDQ8_v1","Casado/Amasiaado",0.375,0.683444070485744,8,174,96,78,5,3
"1389","RMDQ9_v1","Casado/Amasiaado",0.517241379310345,0.393589890666139,29,153,87,66,14,15
"1390","RMDQ10_v1","Casado/Amasiaado",0.5,0.474675107950862,34,148,84,64,17,17
"1391","RMDQ11_v1","Casado/Amasiaado",0.5,0.458911585926666,36,146,83,63,18,18
"1392","RMDQ12_v1","Casado/Amasiaado",0.472222222222222,0.714211764183465,36,146,82,64,19,17
"1393","RMDQ13_v1","Casado/Amasiaado",0.526315789473684,0.257142102373194,38,144,83,61,18,20
"1394","RMDQ14_v1","Casado/Amasiaado",0.55,0.130533953574004,40,142,83,59,18,22
"1395","RMDQ15_v1","Casado/Amasiaado",0.541666666666667,0.306714197946849,24,158,90,68,11,13
"1396","RMDQ16_v1","Casado/Amasiaado",0.516129032258065,0.382012910761673,31,151,86,65,15,16
"1397","RMDQ17_v1","Casado/Amasiaado",0.461538461538462,0.815234880579339,39,143,80,63,21,18
"1398","RMDQ18_v1","Casado/Amasiaado",0.516129032258065,0.382012910761673,31,151,86,65,15,16
"1399","RMDQ19_v1","Casado/Amasiaado",0.518518518518518,0.405226573198601,27,155,88,67,13,14
"1400","RMDQ20_v1","Casado/Amasiaado",0.5,0.490880536568513,32,150,85,65,16,16
"1401","RMDQ21_v1","Casado/Amasiaado",0.5,0.428580619761824,40,142,81,61,20,20
"1402","RMDQ22_v1","Casado/Amasiaado",0.484848484848485,0.611193575320539,33,149,84,65,17,16
"1403","RMDQ23_v1","Casado/Amasiaado",0.483870967741935,0.633057844463271,31,151,85,66,16,15
"1404","RMDQ24_v1","Casado/Amasiaado",0.5,0.507567320217459,30,152,86,66,15,15
"1405","DN4 - Queimação","Casado/Amasiaado",0.469135802469136,0.519914753168118,81,102,59,43,43,38
"1406","DN4 - Sensação de frio dolorosa","Casado/Amasiaado",0.675,0.000500219567324592,40,142,90,52,13,27
"1407","DN4 - Choque elétrico","Casado/Amasiaado",0.403846153846154,0.56009353206846,52,133,73,60,31,21
"1408","DN4 - Formigamento","Casado/Amasiaado",0.446808510638298,0.885874195697831,47,138,78,60,26,21
"1409","DN4 - Alfinetada e agulhada","Casado/Amasiaado",0.327272727272727,0.0486514610908088,55,130,67,63,37,18
"1410","DN4 - Adormecimento","Casado/Amasiaado",0.407407407407407,0.534901691067144,54,129,70,59,32,22
"1411","DN4 - Coceira","Casado/Amasiaado",0.285714285714286,0.408206429617873,7,178,99,79,5,2
"1412","DH4 - Hipoestesia ao toque","Casado/Amasiaado",0.5,0.755030127145604,6,179,101,78,3,3
"1413","DN4 - Hipoestesia a picada de agulha","Casado/Amasiaado",0.285714285714286,0.408206429617873,7,178,99,79,5,2
"1414","DN4 - Escovação","Casado/Amasiaado",0.4,0.862736765472299,5,180,101,79,3,2
"1415","Fuma","Solteiro",0.521739130434783,0.150085476777339,46,147,88,59,22,24
"1416","Cirurgia na coluna","Solteiro",0.430555555555556,0.647656045392028,72,106,64,42,41,31
"1417","Aposentado","Solteiro",0.264705882352941,0.0354740198927289,34,156,84,72,25,9
"1418","Desempregado","Solteiro",0.538461538461538,0.205895827839192,26,160,95,65,12,14
"1419","Licenca_Medica","Solteiro",0.631578947368421,0.0623834293303646,19,169,100,69,7,12
"1420","Aposentado_Invalidez","Solteiro",0.5,0.613590313131274,8,178,105,73,4,4
"1421","Analgésicos","Solteiro",0.39344262295082,0.193170181416443,122,65,33,32,74,48
"1422","OutraDoenca","Solteiro",0.434782608695652,0.808246910411594,69,120,70,50,39,30
"1423","Dor nas costas","Solteiro",0.394495412844037,0.520967895173565,109,77,43,34,66,43
"1424","Dor nas pernas","Solteiro",0.435483870967742,0.628181375399607,62,123,74,49,35,27
"1425","Retornar_trabalho","Solteiro",0.380952380952381,0.619430775692473,21,146,82,64,13,8
"1426","Masc","Solteiro",0.455223880597015,0.430776599778904,134,68,41,27,73,61
"1427","Fem","Solteiro",0.397058823529412,0.430776599778904,68,134,73,61,41,27
"1428","Casado/Amasiaado","Solteiro",0,1.87135563690313e-26,85,117,29,88,85,0
"1429","Solteiro","Solteiro",1,7.64535599642325e-46,88,114,114,0,0,88
"1430","Separado_Divorciado","Solteiro",0,0.0112202523029394,8,194,106,88,8,0
"1431","X4","Solteiro",0,0.125226694102293,3,199,111,88,3,0
"1432","X5","Solteiro",0,0.0289033304687579,6,196,108,88,6,0
"1433","X6","Solteiro",0,0.00169998067403695,12,190,102,88,12,0
"1434","Livrar_costas","Solteiro",0.45360824742268,0.697513490566162,97,15,9,6,53,44
"1435","Livrar_perna","Solteiro",0.428571428571429,0.885749815429911,14,98,54,44,8,6
"1436","Livrar_perda_sens","Solteiro",0,0.3670236122959,1,111,61,50,1,0
"1437","D1","Solteiro",0,0.379626958504178,1,135,76,59,1,0
"1438","D15","Solteiro",0.428571428571429,0.977032998995578,7,129,73,56,4,3
"1439","D16","Solteiro",0.3,0.19102887503998,20,116,63,53,14,6
"1440","D17","Solteiro",0.4,0.876434244326827,5,131,74,57,3,2
"1441","D18","Solteiro",0.5,0.569624862579721,16,120,69,51,8,8
"1442","D19","Solteiro",0.428571428571429,0.977032998995578,7,129,73,56,4,3
"1443","D2","Solteiro",0.5,0.697056755680715,8,128,73,55,4,4
"1444","D20","Solteiro",0.5,0.697056755680715,8,128,73,55,4,4
"1445","D21","Solteiro",0.285714285714286,0.416880359309015,7,129,72,57,5,2
"1446","D22","Solteiro",0,0.212348813642373,2,134,75,59,2,0
"1447","D23","Solteiro",1,0.103606764411036,2,134,77,57,0,2
"1448","D24","Solteiro",0.5,0.449013262929709,26,110,64,46,13,13
"1449","D25","Solteiro",0.75,0.195279287722334,4,132,76,56,1,3
"1450","D26","Solteiro",0,0.212348813642373,2,134,75,59,2,0
"1451","D27","Solteiro",1,0.00924701326139621,5,131,77,54,0,5
"1452","D28","Solteiro",0.666666666666667,0.239165302464729,6,130,75,55,2,4
"1453","D29","Solteiro",0.30952380952381,0.0505718596724715,42,94,48,46,29,13
"1454","D3","Solteiro",0.5,0.849120602315612,2,134,76,58,1,1
"1455","Lombalgia","Solteiro",0.387096774193548,0.314209850376933,62,74,39,35,38,24
"1456","D31","Solteiro",0.588235294117647,0.169656213236931,17,119,70,49,7,10
"1457","D32","Solteiro",0.351351351351351,0.235468053998213,37,99,53,46,24,13
"1458","D33","Solteiro",0.583333333333333,0.273768136718333,12,124,72,52,5,7
"1459","D34","Solteiro",0.666666666666667,0.410577598948078,3,133,76,57,1,2
"1460","D35","Solteiro",1,0.103606764411036,2,134,77,57,0,2
"1461","D36","Solteiro",0.375,0.729311589180158,8,128,72,56,5,3
"1462","D37","Solteiro",0.318181818181818,0.231933830894422,22,114,62,52,15,7
"1463","D38","Solteiro",0.666666666666667,0.410577598948078,3,133,76,57,1,2
"1464","D39","Solteiro",0.2,0.0527188892105124,15,121,65,56,12,3
"1465","D4","Solteiro",0.75,0.195279287722334,4,132,76,56,1,3
"1466","D40","Solteiro",0.6,0.444906532860642,5,131,75,56,2,3
"1467","D41","Solteiro",0.428571428571429,0.977032998995578,7,129,73,56,4,3
"1468","D42","Solteiro",0.333333333333333,0.722487220523156,3,133,75,58,2,1
"1469","D43","Solteiro",0,0.125238677070296,3,133,74,59,3,0
"1470","D44","Solteiro",0.315789473684211,0.0837178531898346,38,98,51,47,26,12
"1471","D45","Solteiro",0.75,0.0206434834553231,12,124,74,50,3,9
"1472","D46","Solteiro",0.289473684210526,0.0344209389193105,38,98,50,48,27,11
"1473","D47","Solteiro",0.666666666666667,0.0883000160710157,12,124,73,51,4,8
"1474","D48","Solteiro",0.307692307692308,0.149035824612735,26,110,59,51,18,8
"1475","D49","Solteiro",0.461538461538462,0.83209405778434,13,123,70,53,7,6
"1476","D5","Solteiro",0.666666666666667,0.410577598948078,3,133,76,57,1,2
"1477","D50","Solteiro",0.5,0.849120602315612,2,134,76,58,1,1
"1478","D51","Solteiro",1,0.25153607167746,1,135,77,58,0,1
"1479","D52","Solteiro",0.5,0.849120602315612,2,134,76,58,1,1
"1480","D53","Solteiro",0,0.212348813642373,2,134,75,59,2,0
"1481","D9","Solteiro",1,0.25153607167746,1,135,77,58,0,1
"1482","RMDQ1_v1","Solteiro",0.342857142857143,0.175015497837418,70,111,61,50,46,24
"1483","RMDQ2_v1","Solteiro",0.346666666666667,0.175707311905322,75,106,58,48,49,26
"1484","RMDQ3_v1","Solteiro",0.348484848484849,0.204988685641538,66,117,65,52,43,23
"1485","RMDQ4_v1","Solteiro",0.340425531914894,0.261701932372275,47,136,77,59,31,16
"1486","RMDQ5_v1","Solteiro",0.344262295081967,0.202164715977912,61,122,68,54,40,21
"1487","RMDQ6_v1","Solteiro",0.333333333333333,0.209561553877755,48,135,76,59,32,16
"1488","RMDQ7_v1","Solteiro",0.363636363636364,0.531993687594629,33,149,86,63,21,12
"1489","RMDQ8_v1","Solteiro",0.5,0.605394615032179,8,174,103,71,4,4
"1490","RMDQ9_v1","Solteiro",0.344827586206897,0.422208472117945,29,153,88,65,19,10
"1491","RMDQ10_v1","Solteiro",0.382352941176471,0.69607401441796,34,148,86,62,21,13
"1492","RMDQ11_v1","Solteiro",0.361111111111111,0.487809980792072,36,146,84,62,23,13
"1493","RMDQ12_v1","Solteiro",0.388888888888889,0.752200150782838,36,146,85,61,22,14
"1494","RMDQ13_v1","Solteiro",0.342105263157895,0.32445778459333,38,144,82,62,25,13
"1495","RMDQ14_v1","Solteiro",0.35,0.366426918354605,40,142,81,61,26,14
"1496","RMDQ15_v1","Solteiro",0.333333333333333,0.400194469405897,24,158,91,67,16,8
"1497","RMDQ16_v1","Solteiro",0.32258064516129,0.266324823643383,31,151,86,65,21,10
"1498","RMDQ17_v1","Solteiro",0.384615384615385,0.694149066116179,39,143,83,60,24,15
"1499","RMDQ18_v1","Solteiro",0.387096774193548,0.756288717982329,31,151,88,63,19,12
"1500","RMDQ19_v1","Solteiro",0.37037037037037,0.633204949012387,27,155,90,65,17,10
"1501","RMDQ20_v1","Solteiro",0.34375,0.386973721497225,32,150,86,64,21,11
"1502","RMDQ21_v1","Solteiro",0.375,0.589532195826978,40,142,82,60,25,15
"1503","RMDQ22_v1","Solteiro",0.363636363636364,0.531993687594629,33,149,86,63,21,12
"1504","RMDQ23_v1","Solteiro",0.387096774193548,0.756288717982329,31,151,88,63,19,12
"1505","RMDQ24_v1","Solteiro",0.366666666666667,0.580213445585084,30,152,88,64,19,11
"1506","DN4 - Queimação","Solteiro",0.37037037037037,0.271700955566304,81,102,56,46,51,30
"1507","DN4 - Sensação de frio dolorosa","Solteiro",0.25,0.00977487616366015,40,142,74,68,30,10
"1508","DN4 - Choque elétrico","Solteiro",0.403846153846154,0.759500621899454,52,133,76,57,31,21
"1509","DN4 - Formigamento","Solteiro",0.340425531914894,0.191839243541406,47,138,76,62,31,16
"1510","DN4 - Alfinetada e agulhada","Solteiro",0.490909090909091,0.214488596365182,55,130,79,51,28,27
"1511","DN4 - Adormecimento","Solteiro",0.37037037037037,0.424854278463538,54,129,73,56,34,20
"1512","DN4 - Coceira","Solteiro",0.285714285714286,0.457883994181554,7,178,102,76,5,2
"1513","DH4 - Hipoestesia ao toque","Solteiro",0.5,0.692663830585402,6,179,104,75,3,3
"1514","DN4 - Hipoestesia a picada de agulha","Solteiro",0.714285714285714,0.109920104973387,7,178,105,73,2,5
"1515","DN4 - Escovação","Solteiro",0.6,0.412866609583166,5,180,105,75,2,3
"1516","Fuma","Separado_Divorciado",0.0217391304347826,0.44218557681651,46,147,140,7,45,1
"1517","Cirurgia na coluna","Separado_Divorciado",0.0416666666666667,0.861921684126111,72,106,101,5,69,3
"1518","Aposentado","Separado_Divorciado",0.0882352941176471,0.139374818308345,34,156,151,5,31,3
"1519","Desempregado","Separado_Divorciado",0.0384615384615385,0.980936923098029,26,160,154,6,25,1
"1520","Licenca_Medica","Separado_Divorciado",0.0526315789473684,0.818440342361416,19,169,162,7,18,1
"1521","Aposentado_Invalidez","Separado_Divorciado",0,0.539908087525517,8,178,170,8,8,0
"1522","Analgésicos","Separado_Divorciado",0.0491803278688525,0.553536642041824,122,65,63,2,116,6
"1523","OutraDoenca","Separado_Divorciado",0.072463768115942,0.0505160267416713,69,120,118,2,64,5
"1524","Dor nas costas","Separado_Divorciado",0.055045871559633,0.335762946847116,109,77,75,2,103,6
"1525","Dor nas pernas","Separado_Divorciado",0.0483870967741935,0.807070619087169,62,123,118,5,59,3
"1526","Retornar_trabalho","Separado_Divorciado",0.0952380952380952,0.192205773791894,21,146,141,5,19,2
"1527","Masc","Separado_Divorciado",0.0373134328358209,0.81473433983609,134,68,65,3,129,5
"1528","Fem","Separado_Divorciado",0.0441176470588235,0.81473433983609,68,134,129,5,65,3
"1529","Casado/Amasiaado","Separado_Divorciado",0,0.013893430078747,85,117,109,8,85,0
"1530","Solteiro","Separado_Divorciado",0,0.0112202523029394,88,114,106,8,88,0
"1531","Separado_Divorciado","Separado_Divorciado",1,7.64535599642325e-46,8,194,194,0,0,8
"1532","X4","Separado_Divorciado",0,0.723063476742426,3,199,191,8,3,0
"1533","X5","Separado_Divorciado",0,0.613578416541615,6,196,188,8,6,0
"1534","X6","Separado_Divorciado",0,0.468251658961437,12,190,182,8,12,0
"1535","Livrar_costas","Separado_Divorciado",0.0412371134020619,0.657176068228176,97,15,14,1,93,4
"1536","Livrar_perna","Separado_Divorciado",0.0714285714285714,0.603896562478827,14,98,94,4,13,1
"1537","Livrar_perda_sens","Separado_Divorciado",0,0.828098929650461,1,111,106,5,1,0
"1538","D1","Separado_Divorciado",0,0.815135138754741,1,135,128,7,1,0
"1539","D15","Separado_Divorciado",0,0.526853490497434,7,129,122,7,7,0
"1540","D16","Separado_Divorciado",0.05,0.974289740376286,20,116,110,6,19,1
"1541","D17","Separado_Divorciado",0,0.595606456103754,5,131,124,7,5,0
"1542","D18","Separado_Divorciado",0,0.321218344859636,16,120,113,7,16,0
"1543","D19","Separado_Divorciado",0,0.526853490497434,7,129,122,7,7,0
"1544","D2","Separado_Divorciado",0,0.497044882450256,8,128,121,7,8,0
"1545","D20","Separado_Divorciado",0,0.497044882450256,8,128,121,7,8,0
"1546","D21","Separado_Divorciado",0,0.526853490497434,7,129,122,7,7,0
"1547","D22","Separado_Divorciado",0,0.739976909027013,2,134,127,7,2,0
"1548","D23","Separado_Divorciado",0,0.739976909027013,2,134,127,7,2,0
"1549","D24","Separado_Divorciado",0,0.186591501022522,26,110,103,7,26,0
"1550","D25","Separado_Divorciado",0,0.63628659530033,4,132,125,7,4,0
"1551","D26","Separado_Divorciado",0,0.739976909027013,2,134,127,7,2,0
"1552","D27","Separado_Divorciado",0,0.595606456103754,5,131,124,7,5,0
"1553","D28","Separado_Divorciado",0,0.55947835087211,6,130,123,7,6,0
"1554","D29","Separado_Divorciado",0.0476190476190476,0.891915120108973,42,94,89,5,40,2
"1555","D3","Separado_Divorciado",0,0.739976909027013,2,134,127,7,2,0
"1556","Lombalgia","Separado_Divorciado",0.0483870967741935,0.881580443764654,62,74,70,4,59,3
"1557","D31","Separado_Divorciado",0,0.30452718874533,17,119,112,7,17,0
"1558","D32","Separado_Divorciado",0.0540540540540541,0.933566397165882,37,99,94,5,35,2
"1559","D33","Separado_Divorciado",0,0.398060116685702,12,124,117,7,12,0
"1560","D34","Separado_Divorciado",0,0.683274873050331,3,133,126,7,3,0
"1561","D35","Separado_Divorciado",0,0.739976909027013,2,134,127,7,2,0
"1562","D36","Separado_Divorciado",0,0.497044882450256,8,128,121,7,8,0
"1563","D37","Separado_Divorciado",0.0454545454545455,0.889065179747181,22,114,108,6,21,1
"1564","D38","Separado_Divorciado",0,0.683274873050331,3,133,126,7,3,0
"1565","D39","Separado_Divorciado",0.0666666666666667,0.777644659047461,15,121,115,6,14,1
"1566","D4","Separado_Divorciado",0,0.63628659530033,4,132,125,7,4,0
"1567","D40","Separado_Divorciado",0,0.595606456103754,5,131,124,7,5,0
"1568","D41","Separado_Divorciado",0,0.526853490497434,7,129,122,7,7,0
"1569","D42","Separado_Divorciado",0,0.683274873050331,3,133,126,7,3,0
"1570","D43","Separado_Divorciado",0,0.683274873050331,3,133,126,7,3,0
"1571","D44","Separado_Divorciado",0.0526315789473684,0.969562661066158,38,98,93,5,36,2
"1572","D45","Separado_Divorciado",0,0.398060116685702,12,124,117,7,12,0
"1573","D46","Separado_Divorciado",0.0526315789473684,0.969562661066158,38,98,93,5,36,2
"1574","D47","Separado_Divorciado",0,0.398060116685702,12,124,117,7,12,0
"1575","D48","Separado_Divorciado",0.0384615384615385,0.738522327104601,26,110,104,6,25,1
"1576","D49","Separado_Divorciado",0,0.377146151318951,13,123,116,7,13,0
"1577","D5","Separado_Divorciado",0,0.683274873050331,3,133,126,7,3,0
"1578","D50","Separado_Divorciado",0,0.739976909027013,2,134,127,7,2,0
"1579","D51","Separado_Divorciado",0,0.815135138754741,1,135,128,7,1,0
"1580","D52","Separado_Divorciado",0,0.739976909027013,2,134,127,7,2,0
"1581","D53","Separado_Divorciado",0,0.739976909027013,2,134,127,7,2,0
"1582","D9","Separado_Divorciado",0,0.815135138754741,1,135,128,7,1,0
"1583","RMDQ1_v1","Separado_Divorciado",0.0285714285714286,0.83726347455151,70,111,106,5,68,2
"1584","RMDQ2_v1","Separado_Divorciado",0.0266666666666667,0.763573484588478,75,106,101,5,73,2
"1585","RMDQ3_v1","Separado_Divorciado",0.0303030303030303,0.505080297248401,66,117,111,6,64,2
"1586","RMDQ4_v1","Separado_Divorciado",0.0425531914893617,0.963930908304965,47,136,130,6,45,2
"1587","RMDQ5_v1","Separado_Divorciado",0.0327868852459016,0.609140401551206,61,122,116,6,59,2
"1588","RMDQ6_v1","Separado_Divorciado",0.0416666666666667,0.935566202781219,48,135,129,6,46,2
"1589","RMDQ7_v1","Separado_Divorciado",0,0.20416192016128,33,149,142,7,33,0
"1590","RMDQ8_v1","Separado_Divorciado",0,0.562897201280188,8,174,167,7,8,0
"1591","RMDQ9_v1","Separado_Divorciado",0,0.24012341477796,29,153,146,7,29,0
"1592","RMDQ10_v1","Separado_Divorciado",0,0.195933046727639,34,148,141,7,34,0
"1593","RMDQ11_v1","Separado_Divorciado",0,0.180309835229217,36,146,139,7,36,0
"1594","RMDQ12_v1","Separado_Divorciado",0,0.180309835229217,36,146,139,7,36,0
"1595","RMDQ13_v1","Separado_Divorciado",0.0263157894736842,0.66160570966093,38,144,138,6,37,1
"1596","RMDQ14_v1","Separado_Divorciado",0,0.152135804935708,40,142,135,7,40,0
"1597","RMDQ15_v1","Separado_Divorciado",0,0.292991788296941,24,158,151,7,24,0
"1598","RMDQ16_v1","Separado_Divorciado",0.032258064516129,0.843685433592571,31,151,145,6,30,1
"1599","RMDQ17_v1","Separado_Divorciado",0.0512820512820513,0.638578518137544,39,143,138,5,37,2
"1600","RMDQ18_v1","Separado_Divorciado",0,0.221508821782249,31,151,144,7,31,0
"1601","RMDQ19_v1","Separado_Divorciado",0,0.260117965806364,27,155,148,7,27,0
"1602","RMDQ20_v1","Separado_Divorciado",0,0.212683288254652,32,150,143,7,32,0
"1603","RMDQ21_v1","Separado_Divorciado",0.025,0.616223475186609,40,142,136,6,39,1
"1604","RMDQ22_v1","Separado_Divorciado",0.0303030303030303,0.787661959672211,33,149,143,6,32,1
"1605","RMDQ23_v1","Separado_Divorciado",0,0.221508821782249,31,151,144,7,31,0
"1606","RMDQ24_v1","Separado_Divorciado",0,0.230651040788941,30,152,145,7,30,0
"1607","DN4 - Queimação","Separado_Divorciado",0.0493827160493827,0.484165329554493,81,102,99,3,77,4
"1608","DN4 - Sensação de frio dolorosa","Separado_Divorciado",0.05,0.667480523178376,40,142,137,5,38,2
"1609","DN4 - Choque elétrico","Separado_Divorciado",0.0384615384615385,0.977821369580842,52,133,128,5,50,2
"1610","DN4 - Formigamento","Separado_Divorciado",0.0425531914893617,0.84448077252083,47,138,133,5,45,2
"1611","DN4 - Alfinetada e agulhada","Separado_Divorciado",0.0181818181818182,0.3620904084458,55,130,124,6,54,1
"1612","DN4 - Adormecimento","Separado_Divorciado",0.0740740740740741,0.102116961386795,54,129,126,3,50,4
"1613","DN4 - Coceira","Separado_Divorciado",0,0.592726414847795,7,178,171,7,7,0
"1614","DH4 - Hipoestesia ao toque","Separado_Divorciado",0,0.621429036548809,6,179,172,7,6,0
"1615","DN4 - Hipoestesia a picada de agulha","Separado_Divorciado",0,0.592726414847795,7,178,171,7,7,0
"1616","DN4 - Escovação","Separado_Divorciado",0,0.653038209525315,5,180,173,7,5,0
"1617","Fuma","X4",0.0652173913043478,0.00180464827369461,46,147,147,0,43,3
"1618","Cirurgia na coluna","X4",0,0.408527180838061,72,106,105,1,72,0
"1619","Aposentado","X4",0,0.415033450743752,34,156,153,3,34,0
"1620","Desempregado","X4",0,0.481487710817077,26,160,157,3,26,0
"1621","Licenca_Medica","X4",0,0.558247600677103,19,169,166,3,19,0
"1622","Aposentado_Invalidez","X4",0,0.711239743217805,8,178,175,3,8,0
"1623","Analgésicos","X4",0.0163934426229508,0.958298962814995,122,65,64,1,120,2
"1624","OutraDoenca","X4",0.0144927536231884,0.908345730160861,69,120,118,2,68,1
"1625","Dor nas costas","X4",0.018348623853211,0.774949647916623,109,77,76,1,107,2
"1626","Dor nas pernas","X4",0.0161290322580645,0.994681636859168,62,123,121,2,61,1
"1627","Retornar_trabalho","X4",0,0.507412062901068,21,146,143,3,21,0
"1628","Masc","X4",0.0149253731343284,0.990276089123858,134,68,67,1,132,2
"1629","Fem","X4",0.0147058823529412,0.990276089123858,68,134,132,2,67,1
"1630","Casado/Amasiaado","X4",0,0.136910526981618,85,117,114,3,85,0
"1631","Solteiro","X4",0,0.125226694102293,88,114,111,3,88,0
"1632","Separado_Divorciado","X4",0,0.723063476742426,8,194,191,3,8,0
"1633","X4","X4",1,7.64535599642314e-46,3,199,199,0,0,3
"1634","X5","X4",0,0.760121315418735,6,196,193,3,6,0
"1635","X6","X4",0,0.660984353778988,12,190,187,3,12,0
"1636","Livrar_costas","X4",0.0103092783505155,0.125069048097251,97,15,14,1,96,1
"1637","Livrar_perna","X4",0.0714285714285714,0.105645429201878,14,98,97,1,13,1
"1638","Livrar_perda_sens","X4",0,0.892259258121653,1,111,109,2,1,0
"1639","D1","X4",0,0.880178390709511,1,135,132,3,1,0
"1640","D15","X4",0.142857142857143,0.0254648673683159,7,129,127,2,6,1
"1641","D16","X4",0,0.467066119740186,20,116,113,3,20,0
"1642","D17","X4",0.2,0.0057757922013957,5,131,129,2,4,1
"1643","D18","X4",0.0625,0.240993975067262,16,120,118,2,15,1
"1644","D19","X4",0.142857142857143,0.0254648673683159,7,129,127,2,6,1
"1645","D2","X4",0.25,6.04963738671134e-06,8,128,127,1,6,2
"1646","D20","X4",0,0.66148119738657,8,128,125,3,8,0
"1647","D21","X4",0,0.683274873050331,7,129,126,3,7,0
"1648","D22","X4",0,0.830565083280277,2,134,131,3,2,0
"1649","D23","X4",0,0.830565083280277,2,134,131,3,2,0
"1650","D24","X4",0,0.394480841695529,26,110,107,3,26,0
"1651","D25","X4",0,0.760447734150187,4,132,129,3,4,0
"1652","D26","X4",0,0.830565083280277,2,134,131,3,2,0
"1653","D27","X4",0,0.732216032264721,5,131,128,3,5,0
"1654","D28","X4",0,0.706710630318467,6,130,127,3,6,0
"1655","D29","X4",0,0.241698399730683,42,94,91,3,42,0
"1656","D3","X4",0.5,3.54931258649229e-06,2,134,132,2,1,1
"1657","Lombalgia","X4",0,0.108893323090039,62,74,71,3,62,0
"1658","D31","X4",0.0588235294117647,0.269885467194664,17,119,117,2,16,1
"1659","D32","X4",0,0.284282472208915,37,99,96,3,37,0
"1660","D33","X4",0.0833333333333333,0.130153483589304,12,124,122,2,11,1
"1661","D34","X4",0,0.792511685634946,3,133,130,3,3,0
"1662","D35","X4",0,0.830565083280277,2,134,131,3,2,0
"1663","D36","X4",0.125,0.0410139457284451,8,128,126,2,7,1
"1664","D37","X4",0,0.441644329784114,22,114,111,3,22,0
"1665","D38","X4",0.333333333333333,0.000205681391078371,3,133,131,2,2,1
"1666","D39","X4",0,0.537448305795192,15,121,118,3,15,0
"1667","D4","X4",0.25,0.00162957881054941,4,132,130,2,3,1
"1668","D40","X4",0.2,0.0057757922013957,5,131,129,2,4,1
"1669","D41","X4",0,0.683274873050331,7,129,126,3,7,0
"1670","D42","X4",0,0.792511685634946,3,133,130,3,3,0
"1671","D43","X4",0,0.792511685634946,3,133,130,3,3,0
"1672","D44","X4",0,0.275429552882231,38,98,95,3,38,0
"1673","D45","X4",0,0.585850572100077,12,124,121,3,12,0
"1674","D46","X4",0,0.275429552882231,38,98,95,3,38,0
"1675","D47","X4",0.0833333333333333,0.130153483589304,12,124,122,2,11,1
"1676","D48","X4",0,0.394480841695529,26,110,107,3,26,0
"1677","D49","X4",0.0769230769230769,0.156711306704719,13,123,121,2,12,1
"1678","D5","X4",0,0.792511685634946,3,133,130,3,3,0
"1679","D50","X4",0,0.830565083280277,2,134,131,3,2,0
"1680","D51","X4",0,0.880178390709511,1,135,132,3,1,0
"1681","D52","X4",0,0.830565083280277,2,134,131,3,2,0
"1682","D53","X4",0,0.830565083280277,2,134,131,3,2,0
"1683","D9","X4",0,0.880178390709511,1,135,132,3,1,0
"1684","RMDQ1_v1","X4",0,0.376988805505011,70,111,108,3,70,0
"1685","RMDQ2_v1","X4",0,0.335043011304556,75,106,103,3,75,0
"1686","RMDQ3_v1","X4",0,0.189627047089212,66,117,114,3,66,0
"1687","RMDQ4_v1","X4",0,0.304577525311025,47,136,133,3,47,0
"1688","RMDQ5_v1","X4",0,0.21686440944597,61,122,119,3,61,0
"1689","RMDQ6_v1","X4",0,0.297705426781462,48,135,132,3,48,0
"1690","RMDQ7_v1","X4",0,0.411118020233273,33,149,146,3,33,0
"1691","RMDQ8_v1","X4",0,0.708039827186728,8,174,171,3,8,0
"1692","RMDQ9_v1","X4",0,0.447035421800336,29,153,150,3,29,0
"1693","RMDQ10_v1","X4",0,0.402535206901696,34,148,145,3,34,0
"1694","RMDQ11_v1","X4",0,0.385804696018125,36,146,143,3,36,0
"1695","RMDQ12_v1","X4",0,0.385804696018125,36,146,143,3,36,0
"1696","RMDQ13_v1","X4",0,0.369622021989821,38,144,141,3,38,0
"1697","RMDQ14_v1","X4",0,0.353953248138362,40,142,139,3,40,0
"1698","RMDQ15_v1","X4",0,0.496070132399276,24,158,155,3,24,0
"1699","RMDQ16_v1","X4",0,0.428746611205637,31,151,148,3,31,0
"1700","RMDQ17_v1","X4",0,0.361725325701722,39,143,140,3,39,0
"1701","RMDQ18_v1","X4",0,0.428746611205637,31,151,148,3,31,0
"1702","RMDQ19_v1","X4",0,0.466044467910479,27,155,152,3,27,0
"1703","RMDQ20_v1","X4",0,0.419853143376068,32,150,147,3,32,0
"1704","RMDQ21_v1","X4",0,0.353953248138362,40,142,139,3,40,0
"1705","RMDQ22_v1","X4",0,0.411118020233273,33,149,146,3,33,0
"1706","RMDQ23_v1","X4",0,0.428746611205637,31,151,148,3,31,0
"1707","RMDQ24_v1","X4",0,0.437804986559031,30,152,149,3,30,0
"1708","DN4 - Queimação","X4",0.0246913580246914,0.430840014068599,81,102,101,1,79,2
"1709","DN4 - Sensação de frio dolorosa","X4",0,0.353953248138362,40,142,139,3,40,0
"1710","DN4 - Choque elétrico","X4",0.0384615384615385,0.134165504642534,52,133,132,1,50,2
"1711","DN4 - Formigamento","X4",0.0425531914893617,0.0978946970900838,47,138,137,1,45,2
"1712","DN4 - Alfinetada e agulhada","X4",0.0545454545454545,0.00725877307748413,55,130,130,0,52,3
"1713","DN4 - Adormecimento","X4",0.037037037037037,0.154772063632672,54,129,128,1,52,2
"1714","DN4 - Coceira","X4",0.142857142857143,0.00684234475716709,7,178,176,2,6,1
"1715","DH4 - Hipoestesia ao toque","X4",0,0.749186120839485,6,179,176,3,6,0
"1716","DN4 - Hipoestesia a picada de agulha","X4",0,0.729118871529751,7,178,175,3,7,0
"1717","DN4 - Escovação","X4",0,0.771017208658739,5,180,177,3,5,0
"1718","Fuma","X5",0.0217391304347826,0.955899710529858,46,147,144,3,45,1
"1719","Cirurgia na coluna","X5",0.0277777777777778,0.693849595610497,72,106,104,2,70,2
"1720","Aposentado","X5",0,0.345330162238084,34,156,152,4,34,0
"1721","Desempregado","X5",0.0384615384615385,0.520467118506384,26,160,157,3,25,1
"1722","Licenca_Medica","X5",0,0.497866946944463,19,169,165,4,19,0
"1723","Aposentado_Invalidez","X5",0,0.668190209618591,8,178,174,4,8,0
"1724","Analgésicos","X5",0.00819672131147541,0.0875580612118638,122,65,62,3,121,1
"1725","OutraDoenca","X5",0,0.125304730406278,69,120,116,4,69,0
"1726","Dor nas costas","X5",0.00917431192660551,0.167789118226844,109,77,74,3,108,1
"1727","Dor nas pernas","X5",0,0.151128983532938,62,123,119,4,62,0
"1728","Retornar_trabalho","X5",0,0.389220792601805,21,146,141,5,21,0
"1729","Masc","X5",0.0298507462686567,0.98614382403195,134,68,66,2,130,4
"1730","Fem","X5",0.0294117647058824,0.98614382403195,68,134,130,4,66,2
"1731","Casado/Amasiaado","X5",0,0.034045603038968,85,117,111,6,85,0
"1732","Solteiro","X5",0,0.0289033304687579,88,114,108,6,88,0
"1733","Separado_Divorciado","X5",0,0.613578416541615,8,194,188,6,8,0
"1734","X4","X5",0,0.760121315418735,3,199,193,6,3,0
"1735","X5","X5",1,7.64535599642325e-46,6,196,196,0,0,6
"1736","X6","X5",0,0.532011596340825,12,190,184,6,12,0
"1737","Livrar_costas","X5",0.0103092783505155,0.125069048097251,97,15,14,1,96,1
"1738","Livrar_perna","X5",0,0.589638551626567,14,98,96,2,14,0
"1739","Livrar_perda_sens","X5",1,9.36734209686383e-14,1,111,110,1,0,1
"1740","D1","X5",0,0.902407153906854,1,135,133,2,1,0
"1741","D15","X5",0,0.739976909027013,7,129,127,2,7,0
"1742","D16","X5",0,0.554127697484356,20,116,114,2,20,0
"1743","D17","X5",0,0.780748527710185,5,131,129,2,5,0
"1744","D18","X5",0.0625,0.0908805539668756,16,120,119,1,15,1
"1745","D19","X5",0,0.739976909027013,7,129,127,2,7,0
"1746","D2","X5",0,0.721704213787294,8,128,126,2,8,0
"1747","D20","X5",0,0.721704213787294,8,128,126,2,8,0
"1748","D21","X5",0,0.739976909027013,7,129,127,2,7,0
"1749","D22","X5",0,0.861819671758601,2,134,132,2,2,0
"1750","D23","X5",0,0.861819671758601,2,134,132,2,2,0
"1751","D24","X5",0.0384615384615385,0.263175050261802,26,110,109,1,25,1
"1752","D25","X5",0,0.804124066880639,4,132,130,2,4,0
"1753","D26","X5",0,0.861819671758601,2,134,132,2,2,0
"1754","D27","X5",0,0.780748527710185,5,131,129,2,5,0
"1755","D28","X5",0,0.759543172318368,6,130,128,2,6,0
"1756","D29","X5",0,0.340923749246409,42,94,92,2,42,0
"1757","D3","X5",0,0.861819671758601,2,134,132,2,2,0
"1758","Lombalgia","X5",0,0.192198319028589,62,74,72,2,62,0
"1759","D31","X5",0,0.590234194210651,17,119,117,2,17,0
"1760","D32","X5",0,0.383757260247278,37,99,97,2,37,0
"1761","D33","X5",0,0.657612161666932,12,124,122,2,12,0
"1762","D34","X5",0,0.830565083280277,3,133,131,2,3,0
"1763","D35","X5",0,0.861819671758601,2,134,132,2,2,0
"1764","D36","X5",0,0.721704213787294,8,128,126,2,8,0
"1765","D37","X5",0,0.531393754170243,22,114,112,2,22,0
"1766","D38","X5",0,0.830565083280277,3,133,131,2,3,0
"1767","D39","X5",0,0.615926597177117,15,121,119,2,15,0
"1768","D4","X5",0,0.804124066880639,4,132,130,2,4,0
"1769","D40","X5",0,0.780748527710185,5,131,129,2,5,0
"1770","D41","X5",0,0.739976909027013,7,129,127,2,7,0
"1771","D42","X5",0,0.830565083280277,3,133,131,2,3,0
"1772","D43","X5",0,0.830565083280277,3,133,131,2,3,0
"1773","D44","X5",0,0.374983020515037,38,98,96,2,38,0
"1774","D45","X5",0,0.657612161666932,12,124,122,2,12,0
"1775","D46","X5",0,0.374983020515037,38,98,96,2,38,0
"1776","D47","X5",0,0.657612161666932,12,124,122,2,12,0
"1777","D48","X5",0,0.488520668794022,26,110,108,2,26,0
"1778","D49","X5",0,0.643234299777126,13,123,121,2,13,0
"1779","D5","X5",0,0.830565083280277,3,133,131,2,3,0
"1780","D50","X5",0,0.861819671758601,2,134,132,2,2,0
"1781","D51","X5",0,0.902407153906854,1,135,133,2,1,0
"1782","D52","X5",0,0.861819671758601,2,134,132,2,2,0
"1783","D53","X5",0,0.861819671758601,2,134,132,2,2,0
"1784","D9","X5",0,0.902407153906854,1,135,133,2,1,0
"1785","RMDQ1_v1","X5",0.0428571428571429,0.314948167557093,70,111,110,1,67,3
"1786","RMDQ2_v1","X5",0.04,0.380659457226035,75,106,105,1,72,3
"1787","RMDQ3_v1","X5",0.0151515151515152,0.641213014187573,66,117,114,3,65,1
"1788","RMDQ4_v1","X5",0,0.234518697602857,47,136,132,4,47,0
"1789","RMDQ5_v1","X5",0.0163934426229508,0.720731087282001,61,122,119,3,60,1
"1790","RMDQ6_v1","X5",0.0208333333333333,0.954925294150218,48,135,132,3,47,1
"1791","RMDQ7_v1","X5",0.0303030303030303,0.718466846384741,33,149,146,3,32,1
"1792","RMDQ8_v1","X5",0,0.664552260223522,8,174,170,4,8,0
"1793","RMDQ9_v1","X5",0.0344827586206897,0.616405875993634,29,153,150,3,28,1
"1794","RMDQ10_v1","X5",0.0294117647058824,0.743020499647911,34,148,145,3,33,1
"1795","RMDQ11_v1","X5",0.0277777777777778,0.791006762917235,36,146,143,3,35,1
"1796","RMDQ12_v1","X5",0.0277777777777778,0.791006762917235,36,146,143,3,35,1
"1797","RMDQ13_v1","X5",0.0263157894736842,0.837538913112981,38,144,141,3,37,1
"1798","RMDQ14_v1","X5",0.05,0.171148825895779,40,142,140,2,38,2
"1799","RMDQ15_v1","X5",0.0416666666666667,0.480132247700843,24,158,155,3,23,1
"1800","RMDQ16_v1","X5",0.032258064516129,0.668212762738764,31,151,148,3,30,1
"1801","RMDQ17_v1","X5",0.0256410256410256,0.860276094665209,39,143,140,3,38,1
"1802","RMDQ18_v1","X5",0.032258064516129,0.668212762738764,31,151,148,3,30,1
"1803","RMDQ19_v1","X5",0.037037037037037,0.563037780257756,27,155,152,3,26,1
"1804","RMDQ20_v1","X5",0.03125,0.693532397529908,32,150,147,3,31,1
"1805","RMDQ21_v1","X5",0.025,0.882669759851911,40,142,139,3,39,1
"1806","RMDQ22_v1","X5",0.0303030303030303,0.718466846384741,33,149,146,3,32,1
"1807","RMDQ23_v1","X5",0.032258064516129,0.668212762738764,31,151,148,3,30,1
"1808","RMDQ24_v1","X5",0.0333333333333333,0.642504591980499,30,152,149,3,29,1
"1809","DN4 - Queimação","X5",0.037037037037037,0.472526884224484,81,102,100,2,78,3
"1810","DN4 - Sensação de frio dolorosa","X5",0,0.228810979671472,40,142,137,5,40,0
"1811","DN4 - Choque elétrico","X5",0.0384615384615385,0.548710096884232,52,133,130,3,50,2
"1812","DN4 - Formigamento","X5",0.0425531914893617,0.447258441037516,47,138,135,3,45,2
"1813","DN4 - Alfinetada e agulhada","X5",0.0363636363636364,0.610491395590076,55,130,127,3,53,2
"1814","DN4 - Adormecimento","X5",0.0740740740740741,0.0120717210767695,54,129,128,1,50,4
"1815","DN4 - Coceira","X5",0,0.653038209525315,7,178,173,5,7,0
"1816","DH4 - Hipoestesia ao toque","X5",0,0.678116980295812,6,179,174,5,6,0
"1817","DN4 - Hipoestesia a picada de agulha","X5",0,0.653038209525315,7,178,173,5,7,0
"1818","DN4 - Escovação","X5",0,0.705565336576118,5,180,175,5,5,0
"1819","Fuma","X6",0.108695652173913,0.0830792452204177,46,147,141,6,41,5
"1820","Cirurgia na coluna","X6",0.0972222222222222,0.0500138051072718,72,106,103,3,65,7
"1821","Aposentado","X6",0.205882352941176,4.54929392710709e-05,34,156,152,4,27,7
"1822","Desempregado","X6",0.0384615384615385,0.629847413624636,26,160,150,10,25,1
"1823","Licenca_Medica","X6",0.0526315789473684,0.908319682917262,19,169,159,10,18,1
"1824","Aposentado_Invalidez","X6",0.125,0.419518039672779,8,178,168,10,7,1
"1825","Analgésicos","X6",0.0737704918032787,0.234004444368344,122,65,63,2,113,9
"1826","OutraDoenca","X6",0.072463768115942,0.525382059585057,69,120,114,6,64,5
"1827","Dor nas costas","X6",0.055045871559633,0.7782363490356,109,77,72,5,103,6
"1828","Dor nas pernas","X6",0.0806451612903226,0.386976844012474,62,123,117,6,57,5
"1829","Retornar_trabalho","X6",0.19047619047619,0.00303132058526851,21,146,141,5,17,4
"1830","Masc","X6",0.0895522388059701,0.0109454307198087,134,68,68,0,122,12
"1831","Fem","X6",0,0.0109454307198087,68,134,122,12,68,0
"1832","Casado/Amasiaado","X6",0,0.00233121422126153,85,117,105,12,85,0
"1833","Solteiro","X6",0,0.00169998067403695,88,114,102,12,88,0
"1834","Separado_Divorciado","X6",0,0.468251658961437,8,194,182,12,8,0
"1835","X4","X6",0,0.660984353778988,3,199,187,12,3,0
"1836","X5","X6",0,0.532011596340825,6,196,184,12,6,0
"1837","X6","X6",1,7.64535599642336e-46,12,190,190,0,0,12
"1838","Livrar_costas","X6",0.0618556701030928,0.942891516636662,97,15,14,1,91,6
"1839","Livrar_perna","X6",0.0714285714285714,0.882704055468208,14,98,92,6,13,1
"1840","Livrar_perda_sens","X6",0,0.795357998505294,1,111,104,7,1,0
"1841","D1","X6",0,0.777361156052393,1,135,125,10,1,0
"1842","D15","X6",0,0.444085965332051,7,129,119,10,7,0
"1843","D16","X6",0.15,0.15597415377561,20,116,109,7,17,3
"1844","D17","X6",0,0.52097059061678,5,131,121,10,5,0
"1845","D18","X6",0,0.230276381512055,16,120,110,10,16,0
"1846","D19","X6",0,0.444085965332051,7,129,119,10,7,0
"1847","D2","X6",0.125,0.56533213981898,8,128,119,9,7,1
"1848","D20","X6",0,0.411451319476889,8,128,118,10,8,0
"1849","D21","X6",0,0.444085965332051,7,129,119,10,7,0
"1850","D22","X6",0,0.688146459888278,2,134,124,10,2,0
"1851","D23","X6",0,0.688146459888278,2,134,124,10,2,0
"1852","D24","X6",0.0384615384615385,0.446198351241192,26,110,101,9,25,1
"1853","D25","X6",0,0.56738337600414,4,132,122,10,4,0
"1854","D26","X6",0,0.688146459888278,2,134,124,10,2,0
"1855","D27","X6",0,0.52097059061678,5,131,121,10,5,0
"1856","D28","X6",0,0.480305975474933,6,130,120,10,6,0
"1857","D29","X6",0.119047619047619,0.173998367457132,42,94,89,5,37,5
"1858","D3","X6",0,0.688146459888278,2,134,124,10,2,0
"1859","Lombalgia","X6",0.0967741935483871,0.341773301122051,62,74,70,4,56,6
"1860","D31","X6",0.0588235294117647,0.803863176758422,17,119,110,9,16,1
"1861","D32","X6",0.108108108108108,0.344899751882013,37,99,93,6,33,4
"1862","D33","X6",0,0.306766347454945,12,124,114,10,12,0
"1863","D34","X6",0,0.621714056090023,3,133,123,10,3,0
"1864","D35","X6",0,0.688146459888278,2,134,124,10,2,0
"1865","D36","X6",0,0.411451319476889,8,128,118,10,8,0
"1866","D37","X6",0.136363636363636,0.217453761221712,22,114,107,7,19,3
"1867","D38","X6",0,0.621714056090023,3,133,123,10,3,0
"1868","D39","X6",0.2,0.0466351168508042,15,121,114,7,12,3
"1869","D4","X6",0,0.56738337600414,4,132,122,10,4,0
"1870","D40","X6",0,0.52097059061678,5,131,121,10,5,0
"1871","D41","X6",0.142857142857143,0.470552989828395,7,129,120,9,6,1
"1872","D42","X6",0,0.621714056090023,3,133,123,10,3,0
"1873","D43","X6",0,0.621714056090023,3,133,123,10,3,0
"1874","D44","X6",0.131578947368421,0.106288088348678,38,98,93,5,33,5
"1875","D45","X6",0.0833333333333333,0.891607233250317,12,124,115,9,11,1
"1876","D46","X6",0.157894736842105,0.0189107805148973,38,98,94,4,32,6
"1877","D47","X6",0.0833333333333333,0.891607233250317,12,124,115,9,11,1
"1878","D48","X6",0.192307692307692,0.00987480625918281,26,110,105,5,21,5
"1879","D49","X6",0.0769230769230769,0.960683450676548,13,123,114,9,12,1
"1880","D5","X6",0.333333333333333,0.0812591734655008,3,133,124,9,2,1
"1881","D50","X6",0,0.688146459888278,2,134,124,10,2,0
"1882","D51","X6",0,0.777361156052393,1,135,125,10,1,0
"1883","D52","X6",0,0.688146459888278,2,134,124,10,2,0
"1884","D53","X6",0,0.688146459888278,2,134,124,10,2,0
"1885","D9","X6",0,0.777361156052393,1,135,125,10,1,0
"1886","RMDQ1_v1","X6",0.0428571428571429,0.580016960732293,70,111,102,9,67,3
"1887","RMDQ2_v1","X6",0.04,0.470216191509536,75,106,97,9,72,3
"1888","RMDQ3_v1","X6",0.0909090909090909,0.298384341750286,66,117,111,6,60,6
"1889","RMDQ4_v1","X6",0.0851063829787234,0.530318247394057,47,136,128,8,43,4
"1890","RMDQ5_v1","X6",0.114754098360656,0.0573695405876138,61,122,117,5,54,7
"1891","RMDQ6_v1","X6",0.145833333333333,0.00891224466223994,48,135,130,5,41,7
"1892","RMDQ7_v1","X6",0.121212121212121,0.157305331985917,33,149,141,8,29,4
"1893","RMDQ8_v1","X6",0.125,0.49114246192435,8,174,163,11,7,1
"1894","RMDQ9_v1","X6",0.103448275862069,0.374619807629857,29,153,144,9,26,3
"1895","RMDQ10_v1","X6",0.0882352941176471,0.561192441198149,34,148,139,9,31,3
"1896","RMDQ11_v1","X6",0.111111111111111,0.222651452609313,36,146,138,8,32,4
"1897","RMDQ12_v1","X6",0.111111111111111,0.222651452609313,36,146,138,8,32,4
"1898","RMDQ13_v1","X6",0.0789473684210526,0.716302881629038,38,144,135,9,35,3
"1899","RMDQ14_v1","X6",0.05,0.645708827467397,40,142,132,10,38,2
"1900","RMDQ15_v1","X6",0.0833333333333333,0.712397607303263,24,158,148,10,22,2
"1901","RMDQ16_v1","X6",0.0967741935483871,0.447477423437325,31,151,142,9,28,3
"1902","RMDQ17_v1","X6",0.0769230769230769,0.755062199425663,39,143,134,9,36,3
"1903","RMDQ18_v1","X6",0.0645161290322581,0.972139233880974,31,151,141,10,29,2
"1904","RMDQ19_v1","X6",0.0740740740740741,0.853475696193983,27,155,145,10,25,2
"1905","RMDQ20_v1","X6",0.125,0.13805873100664,32,150,142,8,28,4
"1906","RMDQ21_v1","X6",0.075,0.793651839738159,40,142,133,9,37,3
"1907","RMDQ22_v1","X6",0.0909090909090909,0.522860349660526,33,149,140,9,30,3
"1908","RMDQ23_v1","X6",0.0967741935483871,0.447477423437325,31,151,142,9,28,3
"1909","RMDQ24_v1","X6",0.1,0.410668232492365,30,152,143,9,27,3
"1910","DN4 - Queimação","X6",0.0493827160493827,0.586423708924194,81,102,95,7,77,4
"1911","DN4 - Sensação de frio dolorosa","X6",0.025,0.346744640181569,40,142,133,9,39,1
"1912","DN4 - Choque elétrico","X6",0.0769230769230769,0.529968849020069,52,133,126,7,48,4
"1913","DN4 - Formigamento","X6",0.0851063829787234,0.389316508736938,47,138,131,7,43,4
"1914","DN4 - Alfinetada e agulhada","X6",0.0727272727272727,0.619641352825129,55,130,123,7,51,4
"1915","DN4 - Adormecimento","X6",0.037037037037037,0.395554489252605,54,129,120,9,52,2
"1916","DN4 - Coceira","X6",0.285714285714286,0.00986240276699366,7,178,169,9,5,2
"1917","DH4 - Hipoestesia ao toque","X6",0,0.531237070984813,6,179,168,11,6,0
"1918","DN4 - Hipoestesia a picada de agulha","X6",0,0.497655964603027,7,178,167,11,7,0
"1919","DN4 - Escovação","X6",0,0.568694187092496,5,180,169,11,5,0
"1920","Fuma","Livrar_costas",0.818181818181818,0.336155093179132,33,79,9,70,6,27
"1921","Cirurgia na coluna","Livrar_costas",0.86,0.839495200184812,50,63,8,55,7,43
"1922","Aposentado","Livrar_costas",0.961538461538462,0.15630849088816,26,93,13,80,1,25
"1923","Desempregado","Livrar_costas",0.846153846153846,0.529583371206293,26,92,10,82,4,22
"1924","Licenca_Medica","Livrar_costas",0.9375,0.461784641670014,16,103,13,90,1,15
"1925","Aposentado_Invalidez","Livrar_costas",0.75,0.285717336283617,8,109,13,96,2,6
"1926","Analgésicos","Livrar_costas",0.88659793814433,0.575712767923035,97,26,4,22,11,86
"1927","OutraDoenca","Livrar_costas",0.862745098039216,0.526970982615792,51,70,7,63,7,44
"1928","Dor nas costas","Livrar_costas",0.918918918918919,5.90344938486379e-05,111,16,7,9,9,102
"1929","Dor nas pernas","Livrar_costas",0.771929824561403,0.000663642262154395,57,68,2,66,13,44
"1930","Retornar_trabalho","Livrar_costas",0.9,0.810101589700952,20,101,12,89,2,18
"1931","Masc","Livrar_costas",0.908045977011494,0.099605876029224,87,41,8,33,8,79
"1932","Fem","Livrar_costas",0.804878048780488,0.099605876029224,41,87,8,79,8,33
"1933","Casado/Amasiaado","Livrar_costas",0.891304347826087,0.512731165344762,46,66,10,56,5,41
"1934","Solteiro","Livrar_costas",0.88,0.697513490566162,50,62,9,53,6,44
"1935","Separado_Divorciado","Livrar_costas",0.8,0.657176068228176,5,107,14,93,1,4
"1936","X4","Livrar_costas",0.5,0.125069048097251,2,110,14,96,1,1
"1937","X5","Livrar_costas",0.5,0.125069048097251,2,110,14,96,1,1
"1938","X6","Livrar_costas",0.857142857142857,0.942891516636662,7,105,14,91,1,6
"1939","Livrar_costas","Livrar_costas",1,1.12242971729829e-29,112,16,16,0,0,112
"1940","Livrar_perna","Livrar_costas",0,9.62715091354252e-26,14,114,2,112,14,0
"1941","Livrar_perda_sens","Livrar_costas",0,0.000162440845186801,2,126,14,112,2,0
"1942","D1","Livrar_costas",1,0.685105670480977,1,99,14,85,0,1
"1943","D15","Livrar_costas",0.666666666666667,0.1592246430211,6,94,12,82,2,4
"1944","D16","Livrar_costas",0.894736842105263,0.627779598272031,19,81,12,69,2,17
"1945","D17","Livrar_costas",1,0.410174600795881,4,96,14,82,0,4
"1946","D18","Livrar_costas",1,0.136244253418548,12,88,14,74,0,12
"1947","D19","Livrar_costas",1,0.354637665742146,5,95,14,81,0,5
"1948","D2","Livrar_costas",1,0.268321791516394,7,93,14,79,0,7
"1949","D20","Livrar_costas",1,0.268321791516394,7,93,14,79,0,7
"1950","D21","Livrar_costas",1,0.268321791516394,7,93,14,79,0,7
"1951","D22","Livrar_costas",1,0.685105670480977,1,99,14,85,0,1
"1952","D23","Livrar_costas",1,0.564351319818157,2,98,14,84,0,2
"1953","D24","Livrar_costas",1,0.0198350198079292,25,75,14,61,0,25
"1954","D25","Livrar_costas",1,0.410174600795881,4,96,14,82,0,4
"1955","D26","Livrar_costas",1,0.564351319818157,2,98,14,84,0,2
"1956","D27","Livrar_costas",1,0.354637665742146,5,95,14,81,0,5
"1957","D28","Livrar_costas",1,0.308033310809975,6,94,14,80,0,6
"1958","D29","Livrar_costas",0.825,0.410174600795881,40,60,7,53,7,33
"1959","D3","Livrar_costas",1,0.685105670480977,1,99,14,85,0,1
"1960","Lombalgia","Livrar_costas",0.836065573770492,0.388321448368179,61,39,4,35,10,51
"1961","D31","Livrar_costas",0.764705882352941,0.213902495888319,17,83,10,73,4,13
"1962","D32","Livrar_costas",0.805555555555556,0.239276499269037,36,64,7,57,7,29
"1963","D33","Livrar_costas",0.666666666666667,0.0396368172231428,12,88,10,78,4,8
"1964","D34","Livrar_costas",1,0.564351319818157,2,98,14,84,0,2
"1965","D35","Livrar_costas",1,0.685105670480977,1,99,14,85,0,1
"1966","D36","Livrar_costas",0.571428571428571,0.0225104448699356,7,93,11,82,3,4
"1967","D37","Livrar_costas",0.85,0.885423396371719,20,80,11,69,3,17
"1968","D38","Livrar_costas",0,1.30819386914069e-05,3,97,11,86,3,0
"1969","D39","Livrar_costas",0.785714285714286,0.387704704280563,14,86,11,75,3,11
"1970","D4","Livrar_costas",1,0.564351319818157,2,98,14,84,0,2
"1971","D40","Livrar_costas",0.25,0.000332606859565408,4,96,11,85,3,1
"1972","D41","Livrar_costas",0.833333333333333,0.846048003443795,6,94,13,81,1,5
"1973","D42","Livrar_costas",1,0.564351319818157,2,98,14,84,0,2
"1974","D43","Livrar_costas",1,0.564351319818157,2,98,14,84,0,2
"1975","D44","Livrar_costas",0.777777777777778,0.075534716456855,36,64,6,58,8,28
"1976","D45","Livrar_costas",0.666666666666667,0.0396368172231428,12,88,10,78,4,8
"1977","D46","Livrar_costas",0.75,0.017425222464693,36,64,5,59,9,27
"1978","D47","Livrar_costas",0.583333333333333,0.00323609342187556,12,88,9,79,5,7
"1979","D48","Livrar_costas",0.75,0.0748358668411259,24,76,8,68,6,18
"1980","D49","Livrar_costas",0.692307692307692,0.0617410439153952,13,87,10,77,4,9
"1981","D5","Livrar_costas",1,0.477976598685774,3,97,14,83,0,3
"1982","D50","Livrar_costas",1,0.685105670480977,1,99,14,85,0,1
"1983","D51","Livrar_costas",1,0.685105670480977,1,99,14,85,0,1
"1984","D52","Livrar_costas",1,0.685105670480977,1,99,14,85,0,1
"1985","D53","Livrar_costas",1,0.685105670480977,1,99,14,85,0,1
"1986","D9","Livrar_costas",1,0.685105670480977,1,99,14,85,0,1
"1987","RMDQ1_v1","Livrar_costas",0.882352941176471,0.864197877893339,51,71,10,61,6,45
"1988","RMDQ2_v1","Livrar_costas",0.892857142857143,0.712528856219392,56,66,10,56,6,50
"1989","RMDQ3_v1","Livrar_costas",0.936170212765957,0.0906252349756962,47,77,13,64,3,44
"1990","RMDQ4_v1","Livrar_costas",0.96969696969697,0.0482807554318782,33,91,15,76,1,32
"1991","RMDQ5_v1","Livrar_costas",0.926829268292683,0.192183679105858,41,83,13,70,3,38
"1992","RMDQ6_v1","Livrar_costas",0.909090909090909,0.445713397608081,33,91,13,78,3,30
"1993","RMDQ7_v1","Livrar_costas",0.923076923076923,0.36421929783921,26,97,14,83,2,24
"1994","RMDQ8_v1","Livrar_costas",1,0.29210506754582,7,116,16,100,0,7
"1995","RMDQ9_v1","Livrar_costas",0.909090909090909,0.546677512023865,22,101,14,87,2,20
"1996","RMDQ10_v1","Livrar_costas",0.925925925925926,0.327453638750848,27,96,14,82,2,25
"1997","RMDQ11_v1","Livrar_costas",0.925925925925926,0.327453638750848,27,96,14,82,2,25
"1998","RMDQ12_v1","Livrar_costas",0.931034482758621,0.263069618166919,29,94,14,80,2,27
"1999","RMDQ13_v1","Livrar_costas",0.928571428571429,0.29380489715575,28,95,14,81,2,26
"2000","RMDQ14_v1","Livrar_costas",0.90625,0.477518917824818,32,91,13,78,3,29
"2001","RMDQ15_v1","Livrar_costas",0.833333333333333,0.617492553600973,18,105,13,92,3,15
"2002","RMDQ16_v1","Livrar_costas",0.91304347826087,0.495326116175534,23,100,14,86,2,21
"2003","RMDQ17_v1","Livrar_costas",0.923076923076923,0.36421929783921,26,97,14,83,2,24
"2004","RMDQ18_v1","Livrar_costas",0.875,0.934261991716333,24,99,13,86,3,21
"2005","RMDQ19_v1","Livrar_costas",0.9,0.662098688194421,20,103,14,89,2,18
"2006","RMDQ20_v1","Livrar_costas",0.916666666666667,0.447941658950252,24,99,14,85,2,22
"2007","RMDQ21_v1","Livrar_costas",0.9375,0.186416370187659,32,91,14,77,2,30
"2008","RMDQ22_v1","Livrar_costas",0.909090909090909,0.546677512023865,22,101,14,87,2,20
"2009","RMDQ23_v1","Livrar_costas",0.916666666666667,0.447941658950252,24,99,14,85,2,22
"2010","RMDQ24_v1","Livrar_costas",0.91304347826087,0.495326116175534,23,100,14,86,2,21
"2011","DN4 - Queimação","Livrar_costas",0.824561403508772,0.12770793366904,57,61,5,56,10,47
"2012","DN4 - Sensação de frio dolorosa","Livrar_costas",0.869565217391304,0.949841823322859,23,96,13,83,3,20
"2013","DN4 - Choque elétrico","Livrar_costas",0.828571428571429,0.43084077961608,35,85,10,75,6,29
"2014","DN4 - Formigamento","Livrar_costas",0.774193548387097,0.0786251804882373,31,89,9,80,7,24
"2015","DN4 - Alfinetada e agulhada","Livrar_costas",0.875,0.84939640127479,40,80,11,69,5,35
"2016","DN4 - Adormecimento","Livrar_costas",0.789473684210526,0.0608460144847477,38,80,7,73,8,30
"2017","DN4 - Coceira","Livrar_costas",1,0.370294615560341,5,115,16,99,0,5
"2018","DH4 - Hipoestesia ao toque","Livrar_costas",1,0.424942938277499,4,116,16,100,0,4
"2019","DN4 - Hipoestesia a picada de agulha","Livrar_costas",1,0.424942938277499,4,116,16,100,0,4
"2020","DN4 - Escovação","Livrar_costas",1,0.491439609923196,3,117,16,101,0,3
"2021","Fuma","Livrar_perna",0.181818181818182,0.239948315399424,33,79,71,8,27,6
"2022","Cirurgia na coluna","Livrar_perna",0.12,0.883064417403572,50,63,56,7,44,6
"2023","Aposentado","Livrar_perna",0.0384615384615385,0.190610733049083,26,93,81,12,25,1
"2024","Desempregado","Livrar_perna",0.153846153846154,0.420495532343745,26,92,83,9,22,4
"2025","Licenca_Medica","Livrar_perna",0.0625,0.51940770850611,16,103,91,12,15,1
"2026","Aposentado_Invalidez","Livrar_perna",0.25,0.195299732576803,8,109,98,11,6,2
"2027","Analgésicos","Livrar_perna",0.11340206185567,0.977449561913696,97,26,23,3,86,11
"2028","OutraDoenca","Livrar_perna",0.137254901960784,0.365968452548214,51,70,64,6,44,7
"2029","Dor nas costas","Livrar_perna",0.0720720720720721,0.000297932765117485,111,16,10,6,103,8
"2030","Dor nas pernas","Livrar_perna",0.228070175438596,0.000164948611540917,57,68,67,1,44,13
"2031","Retornar_trabalho","Livrar_perna",0.1,0.989201338532159,20,101,91,10,18,2
"2032","Masc","Livrar_perna",0.0804597701149425,0.126801388816998,87,41,34,7,80,7
"2033","Fem","Livrar_perna",0.170731707317073,0.126801388816998,41,87,80,7,34,7
"2034","Casado/Amasiaado","Livrar_perna",0.108695652173913,0.66314699553797,46,66,57,9,41,5
"2035","Solteiro","Livrar_perna",0.12,0.885749815429911,50,62,54,8,44,6
"2036","Separado_Divorciado","Livrar_perna",0.2,0.603896562478827,5,107,94,13,4,1
"2037","X4","Livrar_perna",0.5,0.105645429201878,2,110,97,13,1,1
"2038","X5","Livrar_perna",0,0.589638551626567,2,110,96,14,2,0
"2039","X6","Livrar_perna",0.142857142857143,0.882704055468208,7,105,92,13,6,1
"2040","Livrar_costas","Livrar_perna",0,9.62715091354252e-26,112,16,2,14,112,0
"2041","Livrar_perna","Livrar_perna",1,1.12242971729829e-29,14,114,114,0,0,14
"2042","Livrar_perda_sens","Livrar_perna",0,0.617418430269056,2,126,112,14,2,0
"2043","D1","Livrar_perna",0,0.685105670480977,1,99,85,14,1,0
"2044","D15","Livrar_perna",0.333333333333333,0.1592246430211,6,94,82,12,4,2
"2045","D16","Livrar_perna",0.105263157894737,0.627779598272031,19,81,69,12,17,2
"2046","D17","Livrar_perna",0,0.410174600795881,4,96,82,14,4,0
"2047","D18","Livrar_perna",0,0.136244253418548,12,88,74,14,12,0
"2048","D19","Livrar_perna",0,0.354637665742146,5,95,81,14,5,0
"2049","D2","Livrar_perna",0,0.268321791516394,7,93,79,14,7,0
"2050","D20","Livrar_perna",0,0.268321791516394,7,93,79,14,7,0
"2051","D21","Livrar_perna",0,0.268321791516394,7,93,79,14,7,0
"2052","D22","Livrar_perna",0,0.685105670480977,1,99,85,14,1,0
"2053","D23","Livrar_perna",0,0.564351319818157,2,98,84,14,2,0
"2054","D24","Livrar_perna",0,0.0198350198079292,25,75,61,14,25,0
"2055","D25","Livrar_perna",0,0.410174600795881,4,96,82,14,4,0
"2056","D26","Livrar_perna",0,0.564351319818157,2,98,84,14,2,0
"2057","D27","Livrar_perna",0,0.354637665742146,5,95,81,14,5,0
"2058","D28","Livrar_perna",0,0.308033310809975,6,94,80,14,6,0
"2059","D29","Livrar_perna",0.175,0.410174600795881,40,60,53,7,33,7
"2060","D3","Livrar_perna",0,0.685105670480977,1,99,85,14,1,0
"2061","Lombalgia","Livrar_perna",0.163934426229508,0.388321448368179,61,39,35,4,51,10
"2062","D31","Livrar_perna",0.235294117647059,0.213902495888319,17,83,73,10,13,4
"2063","D32","Livrar_perna",0.194444444444444,0.239276499269037,36,64,57,7,29,7
"2064","D33","Livrar_perna",0.333333333333333,0.0396368172231428,12,88,78,10,8,4
"2065","D34","Livrar_perna",0,0.564351319818157,2,98,84,14,2,0
"2066","D35","Livrar_perna",0,0.685105670480977,1,99,85,14,1,0
"2067","D36","Livrar_perna",0.428571428571429,0.0225104448699356,7,93,82,11,4,3
"2068","D37","Livrar_perna",0.15,0.885423396371719,20,80,69,11,17,3
"2069","D38","Livrar_perna",1,1.30819386914069e-05,3,97,86,11,0,3
"2070","D39","Livrar_perna",0.214285714285714,0.387704704280563,14,86,75,11,11,3
"2071","D4","Livrar_perna",0,0.564351319818157,2,98,84,14,2,0
"2072","D40","Livrar_perna",0.75,0.000332606859565408,4,96,85,11,1,3
"2073","D41","Livrar_perna",0.166666666666667,0.846048003443795,6,94,81,13,5,1
"2074","D42","Livrar_perna",0,0.564351319818157,2,98,84,14,2,0
"2075","D43","Livrar_perna",0,0.564351319818157,2,98,84,14,2,0
"2076","D44","Livrar_perna",0.222222222222222,0.075534716456855,36,64,58,6,28,8
"2077","D45","Livrar_perna",0.333333333333333,0.0396368172231428,12,88,78,10,8,4
"2078","D46","Livrar_perna",0.25,0.017425222464693,36,64,59,5,27,9
"2079","D47","Livrar_perna",0.416666666666667,0.00323609342187556,12,88,79,9,7,5
"2080","D48","Livrar_perna",0.25,0.0748358668411259,24,76,68,8,18,6
"2081","D49","Livrar_perna",0.307692307692308,0.0617410439153952,13,87,77,10,9,4
"2082","D5","Livrar_perna",0,0.477976598685774,3,97,83,14,3,0
"2083","D50","Livrar_perna",0,0.685105670480977,1,99,85,14,1,0
"2084","D51","Livrar_perna",0,0.685105670480977,1,99,85,14,1,0
"2085","D52","Livrar_perna",0,0.685105670480977,1,99,85,14,1,0
"2086","D53","Livrar_perna",0,0.685105670480977,1,99,85,14,1,0
"2087","D9","Livrar_perna",0,0.685105670480977,1,99,85,14,1,0
"2088","RMDQ1_v1","Livrar_perna",0.0980392156862745,0.830178510429733,51,71,62,9,46,5
"2089","RMDQ2_v1","Livrar_perna",0.0892857142857143,0.67194136948442,56,66,57,9,51,5
"2090","RMDQ3_v1","Livrar_perna",0.0638297872340425,0.177326715684862,47,77,66,11,44,3
"2091","RMDQ4_v1","Livrar_perna",0.0303030303030303,0.0800825319698658,33,91,78,13,32,1
"2092","RMDQ5_v1","Livrar_perna",0.0731707317073171,0.325810897656119,41,83,72,11,38,3
"2093","RMDQ6_v1","Livrar_perna",0.0909090909090909,0.64119291265472,33,91,80,11,30,3
"2094","RMDQ7_v1","Livrar_perna",0.0769230769230769,0.504714328746874,26,97,85,12,24,2
"2095","RMDQ8_v1","Livrar_perna",0,0.32887120486905,7,116,102,14,7,0
"2096","RMDQ9_v1","Livrar_perna",0.0909090909090909,0.708837555071883,22,101,89,12,20,2
"2097","RMDQ10_v1","Livrar_perna",0.0740740740740741,0.461675099076693,27,96,84,12,25,2
"2098","RMDQ11_v1","Livrar_perna",0.0740740740740741,0.461675099076693,27,96,84,12,25,2
"2099","RMDQ12_v1","Livrar_perna",0.0689655172413793,0.384286070333107,29,94,82,12,27,2
"2100","RMDQ13_v1","Livrar_perna",0.0714285714285714,0.421577354506448,28,95,83,12,26,2
"2101","RMDQ14_v1","Livrar_perna",0.0625,0.287895495678225,32,91,79,12,30,2
"2102","RMDQ15_v1","Livrar_perna",0.111111111111111,0.968744634503816,18,105,93,12,16,2
"2103","RMDQ16_v1","Livrar_perna",0.0869565217391304,0.65277584695815,23,100,88,12,21,2
"2104","RMDQ17_v1","Livrar_perna",0.0769230769230769,0.504714328746874,26,97,85,12,24,2
"2105","RMDQ18_v1","Livrar_perna",0.125,0.847581168623816,24,99,88,11,21,3
"2106","RMDQ19_v1","Livrar_perna",0.1,0.831578880879003,20,103,91,12,18,2
"2107","RMDQ20_v1","Livrar_perna",0.0833333333333333,0.600141486098285,24,99,87,12,22,2
"2108","RMDQ21_v1","Livrar_perna",0.0625,0.287895495678225,32,91,79,12,30,2
"2109","RMDQ22_v1","Livrar_perna",0.0909090909090909,0.708837555071883,22,101,89,12,20,2
"2110","RMDQ23_v1","Livrar_perna",0.0833333333333333,0.600141486098285,24,99,87,12,22,2
"2111","RMDQ24_v1","Livrar_perna",0.0869565217391304,0.65277584695815,23,100,88,12,21,2
"2112","DN4 - Queimação","Livrar_perna",0.157894736842105,0.109469991952695,57,61,57,4,48,9
"2113","DN4 - Sensação de frio dolorosa","Livrar_perna",0.130434782608696,0.832165115677634,23,96,85,11,20,3
"2114","DN4 - Choque elétrico","Livrar_perna",0.171428571428571,0.230486251037914,35,85,77,8,29,6
"2115","DN4 - Formigamento","Livrar_perna",0.225806451612903,0.0279504880910265,31,89,82,7,24,7
"2116","DN4 - Alfinetada e agulhada","Livrar_perna",0.125,0.840639713612799,40,80,71,9,35,5
"2117","DN4 - Adormecimento","Livrar_perna",0.184210526315789,0.0766574292733324,38,80,74,6,31,7
"2118","DN4 - Coceira","Livrar_perna",0,0.406474276328387,5,115,101,14,5,0
"2119","DH4 - Hipoestesia ao toque","Livrar_perna",0,0.459743448144979,4,116,102,14,4,0
"2120","DN4 - Hipoestesia a picada de agulha","Livrar_perna",0,0.459743448144979,4,116,102,14,4,0
"2121","DN4 - Escovação","Livrar_perna",0,0.523809518045622,3,117,103,14,3,0
"2122","Fuma","Livrar_perda_sens",0,0.516197098269408,33,79,78,1,33,0
"2123","Cirurgia na coluna","Livrar_perda_sens",0.02,0.868744414179442,50,63,62,1,49,1
"2124","Aposentado","Livrar_perda_sens",0,0.595433050706267,26,93,92,1,26,0
"2125","Desempregado","Livrar_perda_sens",0,0.593426957598424,26,92,91,1,26,0
"2126","Licenca_Medica","Livrar_perda_sens",0,0.69225387709932,16,103,102,1,16,0
"2127","Aposentado_Invalidez","Livrar_perda_sens",0,0.699165111851179,8,109,107,2,8,0
"2128","Analgésicos","Livrar_perda_sens",0,0.0524502369042994,97,26,25,1,97,0
"2129","OutraDoenca","Livrar_perda_sens",0,0.39138238494486,51,70,69,1,51,0
"2130","Dor nas costas","Livrar_perda_sens",0.00900900900900901,0.108120853726359,111,16,15,1,110,1
"2131","Dor nas pernas","Livrar_perda_sens",0,0.357972021988728,57,68,67,1,57,0
"2132","Retornar_trabalho","Livrar_perda_sens",0,0.525700342438451,20,101,99,2,20,0
"2133","Masc","Livrar_perda_sens",0.0114942528735632,0.58305867218302,87,41,40,1,86,1
"2134","Fem","Livrar_perda_sens",0.024390243902439,0.58305867218302,41,87,86,1,40,1
"2135","Casado/Amasiaado","Livrar_perda_sens",0,0.401694231299615,46,66,65,1,46,0
"2136","Solteiro","Livrar_perda_sens",0,0.3670236122959,50,62,61,1,50,0
"2137","Separado_Divorciado","Livrar_perda_sens",0,0.828098929650461,5,107,106,1,5,0
"2138","X4","Livrar_perda_sens",0,0.892259258121653,2,110,109,1,2,0
"2139","X5","Livrar_perda_sens",0.5,9.36734209686383e-14,2,110,110,0,1,1
"2140","X6","Livrar_perda_sens",0,0.795357998505294,7,105,104,1,7,0
"2141","Livrar_costas","Livrar_perda_sens",0,0.000162440845186801,112,16,14,2,112,0
"2142","Livrar_perna","Livrar_perda_sens",0,0.617418430269056,14,114,112,2,14,0
"2143","Livrar_perda_sens","Livrar_perda_sens",1,1.12242971729829e-29,2,126,126,0,0,2
"2144","D1","Livrar_perda_sens",0,NA,1,99,99,0,1,0
"2145","D15","Livrar_perda_sens",0,NA,6,94,94,0,6,0
"2146","D16","Livrar_perda_sens",0,NA,19,81,81,0,19,0
"2147","D17","Livrar_perda_sens",0,NA,4,96,96,0,4,0
"2148","D18","Livrar_perda_sens",0,NA,12,88,88,0,12,0
"2149","D19","Livrar_perda_sens",0,NA,5,95,95,0,5,0
"2150","D2","Livrar_perda_sens",0,NA,7,93,93,0,7,0
"2151","D20","Livrar_perda_sens",0,NA,7,93,93,0,7,0
"2152","D21","Livrar_perda_sens",0,NA,7,93,93,0,7,0
"2153","D22","Livrar_perda_sens",0,NA,1,99,99,0,1,0
"2154","D23","Livrar_perda_sens",0,NA,2,98,98,0,2,0
"2155","D24","Livrar_perda_sens",0,NA,25,75,75,0,25,0
"2156","D25","Livrar_perda_sens",0,NA,4,96,96,0,4,0
"2157","D26","Livrar_perda_sens",0,NA,2,98,98,0,2,0
"2158","D27","Livrar_perda_sens",0,NA,5,95,95,0,5,0
"2159","D28","Livrar_perda_sens",0,NA,6,94,94,0,6,0
"2160","D29","Livrar_perda_sens",0,NA,40,60,60,0,40,0
"2161","D3","Livrar_perda_sens",0,NA,1,99,99,0,1,0
"2162","Lombalgia","Livrar_perda_sens",0,NA,61,39,39,0,61,0
"2163","D31","Livrar_perda_sens",0,NA,17,83,83,0,17,0
"2164","D32","Livrar_perda_sens",0,NA,36,64,64,0,36,0
"2165","D33","Livrar_perda_sens",0,NA,12,88,88,0,12,0
"2166","D34","Livrar_perda_sens",0,NA,2,98,98,0,2,0
"2167","D35","Livrar_perda_sens",0,NA,1,99,99,0,1,0
"2168","D36","Livrar_perda_sens",0,NA,7,93,93,0,7,0
"2169","D37","Livrar_perda_sens",0,NA,20,80,80,0,20,0
"2170","D38","Livrar_perda_sens",0,NA,3,97,97,0,3,0
"2171","D39","Livrar_perda_sens",0,NA,14,86,86,0,14,0
"2172","D4","Livrar_perda_sens",0,NA,2,98,98,0,2,0
"2173","D40","Livrar_perda_sens",0,NA,4,96,96,0,4,0
"2174","D41","Livrar_perda_sens",0,NA,6,94,94,0,6,0
"2175","D42","Livrar_perda_sens",0,NA,2,98,98,0,2,0
"2176","D43","Livrar_perda_sens",0,NA,2,98,98,0,2,0
"2177","D44","Livrar_perda_sens",0,NA,36,64,64,0,36,0
"2178","D45","Livrar_perda_sens",0,NA,12,88,88,0,12,0
"2179","D46","Livrar_perda_sens",0,NA,36,64,64,0,36,0
"2180","D47","Livrar_perda_sens",0,NA,12,88,88,0,12,0
"2181","D48","Livrar_perda_sens",0,NA,24,76,76,0,24,0
"2182","D49","Livrar_perda_sens",0,NA,13,87,87,0,13,0
"2183","D5","Livrar_perda_sens",0,NA,3,97,97,0,3,0
"2184","D50","Livrar_perda_sens",0,NA,1,99,99,0,1,0
"2185","D51","Livrar_perda_sens",0,NA,1,99,99,0,1,0
"2186","D52","Livrar_perda_sens",0,NA,1,99,99,0,1,0
"2187","D53","Livrar_perda_sens",0,NA,1,99,99,0,1,0
"2188","D9","Livrar_perda_sens",0,NA,1,99,99,0,1,0
"2189","RMDQ1_v1","Livrar_perda_sens",0.0196078431372549,0.964027491461303,51,71,70,1,50,1
"2190","RMDQ2_v1","Livrar_perda_sens",0.0178571428571429,0.98485147500424,56,66,65,1,55,1
"2191","RMDQ3_v1","Livrar_perda_sens",0,0.26531847168,47,77,75,2,47,0
"2192","RMDQ4_v1","Livrar_perda_sens",0,0.390570714659516,33,91,89,2,33,0
"2193","RMDQ5_v1","Livrar_perda_sens",0,0.316308953668101,41,83,81,2,41,0
"2194","RMDQ6_v1","Livrar_perda_sens",0,0.390570714659516,33,91,89,2,33,0
"2195","RMDQ7_v1","Livrar_perda_sens",0,0.460391234966393,26,97,95,2,26,0
"2196","RMDQ8_v1","Livrar_perda_sens",0,0.726140948600676,7,116,114,2,7,0
"2197","RMDQ9_v1","Livrar_perda_sens",0,0.505752825555412,22,101,99,2,22,0
"2198","RMDQ10_v1","Livrar_perda_sens",0,0.44954551242066,27,96,94,2,27,0
"2199","RMDQ11_v1","Livrar_perda_sens",0,0.44954551242066,27,96,94,2,27,0
"2200","RMDQ12_v1","Livrar_perda_sens",0,0.428376882546342,29,94,92,2,29,0
"2201","RMDQ13_v1","Livrar_perda_sens",0,0.438876912649035,28,95,93,2,28,0
"2202","RMDQ14_v1","Livrar_perda_sens",0.03125,0.435701006743543,32,91,90,1,31,1
"2203","RMDQ15_v1","Livrar_perda_sens",0.0555555555555556,0.153665853249879,18,105,104,1,17,1
"2204","RMDQ16_v1","Livrar_perda_sens",0,0.494091831099047,23,100,98,2,23,0
"2205","RMDQ17_v1","Livrar_perda_sens",0,0.460391234966393,26,97,95,2,26,0
"2206","RMDQ18_v1","Livrar_perda_sens",0,0.482653175722585,24,99,97,2,24,0
"2207","RMDQ19_v1","Livrar_perda_sens",0,0.529803457460897,20,103,101,2,20,0
"2208","RMDQ20_v1","Livrar_perda_sens",0,0.482653175722585,24,99,97,2,24,0
"2209","RMDQ21_v1","Livrar_perda_sens",0,0.397814837807423,32,91,89,2,32,0
"2210","RMDQ22_v1","Livrar_perda_sens",0,0.505752825555412,22,101,99,2,22,0
"2211","RMDQ23_v1","Livrar_perda_sens",0,0.482653175722585,24,99,97,2,24,0
"2212","RMDQ24_v1","Livrar_perda_sens",0,0.494091831099047,23,100,98,2,23,0
"2213","DN4 - Queimação","Livrar_perda_sens",0.0175438596491228,0.961414393251082,57,61,60,1,56,1
"2214","DN4 - Sensação de frio dolorosa","Livrar_perda_sens",0,0.485108414698764,23,96,94,2,23,0
"2215","DN4 - Choque elétrico","Livrar_perda_sens",0,0.36011632639728,35,85,83,2,35,0
"2216","DN4 - Formigamento","Livrar_perda_sens",0,0.399963349010264,31,89,87,2,31,0
"2217","DN4 - Alfinetada e agulhada","Livrar_perda_sens",0,0.313243773401308,40,80,78,2,40,0
"2218","DN4 - Adormecimento","Livrar_perda_sens",0.0263157894736842,0.586949267478778,38,80,79,1,37,1
"2219","DN4 - Coceira","Livrar_perda_sens",0,0.766182191157743,5,115,113,2,5,0
"2220","DH4 - Hipoestesia ao toque","Livrar_perda_sens",0,0.791141159033469,4,116,114,2,4,0
"2221","DN4 - Hipoestesia a picada de agulha","Livrar_perda_sens",0,0.791141159033469,4,116,114,2,4,0
"2222","DN4 - Escovação","Livrar_perda_sens",0,0.819361364095442,3,117,115,2,3,0
"2223","Fuma","D1",0,0.452095549051344,46,82,81,1,46,0
"2224","Cirurgia na coluna","D1",0,0.348070916478987,55,63,62,1,55,0
"2225","Aposentado","D1",0,0.578126229420996,31,101,100,1,31,0
"2226","Desempregado","D1",0,0.624248775981322,25,105,104,1,25,0
"2227","Licenca_Medica","D1",0,0.689986442818079,18,114,113,1,18,0
"2228","Aposentado_Invalidez","D1",0,0.797943352456733,8,123,122,1,8,0
"2229","Analgésicos","D1",0.0113636363636364,0.487982136848066,88,42,42,0,87,1
"2230","OutraDoenca","D1",0,0.427412188827125,50,80,79,1,50,0
"2231","Dor nas costas","D1",0.010989010989011,0.522073609395411,91,37,37,0,90,1
"2232","Dor nas pernas","D1",0,0.380232056877916,55,72,71,1,55,0
"2233","Retornar_trabalho","D1",0,0.651725008243142,20,99,98,1,20,0
"2234","Masc","D1",0.0113636363636364,0.458524130935477,88,48,48,0,87,1
"2235","Fem","D1",0,0.458524130935477,48,88,87,1,48,0
"2236","Casado/Amasiaado","D1",0.0181818181818182,0.2232064450424,55,81,81,0,54,1
"2237","Solteiro","D1",0,0.379626958504178,59,77,76,1,59,0
"2238","Separado_Divorciado","D1",0,0.815135138754741,7,129,128,1,7,0
"2239","X4","D1",0,0.880178390709511,3,133,132,1,3,0
"2240","X5","D1",0,0.902407153906854,2,134,133,1,2,0
"2241","X6","D1",0,0.777361156052393,10,126,125,1,10,0
"2242","Livrar_costas","D1",0.0116279069767442,0.685105670480977,86,14,14,0,85,1
"2243","Livrar_perna","D1",0,0.685105670480977,14,86,85,1,14,0
"2244","Livrar_perda_sens","D1",NA,NA,0,100,99,1,0,0
"2245","D1","D1",1,1.99530445797665e-31,1,135,135,0,0,1
"2246","D15","D1",0,0.815135138754741,7,129,128,1,7,0
"2247","D16","D1",0,0.676852177137204,20,116,115,1,20,0
"2248","D17","D1",0.2,2.78393278311577e-07,5,131,131,0,4,1
"2249","D18","D1",0.0625,0.00598253521157324,16,120,120,0,15,1
"2250","D19","D1",0,0.815135138754741,7,129,128,1,7,0
"2251","D2","D1",0,0.801872700366009,8,128,127,1,8,0
"2252","D20","D1",0,0.801872700366009,8,128,127,1,8,0
"2253","D21","D1",0,0.815135138754741,7,129,128,1,7,0
"2254","D22","D1",0,0.902407153906854,2,134,133,1,2,0
"2255","D23","D1",0,0.902407153906854,2,134,133,1,2,0
"2256","D24","D1",0,0.625571266952418,26,110,109,1,26,0
"2257","D25","D1",0,0.861298710023066,4,132,131,1,4,0
"2258","D26","D1",0,0.902407153906854,2,134,133,1,2,0
"2259","D27","D1",0,0.844540967905734,5,131,130,1,5,0
"2260","D28","D1",0,0.829277200319907,6,130,129,1,6,0
"2261","D29","D1",0,0.502278826842558,42,94,93,1,42,0
"2262","D3","D1",0,0.902407153906854,2,134,133,1,2,0
"2263","Lombalgia","D1",0,0.358242727739549,62,74,73,1,62,0
"2264","D31","D1",0,0.704419244092944,17,119,118,1,17,0
"2265","D32","D1",0,0.539479231806348,37,99,98,1,37,0
"2266","D33","D1",0,0.75486151575449,12,124,123,1,12,0
"2267","D34","D1",0,0.880178390709511,3,133,132,1,3,0
"2268","D35","D1",0,0.902407153906854,2,134,133,1,2,0
"2269","D36","D1",0,0.801872700366009,8,128,127,1,8,0
"2270","D37","D1",0,0.659269674875409,22,114,113,1,22,0
"2271","D38","D1",0,0.880178390709511,3,133,132,1,3,0
"2272","D39","D1",0,0.723795314149376,15,121,120,1,15,0
"2273","D4","D1",0,0.861298710023066,4,132,131,1,4,0
"2274","D40","D1",0,0.844540967905734,5,131,130,1,5,0
"2275","D41","D1",0,0.815135138754741,7,129,128,1,7,0
"2276","D42","D1",0,0.880178390709511,3,133,132,1,3,0
"2277","D43","D1",0,0.880178390709511,3,133,132,1,3,0
"2278","D44","D1",0,0.531969817884708,38,98,97,1,38,0
"2279","D45","D1",0,0.75486151575449,12,124,123,1,12,0
"2280","D46","D1",0,0.531969817884708,38,98,97,1,38,0
"2281","D47","D1",0,0.75486151575449,12,124,123,1,12,0
"2282","D48","D1",0,0.625571266952418,26,110,109,1,26,0
"2283","D49","D1",0,0.744194764154502,13,123,122,1,13,0
"2284","D5","D1",0,0.880178390709511,3,133,132,1,3,0
"2285","D50","D1",0,0.902407153906854,2,134,133,1,2,0
"2286","D51","D1",0,0.931160789923657,1,135,134,1,1,0
"2287","D52","D1",0,0.902407153906854,2,134,133,1,2,0
"2288","D53","D1",0,0.902407153906854,2,134,133,1,2,0
"2289","D9","D1",0,0.931160789923657,1,135,134,1,1,0
"2290","RMDQ1_v1","D1",0.0232558139534884,0.419839443150142,43,73,73,0,42,1
"2291","RMDQ2_v1","D1",0.0212765957446809,0.471846992882068,47,69,69,0,46,1
"2292","RMDQ3_v1","D1",0.0277777777777778,0.1296036170137,36,82,82,0,35,1
"2293","RMDQ4_v1","D1",0.0384615384615385,0.0588782180805536,26,92,92,0,25,1
"2294","RMDQ5_v1","D1",0,0.531483921254055,33,85,84,1,33,0
"2295","RMDQ6_v1","D1",0,0.566468281116867,29,89,88,1,29,0
"2296","RMDQ7_v1","D1",0,0.648368667298824,20,97,96,1,20,0
"2297","RMDQ8_v1","D1",0,0.850129340451501,4,113,112,1,4,0
"2298","RMDQ9_v1","D1",0,0.668479726871623,18,99,98,1,18,0
"2299","RMDQ10_v1","D1",0,0.628885363875848,22,95,94,1,22,0
"2300","RMDQ11_v1","D1",0,0.61934434211196,23,94,93,1,23,0
"2301","RMDQ12_v1","D1",0,0.628885363875848,22,95,94,1,22,0
"2302","RMDQ13_v1","D1",0.0454545454545455,0.0368916317321308,22,95,95,0,21,1
"2303","RMDQ14_v1","D1",0,0.600606776606717,25,92,91,1,25,0
"2304","RMDQ15_v1","D1",0,0.700139702762516,15,102,101,1,15,0
"2305","RMDQ16_v1","D1",0,0.658337884368623,19,98,97,1,19,0
"2306","RMDQ17_v1","D1",0,0.628885363875848,22,95,94,1,22,0
"2307","RMDQ18_v1","D1",0,0.648368667298824,20,97,96,1,20,0
"2308","RMDQ19_v1","D1",0,0.689357768311308,16,101,100,1,16,0
"2309","RMDQ20_v1","D1",0,0.638555915507599,21,96,95,1,21,0
"2310","RMDQ21_v1","D1",0,0.609921533119359,24,93,92,1,24,0
"2311","RMDQ22_v1","D1",0,0.648368667298824,20,97,96,1,20,0
"2312","RMDQ23_v1","D1",0,0.658337884368623,19,98,97,1,19,0
"2313","RMDQ24_v1","D1",0,0.658337884368623,19,98,97,1,19,0
"2314","DN4 - Queimação","D1",0.0188679245283019,0.266069863620088,53,65,65,0,52,1
"2315","DN4 - Sensação de frio dolorosa","D1",0.0416666666666667,0.0468674002441255,24,94,94,0,23,1
"2316","DN4 - Choque elétrico","D1",0,0.508374874653824,36,83,82,1,36,0
"2317","DN4 - Formigamento","D1",0.032258064516129,0.0906514651303281,31,88,88,0,30,1
"2318","DN4 - Alfinetada e agulhada","D1",0,0.508374874653824,36,83,82,1,36,0
"2319","DN4 - Adormecimento","D1",0,0.531483921254055,33,85,84,1,33,0
"2320","DN4 - Coceira","D1",0,0.817001778007153,6,113,112,1,6,0
"2321","DH4 - Hipoestesia ao toque","D1",0,0.833423792098798,5,114,113,1,5,0
"2322","DN4 - Hipoestesia a picada de agulha","D1",0,0.833423792098798,5,114,113,1,5,0
"2323","DN4 - Escovação","D1",0,0.851433613762243,4,115,114,1,4,0
"2324","Fuma","D15",0.108695652173913,0.0023225674062509,46,82,82,0,41,5
"2325","Cirurgia na coluna","D15",0.0909090909090909,0.0144633272971544,55,63,63,0,50,5
"2326","Aposentado","D15",0.032258064516129,0.686761644479342,31,101,96,5,30,1
"2327","Desempregado","D15",0.08,0.369475560195933,25,105,101,4,23,2
"2328","Licenca_Medica","D15",0.166666666666667,0.00789277254493988,18,114,111,3,15,3
"2329","Aposentado_Invalidez","D15",0.125,0.268803203207311,8,123,118,5,7,1
"2330","Analgésicos","D15",0.0340909090909091,0.148603043072552,88,42,38,4,85,3
"2331","OutraDoenca","D15",0.04,0.580300480306315,50,80,75,5,48,2
"2332","Dor nas costas","D15",0.0549450549450549,0.983964821465572,91,37,35,2,86,5
"2333","Dor nas pernas","D15",0.109090909090909,0.0198345060885519,55,72,71,1,49,6
"2334","Retornar_trabalho","D15",0,0.220283219050709,20,99,92,7,20,0
"2335","Masc","D15",0.0454545454545455,0.66724773570396,88,48,45,3,84,4
"2336","Fem","D15",0.0625,0.66724773570396,48,88,84,4,45,3
"2337","Casado/Amasiaado","D15",0.0545454545454545,0.893615907253868,55,81,77,4,52,3
"2338","Solteiro","D15",0.0508474576271186,0.977032998995578,59,77,73,4,56,3
"2339","Separado_Divorciado","D15",0,0.526853490497434,7,129,122,7,7,0
"2340","X4","D15",0.333333333333333,0.0254648673683159,3,133,127,6,2,1
"2341","X5","D15",0,0.739976909027013,2,134,127,7,2,0
"2342","X6","D15",0,0.444085965332051,10,126,119,7,10,0
"2343","Livrar_costas","D15",0.0465116279069767,0.1592246430211,86,14,12,2,82,4
"2344","Livrar_perna","D15",0.142857142857143,0.1592246430211,14,86,82,4,12,2
"2345","Livrar_perda_sens","D15",NA,NA,0,100,94,6,0,0
"2346","D1","D15",0,0.815135138754741,1,135,128,7,1,0
"2347","D15","D15",1,1.99530445797665e-31,7,129,129,0,0,7
"2348","D16","D15",0.15,0.0308255911313597,20,116,112,4,17,3
"2349","D17","D15",0.4,0.000325896542562272,5,131,126,5,3,2
"2350","D18","D15",0.125,0.156458987223275,16,120,115,5,14,2
"2351","D19","D15",0,0.526853490497434,7,129,122,7,7,0
"2352","D2","D15",0.125,0.331942004087524,8,128,122,6,7,1
"2353","D20","D15",0,0.497044882450256,8,128,121,7,8,0
"2354","D21","D15",0,0.526853490497434,7,129,122,7,7,0
"2355","D22","D15",0,0.739976909027013,2,134,127,7,2,0
"2356","D23","D15",0,0.739976909027013,2,134,127,7,2,0
"2357","D24","D15",0,0.186591501022522,26,110,103,7,26,0
"2358","D25","D15",0,0.63628659530033,4,132,125,7,4,0
"2359","D26","D15",0,0.739976909027013,2,134,127,7,2,0
"2360","D27","D15",0,0.595606456103754,5,131,124,7,5,0
"2361","D28","D15",0,0.55947835087211,6,130,123,7,6,0
"2362","D29","D15",0.0952380952380952,0.122562737228077,42,94,91,3,38,4
"2363","D3","D15",0,0.739976909027013,2,134,127,7,2,0
"2364","Lombalgia","D15",0.032258064516129,0.353317884063431,62,74,69,5,60,2
"2365","D31","D15",0.235294117647059,0.000245366968341328,17,119,116,3,13,4
"2366","D32","D15",0.027027027027027,0.430286953545862,37,99,93,6,36,1
"2367","D33","D15",0.166666666666667,0.0585717946693723,12,124,119,5,10,2
"2368","D34","D15",0.333333333333333,0.0254648673683159,3,133,127,6,2,1
"2369","D35","D15",0.5,0.00382637942754141,2,134,128,6,1,1
"2370","D36","D15",0.625,3.80079434300703e-14,8,128,126,2,3,5
"2371","D37","D15",0.181818181818182,0.0025092611761976,22,114,111,3,18,4
"2372","D38","D15",0.666666666666667,1.07956281323173e-06,3,133,128,5,1,2
"2373","D39","D15",0,0.338829038839701,15,121,114,7,15,0
"2374","D4","D15",0.25,0.0681472853138079,4,132,126,6,3,1
"2375","D40","D15",0.8,1.17874103972796e-14,5,131,128,3,1,4
"2376","D41","D15",0.428571428571429,3.54616436732681e-06,7,129,125,4,4,3
"2377","D42","D15",0,0.683274873050331,3,133,126,7,3,0
"2378","D43","D15",0,0.683274873050331,3,133,126,7,3,0
"2379","D44","D15",0.0526315789473684,0.969562661066158,38,98,93,5,36,2
"2380","D45","D15",0.166666666666667,0.0585717946693723,12,124,119,5,10,2
"2381","D46","D15",0.0526315789473684,0.969562661066158,38,98,93,5,36,2
"2382","D47","D15",0.25,0.00111555229397474,12,124,120,4,9,3
"2383","D48","D15",0.0384615384615385,0.738522327104601,26,110,104,6,25,1
"2384","D49","D15",0.153846153846154,0.0789811536453963,13,123,118,5,11,2
"2385","D5","D15",0.333333333333333,0.0254648673683159,3,133,127,6,2,1
"2386","D50","D15",0,0.739976909027013,2,134,127,7,2,0
"2387","D51","D15",1,1.64201114746102e-05,1,135,129,6,0,1
"2388","D52","D15",0,0.739976909027013,2,134,127,7,2,0
"2389","D53","D15",0,0.739976909027013,2,134,127,7,2,0
"2390","D9","D15",1,1.64201114746102e-05,1,135,129,6,0,1
"2391","RMDQ1_v1","D15",0.0697674418604651,0.917577367895651,43,73,69,4,40,3
"2392","RMDQ2_v1","D15",0.0638297872340425,0.960191476540528,47,69,65,4,44,3
"2393","RMDQ3_v1","D15",0.0277777777777778,0.336492389359646,36,82,76,6,35,1
"2394","RMDQ4_v1","D15",0,0.14700890489015,26,92,85,7,26,0
"2395","RMDQ5_v1","D15",0.0303030303030303,0.405712579214709,33,85,79,6,32,1
"2396","RMDQ6_v1","D15",0.0344827586206897,0.514393596899754,29,89,83,6,28,1
"2397","RMDQ7_v1","D15",0.05,0.838703911858419,20,97,91,6,19,1
"2398","RMDQ8_v1","D15",0,0.607687652229803,4,113,106,7,4,0
"2399","RMDQ9_v1","D15",0.0555555555555556,0.933766669511119,18,99,93,6,17,1
"2400","RMDQ10_v1","D15",0.0454545454545455,0.752394853272729,22,95,89,6,21,1
"2401","RMDQ11_v1","D15",0.0434782608695652,0.712225217901405,23,94,88,6,22,1
"2402","RMDQ12_v1","D15",0.0454545454545455,0.752394853272729,22,95,89,6,21,1
"2403","RMDQ13_v1","D15",0.0454545454545455,0.752394853272729,22,95,89,6,21,1
"2404","RMDQ14_v1","D15",0.04,0.63733801517531,25,92,86,6,24,1
"2405","RMDQ15_v1","D15",0.0666666666666667,0.904810508581279,15,102,96,6,14,1
"2406","RMDQ16_v1","D15",0.0526315789473684,0.88507678924591,19,98,92,6,18,1
"2407","RMDQ17_v1","D15",0.0454545454545455,0.752394853272729,22,95,89,6,21,1
"2408","RMDQ18_v1","D15",0.05,0.838703911858419,20,97,91,6,19,1
"2409","RMDQ19_v1","D15",0.0625,0.961330653334592,16,101,95,6,15,1
"2410","RMDQ20_v1","D15",0.0476190476190476,0.794517050138976,21,96,90,6,20,1
"2411","RMDQ21_v1","D15",0.0416666666666667,0.673904727525455,24,93,87,6,23,1
"2412","RMDQ22_v1","D15",0.05,0.838703911858419,20,97,91,6,19,1
"2413","RMDQ23_v1","D15",0.0526315789473684,0.88507678924591,19,98,92,6,18,1
"2414","RMDQ24_v1","D15",0.0526315789473684,0.88507678924591,19,98,92,6,18,1
"2415","DN4 - Queimação","D15",0.0754716981132075,0.502481575566997,53,65,62,3,49,4
"2416","DN4 - Sensação de frio dolorosa","D15",0,0.168084755737741,24,94,87,7,24,0
"2417","DN4 - Choque elétrico","D15",0.138888888888889,0.014498692935062,36,83,81,2,31,5
"2418","DN4 - Formigamento","D15",0.129032258064516,0.0533672436257132,31,88,85,3,27,4
"2419","DN4 - Alfinetada e agulhada","D15",0.138888888888889,0.014498692935062,36,83,81,2,31,5
"2420","DN4 - Adormecimento","D15",0.0909090909090909,0.36544265238027,33,85,81,4,30,3
"2421","DN4 - Coceira","D15",0.166666666666667,0.249278728612911,6,113,107,6,5,1
"2422","DH4 - Hipoestesia ao toque","D15",0.2,0.170453834419036,5,114,108,6,4,1
"2423","DN4 - Hipoestesia a picada de agulha","D15",0.2,0.170453834419036,5,114,108,6,4,1
"2424","DN4 - Escovação","D15",0.25,0.098326934488196,4,115,109,6,3,1
"2425","Fuma","D16",0.173913043478261,0.543728778149125,46,82,71,11,38,8
"2426","Cirurgia na coluna","D16",0.145454545454545,0.968027946264935,55,63,54,9,47,8
"2427","Aposentado","D16",0.290322580645161,0.0137332931936109,31,101,90,11,22,9
"2428","Desempregado","D16",0.08,0.254830925062737,25,105,87,18,23,2
"2429","Licenca_Medica","D16",0.166666666666667,0.847021786519567,18,114,97,17,15,3
"2430","Aposentado_Invalidez","D16",0.375,0.0566237703305408,8,123,107,16,5,3
"2431","Analgésicos","D16",0.204545454545455,0.0203887833797969,88,42,40,2,70,18
"2432","OutraDoenca","D16",0.14,0.72940452739515,50,80,67,13,43,7
"2433","Dor nas costas","D16",0.208791208791209,0.0102439119688552,91,37,36,1,72,19
"2434","Dor nas pernas","D16",0.345454545454545,3.71703020242853e-07,55,72,71,1,36,19
"2435","Retornar_trabalho","D16",0.35,0.00370268020046657,20,99,89,10,13,7
"2436","Masc","D16",0.159090909090909,0.591650357484209,88,48,42,6,74,14
"2437","Fem","D16",0.125,0.591650357484209,48,88,74,14,42,6
"2438","Casado/Amasiaado","D16",0.181818181818182,0.345610640795716,55,81,71,10,45,10
"2439","Solteiro","D16",0.101694915254237,0.19102887503998,59,77,63,14,53,6
"2440","Separado_Divorciado","D16",0.142857142857143,0.974289740376286,7,129,110,19,6,1
"2441","X4","D16",0,0.467066119740186,3,133,113,20,3,0
"2442","X5","D16",0,0.554127697484356,2,134,114,20,2,0
"2443","X6","D16",0.3,0.15597415377561,10,126,109,17,7,3
"2444","Livrar_costas","D16",0.197674418604651,0.627779598272031,86,14,12,2,69,17
"2445","Livrar_perna","D16",0.142857142857143,0.627779598272031,14,86,69,17,12,2
"2446","Livrar_perda_sens","D16",NA,NA,0,100,81,19,0,0
"2447","D1","D16",0,0.676852177137204,1,135,115,20,1,0
"2448","D15","D16",0.428571428571429,0.0308255911313597,7,129,112,17,4,3
"2449","D16","D16",1,1.99530445797665e-31,20,116,116,0,0,20
"2450","D17","D16",0.2,0.733426772104044,5,131,112,19,4,1
"2451","D18","D16",0.0625,0.30929633637411,16,120,101,19,15,1
"2452","D19","D16",0.142857142857143,0.974289740376286,7,129,110,19,6,1
"2453","D2","D16",0.125,0.855906204792587,8,128,109,19,7,1
"2454","D20","D16",0,0.226054306034848,8,128,108,20,8,0
"2455","D21","D16",0.142857142857143,0.974289740376286,7,129,110,19,6,1
"2456","D22","D16",0,0.554127697484356,2,134,114,20,2,0
"2457","D23","D16",0,0.554127697484356,2,134,114,20,2,0
"2458","D24","D16",0.0769230769230769,0.261531536755026,26,110,92,18,24,2
"2459","D25","D16",0,0.399260020365242,4,132,112,20,4,0
"2460","D26","D16",0,0.554127697484356,2,134,114,20,2,0
"2461","D27","D16",0.2,0.733426772104044,5,131,112,19,4,1
"2462","D28","D16",0,0.298199645327366,6,130,110,20,6,0
"2463","D29","D16",0.380952380952381,2.63198503318329e-07,42,94,90,4,26,16
"2464","D3","D16",0,0.554127697484356,2,134,114,20,2,0
"2465","Lombalgia","D16",0.258064516129032,0.000820691942325468,62,74,70,4,46,16
"2466","D31","D16",0.0588235294117647,0.272143386891802,17,119,100,19,16,1
"2467","D32","D16",0.459459459459459,3.20175248906849e-10,37,99,96,3,20,17
"2468","D33","D16",0.0833333333333333,0.513907330318457,12,124,105,19,11,1
"2469","D34","D16",0.333333333333333,0.356947483268678,3,133,114,19,2,1
"2470","D35","D16",0.5,0.155663891032951,2,134,115,19,1,1
"2471","D36","D16",0.125,0.855906204792587,8,128,109,19,7,1
"2472","D37","D16",0.818181818181818,2.79019726204524e-22,22,114,112,2,4,18
"2473","D38","D16",0,0.467066119740186,3,133,113,20,3,0
"2474","D39","D16",0.866666666666667,7.25356607226897e-17,15,121,114,7,2,13
"2475","D4","D16",0.25,0.555150103521647,4,132,113,19,3,1
"2476","D40","D16",0,0.34413339274707,5,131,111,20,5,0
"2477","D41","D16",0.571428571428571,0.00113356584548728,7,129,113,16,3,4
"2478","D42","D16",0,0.467066119740186,3,133,113,20,3,0
"2479","D43","D16",0,0.467066119740186,3,133,113,20,3,0
"2480","D44","D16",0.421052631578947,1.93149500093739e-08,38,98,94,4,22,16
"2481","D45","D16",0.166666666666667,0.840815091812043,12,124,106,18,10,2
"2482","D46","D16",0.421052631578947,1.93149500093739e-08,38,98,94,4,22,16
"2483","D47","D16",0.0833333333333333,0.513907330318457,12,124,105,19,11,1
"2484","D48","D16",0.576923076923077,5.92063449651354e-12,26,110,105,5,11,15
"2485","D49","D16",0,0.115428930418204,13,123,103,20,13,0
"2486","D5","D16",0.333333333333333,0.356947483268678,3,133,114,19,2,1
"2487","D50","D16",0,0.554127697484356,2,134,114,20,2,0
"2488","D51","D16",1,0.0156394686045021,1,135,116,19,0,1
"2489","D52","D16",0,0.554127697484356,2,134,114,20,2,0
"2490","D53","D16",0,0.554127697484356,2,134,114,20,2,0
"2491","D9","D16",1,0.0156394686045021,1,135,116,19,0,1
"2492","RMDQ1_v1","D16",0.232558139534884,0.376809666919781,43,73,63,10,33,10
"2493","RMDQ2_v1","D16",0.191489361702128,0.814305430061036,47,69,58,11,38,9
"2494","RMDQ3_v1","D16",0.333333333333333,0.00167144613575706,36,82,74,8,24,12
"2495","RMDQ4_v1","D16",0.269230769230769,0.12474439143712,26,92,79,13,19,7
"2496","RMDQ5_v1","D16",0.393939393939394,5.14160689224434e-05,33,85,78,7,20,13
"2497","RMDQ6_v1","D16",0.344827586206897,0.00375775691349187,29,89,79,10,19,10
"2498","RMDQ7_v1","D16",0.3,0.0922146018040814,20,97,83,14,14,6
"2499","RMDQ8_v1","D16",0,0.355441049039986,4,113,93,20,4,0
"2500","RMDQ9_v1","D16",0.277777777777778,0.190553660220271,18,99,84,15,13,5
"2501","RMDQ10_v1","D16",0.227272727272727,0.436033107334636,22,95,80,15,17,5
"2502","RMDQ11_v1","D16",0.260869565217391,0.201198863190655,23,94,80,14,17,6
"2503","RMDQ12_v1","D16",0.272727272727273,0.159306249364,22,95,81,14,16,6
"2504","RMDQ13_v1","D16",0.272727272727273,0.159306249364,22,95,81,14,16,6
"2505","RMDQ14_v1","D16",0.16,0.869839819438198,25,92,76,16,21,4
"2506","RMDQ15_v1","D16",0.266666666666667,0.291532902301946,15,102,86,16,11,4
"2507","RMDQ16_v1","D16",0.263157894736842,0.243334917175902,19,98,83,15,14,5
"2508","RMDQ17_v1","D16",0.181818181818182,0.88044108578768,22,95,79,16,18,4
"2509","RMDQ18_v1","D16",0.2,0.704583574822705,20,97,81,16,16,4
"2510","RMDQ19_v1","D16",0.375,0.0196143295292612,16,101,87,14,10,6
"2511","RMDQ20_v1","D16",0.238095238095238,0.366809488218735,21,96,81,15,16,5
"2512","RMDQ21_v1","D16",0.291666666666667,0.0780427272903602,24,93,80,13,17,7
"2513","RMDQ22_v1","D16",0.3,0.0922146018040814,20,97,83,14,14,6
"2514","RMDQ23_v1","D16",0.263157894736842,0.243334917175902,19,98,83,15,14,5
"2515","RMDQ24_v1","D16",0.263157894736842,0.243334917175902,19,98,83,15,14,5
"2516","DN4 - Queimação","D16",0.188679245283019,0.615914729457111,53,65,55,10,43,10
"2517","DN4 - Sensação de frio dolorosa","D16",0.166666666666667,0.932760869926198,24,94,79,15,20,4
"2518","DN4 - Choque elétrico","D16",0.25,0.115443064543299,36,83,72,11,27,9
"2519","DN4 - Formigamento","D16",0.258064516129032,0.119157289747005,31,88,76,12,23,8
"2520","DN4 - Alfinetada e agulhada","D16",0.194444444444444,0.612301358266918,36,83,70,13,29,7
"2521","DN4 - Adormecimento","D16",0.272727272727273,0.0625469554834348,33,85,74,11,24,9
"2522","DN4 - Coceira","D16",0.333333333333333,0.266574970439957,6,113,95,18,4,2
"2523","DH4 - Hipoestesia ao toque","D16",0.2,0.845314736680156,5,114,95,19,4,1
"2524","DN4 - Hipoestesia a picada de agulha","D16",0.2,0.845314736680156,5,114,95,19,4,1
"2525","DN4 - Escovação","D16",0.25,0.655751723264071,4,115,96,19,3,1
"2526","Fuma","D17",0.0652173913043478,0.0980711909221135,46,82,81,1,43,3
"2527","Cirurgia na coluna","D17",0.0363636363636364,0.480558585282761,55,63,62,1,53,2
"2528","Aposentado","D17",0,0.2066028535923,31,101,96,5,31,0
"2529","Desempregado","D17",0.04,0.964499561927088,25,105,101,4,24,1
"2530","Licenca_Medica","D17",0.111111111111111,0.0798941607124705,18,114,111,3,16,2
"2531","Aposentado_Invalidez","D17",0,0.560923278469121,8,123,118,5,8,0
"2532","Analgésicos","D17",0.0454545454545455,0.548410082507464,88,42,41,1,84,4
"2533","OutraDoenca","D17",0,0.0714234577298519,50,80,75,5,50,0
"2534","Dor nas costas","D17",0.0549450549450549,0.145804141252675,91,37,37,0,86,5
"2535","Dor nas pernas","D17",0.0363636363636364,0.878975562520298,55,72,69,3,53,2
"2536","Retornar_trabalho","D17",0,0.304495053929834,20,99,94,5,20,0
"2537","Masc","D17",0.0568181818181818,0.0924396383197938,88,48,48,0,83,5
"2538","Fem","D17",0,0.0924396383197938,48,88,83,5,48,0
"2539","Casado/Amasiaado","D17",0.0363636363636364,0.983659855025523,55,81,78,3,53,2
"2540","Solteiro","D17",0.0338983050847458,0.876434244326827,59,77,74,3,57,2
"2541","Separado_Divorciado","D17",0,0.595606456103754,7,129,124,5,7,0
"2542","X4","D17",0.333333333333333,0.0057757922013957,3,133,129,4,2,1
"2543","X5","D17",0,0.780748527710185,2,134,129,5,2,0
"2544","X6","D17",0,0.52097059061678,10,126,121,5,10,0
"2545","Livrar_costas","D17",0.0465116279069767,0.410174600795881,86,14,14,0,82,4
"2546","Livrar_perna","D17",0,0.410174600795881,14,86,82,4,14,0
"2547","Livrar_perda_sens","D17",NA,NA,0,100,96,4,0,0
"2548","D1","D17",1,2.78393278311577e-07,1,135,131,4,0,1
"2549","D15","D17",0.285714285714286,0.000325896542562272,7,129,126,3,5,2
"2550","D16","D17",0.05,0.733426772104044,20,116,112,4,19,1
"2551","D17","D17",1,1.99530445797665e-31,5,131,131,0,0,5
"2552","D18","D17",0.3125,4.38985818804933e-10,16,120,120,0,11,5
"2553","D19","D17",0.142857142857143,0.125637765953246,7,129,125,4,6,1
"2554","D2","D17",0.125,0.171623781856835,8,128,124,4,7,1
"2555","D20","D17",0,0.568958961171041,8,128,123,5,8,0
"2556","D21","D17",0.142857142857143,0.125637765953246,7,129,125,4,6,1
"2557","D22","D17",0,0.780748527710185,2,134,129,5,2,0
"2558","D23","D17",0,0.780748527710185,2,134,129,5,2,0
"2559","D24","D17",0.0384615384615385,0.959227442302328,26,110,106,4,25,1
"2560","D25","D17",0,0.691656304093206,4,132,127,5,4,0
"2561","D26","D17",0,0.780748527710185,2,134,129,5,2,0
"2562","D27","D17",0,0.656239661480154,5,131,126,5,5,0
"2563","D28","D17",0,0.62451163800975,6,130,125,5,6,0
"2564","D29","D17",0.0476190476190476,0.65297976041166,42,94,91,3,40,2
"2565","D3","D17",0,0.780748527710185,2,134,129,5,2,0
"2566","Lombalgia","D17",0.0161290322580645,0.241783630662983,62,74,70,4,61,1
"2567","D31","D17",0.0588235294117647,0.605380068057658,17,119,115,4,16,1
"2568","D32","D17",0.027027027027027,0.712191012113425,37,99,95,4,36,1
"2569","D33","D17",0,0.478474042466117,12,124,119,5,12,0
"2570","D34","D17",0,0.732216032264721,3,133,128,5,3,0
"2571","D35","D17",0,0.780748527710185,2,134,129,5,2,0
"2572","D36","D17",0.25,0.000954535942054647,8,128,125,3,6,2
"2573","D37","D17",0.136363636363636,0.00669900195187523,22,114,112,2,19,3
"2574","D38","D17",0,0.732216032264721,3,133,128,5,3,0
"2575","D39","D17",0.0666666666666667,0.514117613858902,15,121,117,4,14,1
"2576","D4","D17",0,0.691656304093206,4,132,127,5,4,0
"2577","D40","D17",0.4,1.09406567191532e-05,5,131,128,3,3,2
"2578","D41","D17",0.285714285714286,0.000325896542562272,7,129,126,3,5,2
"2579","D42","D17",0,0.732216032264721,3,133,128,5,3,0
"2580","D43","D17",0,0.732216032264721,3,133,128,5,3,0
"2581","D44","D17",0,0.155979827588615,38,98,93,5,38,0
"2582","D45","D17",0,0.478474042466117,12,124,119,5,12,0
"2583","D46","D17",0.0263157894736842,0.686789350124843,38,98,94,4,37,1
"2584","D47","D17",0,0.478474042466117,12,124,119,5,12,0
"2585","D48","D17",0,0.268005741392268,26,110,105,5,26,0
"2586","D49","D17",0,0.458879926672685,13,123,118,5,13,0
"2587","D5","D17",0,0.732216032264721,3,133,128,5,3,0
"2588","D50","D17",0,0.780748527710185,2,134,129,5,2,0
"2589","D51","D17",0,0.844540967905734,1,135,130,5,1,0
"2590","D52","D17",0,0.780748527710185,2,134,129,5,2,0
"2591","D53","D17",0,0.780748527710185,2,134,129,5,2,0
"2592","D9","D17",0,0.844540967905734,1,135,130,5,1,0
"2593","RMDQ1_v1","D17",0.0232558139534884,0.703633355024225,43,73,69,4,42,1
"2594","RMDQ2_v1","D17",0.0425531914893617,0.977451832998824,47,69,66,3,45,2
"2595","RMDQ3_v1","D17",0.0555555555555556,0.637620812722162,36,82,79,3,34,2
"2596","RMDQ4_v1","D17",0.0384615384615385,0.910721228321822,26,92,88,4,25,1
"2597","RMDQ5_v1","D17",0.0303030303030303,0.685070666079238,33,85,81,4,32,1
"2598","RMDQ6_v1","D17",0,0.192117716744612,29,89,84,5,29,0
"2599","RMDQ7_v1","D17",0.05,0.859964262675104,20,97,93,4,19,1
"2600","RMDQ8_v1","D17",0,0.667201950354723,4,113,108,5,4,0
"2601","RMDQ9_v1","D17",0,0.329801954387474,18,99,94,5,18,0
"2602","RMDQ10_v1","D17",0,0.271414036674767,22,95,90,5,22,0
"2603","RMDQ11_v1","D17",0,0.258267411370114,23,94,89,5,23,0
"2604","RMDQ12_v1","D17",0,0.271414036674767,22,95,90,5,22,0
"2605","RMDQ13_v1","D17",0.0454545454545455,0.944203181175876,22,95,91,4,21,1
"2606","RMDQ14_v1","D17",0,0.233510138206751,25,92,87,5,25,0
"2607","RMDQ15_v1","D17",0,0.380799352580873,15,102,97,5,15,0
"2608","RMDQ16_v1","D17",0,0.314265473296222,19,98,93,5,19,0
"2609","RMDQ17_v1","D17",0,0.271414036674767,22,95,90,5,22,0
"2610","RMDQ18_v1","D17",0,0.29938055120971,20,97,92,5,20,0
"2611","RMDQ19_v1","D17",0,0.363013858556909,16,101,96,5,16,0
"2612","RMDQ20_v1","D17",0,0.285108215160341,21,96,91,5,21,0
"2613","RMDQ21_v1","D17",0,0.245640976946185,24,93,88,5,24,0
"2614","RMDQ22_v1","D17",0,0.29938055120971,20,97,92,5,20,0
"2615","RMDQ23_v1","D17",0,0.314265473296222,19,98,93,5,19,0
"2616","RMDQ24_v1","D17",0,0.314265473296222,19,98,93,5,19,0
"2617","DN4 - Queimação","D17",0.0754716981132075,0.107020526847558,53,65,64,1,49,4
"2618","DN4 - Sensação de frio dolorosa","D17",0.0416666666666667,0.984647097685877,24,94,90,4,23,1
"2619","DN4 - Choque elétrico","D17",0.0555555555555556,0.627809401675126,36,83,80,3,34,2
"2620","DN4 - Formigamento","D17",0.0645161290322581,0.467782054809843,31,88,85,3,29,2
"2621","DN4 - Alfinetada e agulhada","D17",0.0833333333333333,0.139003043752015,36,83,81,2,33,3
"2622","DN4 - Adormecimento","D17",0,0.154518328207651,33,85,80,5,33,0
"2623","DN4 - Coceira","D17",0,0.598587935384081,6,113,108,5,6,0
"2624","DH4 - Hipoestesia ao toque","D17",0,0.632328327021753,5,114,109,5,5,0
"2625","DN4 - Hipoestesia a picada de agulha","D17",0,0.632328327021753,5,114,109,5,5,0
"2626","DN4 - Escovação","D17",0,0.670052424301302,4,115,110,5,4,0
"2627","Fuma","D18",0.195652173913043,0.0191586856383373,46,82,77,5,37,9
"2628","Cirurgia na coluna","D18",0.127272727272727,0.390383343668942,55,63,58,5,48,7
"2629","Aposentado","D18",0.0645161290322581,0.268848540129623,31,101,87,14,29,2
"2630","Desempregado","D18",0.16,0.531786062941489,25,105,93,12,21,4
"2631","Licenca_Medica","D18",0.166666666666667,0.524894826481102,18,114,101,13,15,3
"2632","Aposentado_Invalidez","D18",0.125,0.979641612736218,8,123,108,15,7,1
"2633","Analgésicos","D18",0.147727272727273,0.0947700044635554,88,42,40,2,75,13
"2634","OutraDoenca","D18",0.1,0.526622450513313,50,80,69,11,45,5
"2635","Dor nas costas","D18",0.164835164835165,0.0325868338154857,91,37,36,1,76,15
"2636","Dor nas pernas","D18",0.0909090909090909,0.297821992365247,55,72,61,11,50,5
"2637","Retornar_trabalho","D18",0.1,0.620462573606016,20,99,85,14,18,2
"2638","Masc","D18",0.147727272727273,0.14042502806385,88,48,45,3,75,13
"2639","Fem","D18",0.0625,0.14042502806385,48,88,75,13,45,3
"2640","Casado/Amasiaado","D18",0.109090909090909,0.798571222618273,55,81,71,10,49,6
"2641","Solteiro","D18",0.135593220338983,0.569624862579721,59,77,69,8,51,8
"2642","Separado_Divorciado","D18",0,0.321218344859636,7,129,113,16,7,0
"2643","X4","D18",0.333333333333333,0.240993975067262,3,133,118,15,2,1
"2644","X5","D18",0.5,0.0908805539668756,2,134,119,15,1,1
"2645","X6","D18",0,0.230276381512055,10,126,110,16,10,0
"2646","Livrar_costas","D18",0.13953488372093,0.136244253418548,86,14,14,0,74,12
"2647","Livrar_perna","D18",0,0.136244253418548,14,86,74,12,14,0
"2648","Livrar_perda_sens","D18",NA,NA,0,100,88,12,0,0
"2649","D1","D18",1,0.00598253521157324,1,135,120,15,0,1
"2650","D15","D18",0.285714285714286,0.156458987223275,7,129,115,14,5,2
"2651","D16","D18",0.05,0.30929633637411,20,116,101,15,19,1
"2652","D17","D18",1,4.38985818804933e-10,5,131,120,11,0,5
"2653","D18","D18",1,1.99530445797665e-31,16,120,120,0,0,16
"2654","D19","D18",0.571428571428571,0.000130178269082534,7,129,117,12,3,4
"2655","D2","D18",0.5,0.000540397683510625,8,128,116,12,4,4
"2656","D20","D18",0.625,4.41112891277472e-06,8,128,117,11,3,5
"2657","D21","D18",0.428571428571429,0.00875176992011601,7,129,116,13,4,3
"2658","D22","D18",1,9.54882562575112e-05,2,134,120,14,0,2
"2659","D23","D18",0,0.602898245770971,2,134,118,16,2,0
"2660","D24","D18",0.153846153846154,0.524118766695548,26,110,98,12,22,4
"2661","D25","D18",0,0.458524130935477,4,132,116,16,4,0
"2662","D26","D18",0.5,0.0908805539668756,2,134,119,15,1,1
"2663","D27","D18",0,0.405446952751703,5,131,115,16,5,0
"2664","D28","D18",0.166666666666667,0.703068761135366,6,130,115,15,5,1
"2665","D29","D18",0.0476190476190476,0.090208328874367,42,94,80,14,40,2
"2666","D3","D18",0.5,0.0908805539668756,2,134,119,15,1,1
"2667","Lombalgia","D18",0.0645161290322581,0.0783580118101856,62,74,62,12,58,4
"2668","D31","D18",0.0588235294117647,0.420965220516746,17,119,104,15,16,1
"2669","D32","D18",0.027027027027027,0.0449379562318231,37,99,84,15,36,1
"2670","D33","D18",0,0.185269593670831,12,124,108,16,12,0
"2671","D34","D18",0,0.522466034450895,3,133,117,16,3,0
"2672","D35","D18",0.5,0.0908805539668756,2,134,119,15,1,1
"2673","D36","D18",0.25,0.23105176113783,8,128,114,14,6,2
"2674","D37","D18",0.136363636363636,0.766003152898813,22,114,101,13,19,3
"2675","D38","D18",0,0.522466034450895,3,133,117,16,3,0
"2676","D39","D18",0.0666666666666667,0.515885059645803,15,121,106,15,14,1
"2677","D4","D18",0.5,0.0159893910801081,4,132,118,14,2,2
"2678","D40","D18",0.4,0.0458644786531582,5,131,117,14,3,2
"2679","D41","D18",0.285714285714286,0.156458987223275,7,129,115,14,5,2
"2680","D42","D18",0.666666666666667,0.00283985885956862,3,133,119,14,1,2
"2681","D43","D18",0.666666666666667,0.00283985885956862,3,133,119,14,1,2
"2682","D44","D18",0,0.00800975216309347,38,98,82,16,38,0
"2683","D45","D18",0,0.185269593670831,12,124,108,16,12,0
"2684","D46","D18",0.0526315789473684,0.142814491244088,38,98,84,14,36,2
"2685","D47","D18",0.0833333333333333,0.699221345182709,12,124,109,15,11,1
"2686","D48","D18",0,0.0384261013671868,26,110,94,16,26,0
"2687","D49","D18",0,0.166239567407229,13,123,107,16,13,0
"2688","D5","D18",0,0.522466034450895,3,133,117,16,3,0
"2689","D50","D18",0,0.602898245770971,2,134,118,16,2,0
"2690","D51","D18",0,0.713993297445649,1,135,119,16,1,0
"2691","D52","D18",0,0.602898245770971,2,134,118,16,2,0
"2692","D53","D18",0.5,0.0908805539668756,2,134,119,15,1,1
"2693","D9","D18",0,0.713993297445649,1,135,119,16,1,0
"2694","RMDQ1_v1","D18",0.116279069767442,0.016715307011663,43,73,66,7,38,5
"2695","RMDQ2_v1","D18",0.170212765957447,0.00297494399683545,47,69,65,4,39,8
"2696","RMDQ3_v1","D18",0.166666666666667,0.194027498199525,36,82,75,7,30,6
"2697","RMDQ4_v1","D18",0.230769230769231,0.0261274221766047,26,92,85,7,20,6
"2698","RMDQ5_v1","D18",0.121212121212121,0.81132786707398,33,85,76,9,29,4
"2699","RMDQ6_v1","D18",0.137931034482759,0.582456953374208,29,89,80,9,25,4
"2700","RMDQ7_v1","D18",0.2,0.164769724203116,20,97,88,9,16,4
"2701","RMDQ8_v1","D18",0.25,0.368444225205557,4,113,101,12,3,1
"2702","RMDQ9_v1","D18",0.166666666666667,0.41488003047373,18,99,89,10,15,3
"2703","RMDQ10_v1","D18",0.227272727272727,0.0543559369541834,22,95,87,8,17,5
"2704","RMDQ11_v1","D18",0.217391304347826,0.0703835877226248,23,94,86,8,18,5
"2705","RMDQ12_v1","D18",0.181818181818182,0.241548993591403,22,95,86,9,18,4
"2706","RMDQ13_v1","D18",0.181818181818182,0.241548993591403,22,95,86,9,18,4
"2707","RMDQ14_v1","D18",0.2,0.110750569792763,25,92,84,8,20,5
"2708","RMDQ15_v1","D18",0.133333333333333,0.769286962232618,15,102,91,11,13,2
"2709","RMDQ16_v1","D18",0.157894736842105,0.478322601755956,19,98,88,10,16,3
"2710","RMDQ17_v1","D18",0.136363636363636,0.675758112096709,22,95,85,10,19,3
"2711","RMDQ18_v1","D18",0.2,0.164769724203116,20,97,88,9,16,4
"2712","RMDQ19_v1","D18",0.125,0.849102045227504,16,101,90,11,14,2
"2713","RMDQ20_v1","D18",0.19047619047619,0.201391507842252,21,96,87,9,17,4
"2714","RMDQ21_v1","D18",0.208333333333333,0.0891521205222315,24,93,85,8,19,5
"2715","RMDQ22_v1","D18",0.15,0.543334595440438,20,97,87,10,17,3
"2716","RMDQ23_v1","D18",0.157894736842105,0.478322601755956,19,98,88,10,16,3
"2717","RMDQ24_v1","D18",0.210526315789474,0.131905158843114,19,98,89,9,15,4
"2718","DN4 - Queimação","D18",0.132075471698113,0.0955215611693831,53,65,62,3,46,7
"2719","DN4 - Sensação de frio dolorosa","D18",0.0833333333333333,0.977792301857777,24,94,86,8,22,2
"2720","DN4 - Choque elétrico","D18",0.138888888888889,0.155465442549244,36,83,78,5,31,5
"2721","DN4 - Formigamento","D18",0.0967741935483871,0.766216056027575,31,88,81,7,28,3
"2722","DN4 - Alfinetada e agulhada","D18",0.166666666666667,0.032370927649448,36,83,79,4,30,6
"2723","DN4 - Adormecimento","D18",0.0303030303030303,0.185796163618726,33,85,76,9,32,1
"2724","DN4 - Coceira","D18",0,0.446435185239397,6,113,103,10,6,0
"2725","DH4 - Hipoestesia ao toque","D18",0.2,0.339612700081032,5,114,105,9,4,1
"2726","DN4 - Hipoestesia a picada de agulha","D18",0.2,0.339612700081032,5,114,105,9,4,1
"2727","DN4 - Escovação","D18",0.25,0.223585207119876,4,115,106,9,3,1
"2728","Fuma","D19",0.0869565217391304,0.229120599446101,46,82,79,3,42,4
"2729","Cirurgia na coluna","D19",0,0.0572747675759925,55,63,59,4,55,0
"2730","Aposentado","D19",0.0645161290322581,0.744241612082321,31,101,96,5,29,2
"2731","Desempregado","D19",0.08,0.519153654398101,25,105,100,5,23,2
"2732","Licenca_Medica","D19",0.0555555555555556,0.95897070656557,18,114,108,6,17,1
"2733","Aposentado_Invalidez","D19",0.125,0.352973574776444,8,123,117,6,7,1
"2734","Analgésicos","D19",0.0568181818181818,0.401559180987227,88,42,41,1,83,5
"2735","OutraDoenca","D19",0.06,0.805872886488264,50,80,76,4,47,3
"2736","Dor nas costas","D19",0.0769230769230769,0.0827110839918079,91,37,37,0,84,7
"2737","Dor nas pernas","D19",0.0545454545454545,0.980281654914855,55,72,68,4,52,3
"2738","Retornar_trabalho","D19",0.15,0.0574394426312504,20,99,95,4,17,3
"2739","Masc","D19",0.0795454545454545,0.0448207879789162,88,48,48,0,81,7
"2740","Fem","D19",0,0.0448207879789162,48,88,81,7,48,0
"2741","Casado/Amasiaado","D19",0.0545454545454545,0.893615907253868,55,81,77,4,52,3
"2742","Solteiro","D19",0.0508474576271186,0.977032998995578,59,77,73,4,56,3
"2743","Separado_Divorciado","D19",0,0.526853490497434,7,129,122,7,7,0
"2744","X4","D19",0.333333333333333,0.0254648673683159,3,133,127,6,2,1
"2745","X5","D19",0,0.739976909027013,2,134,127,7,2,0
"2746","X6","D19",0,0.444085965332051,10,126,119,7,10,0
"2747","Livrar_costas","D19",0.0581395348837209,0.354637665742146,86,14,14,0,81,5
"2748","Livrar_perna","D19",0,0.354637665742146,14,86,81,5,14,0
"2749","Livrar_perda_sens","D19",NA,NA,0,100,95,5,0,0
"2750","D1","D19",0,0.815135138754741,1,135,128,7,1,0
"2751","D15","D19",0,0.526853490497434,7,129,122,7,7,0
"2752","D16","D19",0.05,0.974289740376286,20,116,110,6,19,1
"2753","D17","D19",0.2,0.125637765953246,5,131,125,6,4,1
"2754","D18","D19",0.25,0.000130178269082534,16,120,117,3,12,4
"2755","D19","D19",1,1.99530445797665e-31,7,129,129,0,0,7
"2756","D2","D19",0.25,0.00880417235434038,8,128,123,5,6,2
"2757","D20","D19",0.5,3.25328093603584e-09,8,128,125,3,4,4
"2758","D21","D19",0.571428571428571,1.62941368146417e-10,7,129,126,3,3,4
"2759","D22","D19",1,9.58651296580466e-10,2,134,129,5,0,2
"2760","D23","D19",0,0.739976909027013,2,134,127,7,2,0
"2761","D24","D19",0.153846153846154,0.00861550241929527,26,110,107,3,22,4
"2762","D25","D19",0.5,3.77296235126334e-05,4,132,127,5,2,2
"2763","D26","D19",0.5,0.00382637942754141,2,134,128,6,1,1
"2764","D27","D19",0,0.595606456103754,5,131,124,7,5,0
"2765","D28","D19",0,0.55947835087211,6,130,123,7,6,0
"2766","D29","D19",0.0238095238095238,0.329126521909262,42,94,88,6,41,1
"2767","D3","D19",1,9.58651296580466e-10,2,134,129,5,0,2
"2768","Lombalgia","D19",0.0645161290322581,0.528537006380904,62,74,71,3,58,4
"2769","D31","D19",0,0.30452718874533,17,119,112,7,17,0
"2770","D32","D19",0.027027027027027,0.430286953545862,37,99,93,6,36,1
"2771","D33","D19",0,0.398060116685702,12,124,117,7,12,0
"2772","D34","D19",0,0.683274873050331,3,133,126,7,3,0
"2773","D35","D19",0,0.739976909027013,2,134,127,7,2,0
"2774","D36","D19",0,0.497044882450256,8,128,121,7,8,0
"2775","D37","D19",0.0454545454545455,0.889065179747181,22,114,108,6,21,1
"2776","D38","D19",0,0.683274873050331,3,133,126,7,3,0
"2777","D39","D19",0.0666666666666667,0.777644659047461,15,121,115,6,14,1
"2778","D4","D19",0.5,3.77296235126334e-05,4,132,127,5,2,2
"2779","D40","D19",0,0.595606456103754,5,131,124,7,5,0
"2780","D41","D19",0,0.526853490497434,7,129,122,7,7,0
"2781","D42","D19",0.666666666666667,1.07956281323173e-06,3,133,128,5,1,2
"2782","D43","D19",0.333333333333333,0.0254648673683159,3,133,127,6,2,1
"2783","D44","D19",0,0.0907187714181211,38,98,91,7,38,0
"2784","D45","D19",0,0.398060116685702,12,124,117,7,12,0
"2785","D46","D19",0.0526315789473684,0.969562661066158,38,98,93,5,36,2
"2786","D47","D19",0.0833333333333333,0.600868844205315,12,124,118,6,11,1
"2787","D48","D19",0,0.186591501022522,26,110,103,7,26,0
"2788","D49","D19",0,0.377146151318951,13,123,116,7,13,0
"2789","D5","D19",0,0.683274873050331,3,133,126,7,3,0
"2790","D50","D19",0,0.739976909027013,2,134,127,7,2,0
"2791","D51","D19",0,0.815135138754741,1,135,128,7,1,0
"2792","D52","D19",0,0.739976909027013,2,134,127,7,2,0
"2793","D53","D19",0,0.739976909027013,2,134,127,7,2,0
"2794","D9","D19",0,0.815135138754741,1,135,128,7,1,0
"2795","RMDQ1_v1","D19",0.0465116279069767,0.954717850747826,43,73,69,4,41,2
"2796","RMDQ2_v1","D19",0.0851063829787234,0.393698491458265,47,69,67,2,43,4
"2797","RMDQ3_v1","D19",0.111111111111111,0.0483347215020216,36,82,80,2,32,4
"2798","RMDQ4_v1","D19",0.0384615384615385,0.744741205960005,26,92,87,5,25,1
"2799","RMDQ5_v1","D19",0.0909090909090909,0.217097695700059,33,85,82,3,30,3
"2800","RMDQ6_v1","D19",0.0689655172413793,0.60907649294245,29,89,85,4,27,2
"2801","RMDQ7_v1","D19",0.1,0.277999040548378,20,97,93,4,18,2
"2802","RMDQ8_v1","D19",0,0.636106947053544,4,113,107,6,4,0
"2803","RMDQ9_v1","D19",0.0555555555555556,0.928795596474829,18,99,94,5,17,1
"2804","RMDQ10_v1","D19",0.0909090909090909,0.349709263533331,22,95,91,4,20,2
"2805","RMDQ11_v1","D19",0.0869565217391304,0.386838617744652,23,94,90,4,21,2
"2806","RMDQ12_v1","D19",0.0909090909090909,0.349709263533331,22,95,91,4,20,2
"2807","RMDQ13_v1","D19",0.0454545454545455,0.890617765836712,22,95,90,5,21,1
"2808","RMDQ14_v1","D19",0.08,0.462871352347925,25,92,88,4,23,2
"2809","RMDQ15_v1","D19",0.0666666666666667,0.772338849125788,15,102,97,5,14,1
"2810","RMDQ16_v1","D19",0.0526315789473684,0.976753057814779,19,98,93,5,18,1
"2811","RMDQ17_v1","D19",0.0909090909090909,0.349709263533331,22,95,91,4,20,2
"2812","RMDQ18_v1","D19",0.1,0.277999040548378,20,97,93,4,18,2
"2813","RMDQ19_v1","D19",0.0625,0.826685272526541,16,101,96,5,15,1
"2814","RMDQ20_v1","D19",0.0952380952380952,0.313372258034747,21,96,92,4,19,2
"2815","RMDQ21_v1","D19",0.0833333333333333,0.42460565910448,24,93,89,4,22,2
"2816","RMDQ22_v1","D19",0.1,0.277999040548378,20,97,93,4,18,2
"2817","RMDQ23_v1","D19",0.105263157894737,0.243778720817742,19,98,94,4,17,2
"2818","RMDQ24_v1","D19",0.105263157894737,0.243778720817742,19,98,94,4,17,2
"2819","DN4 - Queimação","D19",0.0754716981132075,0.107020526847558,53,65,64,1,49,4
"2820","DN4 - Sensação de frio dolorosa","D19",0.0416666666666667,0.984647097685877,24,94,90,4,23,1
"2821","DN4 - Choque elétrico","D19",0.111111111111111,0.0133529243945253,36,83,82,1,32,4
"2822","DN4 - Formigamento","D19",0,0.175113197012655,31,88,83,5,31,0
"2823","DN4 - Alfinetada e agulhada","D19",0.0833333333333333,0.139003043752015,36,83,81,2,33,3
"2824","DN4 - Adormecimento","D19",0.0303030303030303,0.685070666079238,33,85,81,4,32,1
"2825","DN4 - Coceira","D19",0.166666666666667,0.11834715083047,6,113,109,4,5,1
"2826","DH4 - Hipoestesia ao toque","D19",0.2,0.0720217504435083,5,114,110,4,4,1
"2827","DN4 - Hipoestesia a picada de agulha","D19",0.2,0.0720217504435083,5,114,110,4,4,1
"2828","DN4 - Escovação","D19",0.25,0.0349379793761989,4,115,111,4,3,1
"2829","Fuma","D2",0.173913043478261,9.6111518125377e-05,46,82,82,0,38,8
"2830","Cirurgia na coluna","D2",0.0545454545454545,0.539659987297388,55,63,61,2,52,3
"2831","Aposentado","D2",0.0645161290322581,0.916926461823846,31,101,95,6,29,2
"2832","Desempregado","D2",0.12,0.175918382739605,25,105,100,5,22,3
"2833","Licenca_Medica","D2",0.111111111111111,0.333881043695306,18,114,108,6,16,2
"2834","Aposentado_Invalidez","D2",0.125,0.435791732583084,8,123,116,7,7,1
"2835","Analgésicos","D2",0.0795454545454545,0.216215774783406,88,42,41,1,81,7
"2836","OutraDoenca","D2",0.08,0.488645167772786,50,80,76,4,46,4
"2837","Dor nas costas","D2",0.0879120879120879,0.0625065347527681,91,37,37,0,83,8
"2838","Dor nas pernas","D2",0.0727272727272727,0.693079342054927,55,72,68,4,51,4
"2839","Retornar_trabalho","D2",0.1,0.521070900456866,20,99,93,6,18,2
"2840","Masc","D2",0.0681818181818182,0.529988878117519,88,48,46,2,82,6
"2841","Fem","D2",0.0416666666666667,0.529988878117519,48,88,82,6,46,2
"2842","Casado/Amasiaado","D2",0.0181818181818182,0.0969443534176441,55,81,74,7,54,1
"2843","Solteiro","D2",0.0677966101694915,0.697056755680715,59,77,73,4,55,4
"2844","Separado_Divorciado","D2",0,0.497044882450256,7,129,121,8,7,0
"2845","X4","D2",0.666666666666667,6.04963738671134e-06,3,133,127,6,1,2
"2846","X5","D2",0,0.721704213787294,2,134,126,8,2,0
"2847","X6","D2",0.1,0.56533213981898,10,126,119,7,9,1
"2848","Livrar_costas","D2",0.0813953488372093,0.268321791516394,86,14,14,0,79,7
"2849","Livrar_perna","D2",0,0.268321791516394,14,86,79,7,14,0
"2850","Livrar_perda_sens","D2",NA,NA,0,100,93,7,0,0
"2851","D1","D2",0,0.801872700366009,1,135,127,8,1,0
"2852","D15","D2",0.142857142857143,0.331942004087524,7,129,122,7,6,1
"2853","D16","D2",0.05,0.855906204792587,20,116,109,7,19,1
"2854","D17","D2",0.2,0.171623781856835,5,131,124,7,4,1
"2855","D18","D2",0.25,0.000540397683510625,16,120,116,4,12,4
"2856","D19","D2",0.285714285714286,0.00880417235434038,7,129,123,6,5,2
"2857","D2","D2",1,1.99530445797665e-31,8,128,128,0,0,8
"2858","D20","D2",0.125,0.412228871095719,8,128,121,7,7,1
"2859","D21","D2",0.142857142857143,0.331942004087524,7,129,122,7,6,1
"2860","D22","D2",0,0.721704213787294,2,134,126,8,2,0
"2861","D23","D2",0,0.721704213787294,2,134,126,8,2,0
"2862","D24","D2",0.115384615384615,0.172911591990018,26,110,105,5,23,3
"2863","D25","D2",0,0.611790554856623,4,132,124,8,4,0
"2864","D26","D2",0,0.721704213787294,2,134,126,8,2,0
"2865","D27","D2",0,0.568958961171041,5,131,123,8,5,0
"2866","D28","D2",0.166666666666667,0.25084530450745,6,130,123,7,5,1
"2867","D29","D2",0.0238095238095238,0.246045641215853,42,94,87,7,41,1
"2868","D3","D2",1,1.20573574480081e-08,2,134,128,6,0,2
"2869","Lombalgia","D2",0.032258064516129,0.228129672633251,62,74,68,6,60,2
"2870","D31","D2",0.0588235294117647,1,17,119,112,7,16,1
"2871","D32","D2",0,0.0746923495739824,37,99,91,8,37,0
"2872","D33","D2",0,0.364426724716409,12,124,116,8,12,0
"2873","D34","D2",0.666666666666667,6.04963738671134e-06,3,133,127,6,1,2
"2874","D35","D2",0.5,0.00755433235506732,2,134,127,7,1,1
"2875","D36","D2",0,0.466081807166599,8,128,120,8,8,0
"2876","D37","D2",0.0454545454545455,0.770988426241838,22,114,107,7,21,1
"2877","D38","D2",0,0.66148119738657,3,133,125,8,3,0
"2878","D39","D2",0,0.304652117988235,15,121,113,8,15,0
"2879","D4","D2",0.75,2.4711706269955e-09,4,132,127,5,1,3
"2880","D40","D2",0,0.568958961171041,5,131,123,8,5,0
"2881","D41","D2",0,0.497044882450256,7,129,121,8,7,0
"2882","D42","D2",0,0.66148119738657,3,133,125,8,3,0
"2883","D43","D2",0.333333333333333,0.0410139457284451,3,133,126,7,2,1
"2884","D44","D2",0.0263157894736842,0.315723814596718,38,98,91,7,37,1
"2885","D45","D2",0.0833333333333333,0.705504165117011,12,124,117,7,11,1
"2886","D46","D2",0.0526315789473684,0.84844589248364,38,98,92,6,36,2
"2887","D47","D2",0.166666666666667,0.096359635700202,12,124,118,6,10,2
"2888","D48","D2",0.0384615384615385,0.623676291683334,26,110,103,7,25,1
"2889","D49","D2",0.0769230769230769,0.770562847497233,13,123,116,7,12,1
"2890","D5","D2",1,2.45394149904231e-12,3,133,128,5,0,3
"2891","D50","D2",0.5,0.00755433235506732,2,134,127,7,1,1
"2892","D51","D2",1,5.94993819266424e-05,1,135,128,7,0,1
"2893","D52","D2",0,0.721704213787294,2,134,126,8,2,0
"2894","D53","D2",0.5,0.00755433235506732,2,134,127,7,1,1
"2895","D9","D2",1,5.94993819266424e-05,1,135,128,7,0,1
"2896","RMDQ1_v1","D2",0.0697674418604651,0.963330714118888,43,73,68,5,40,3
"2897","RMDQ2_v1","D2",0.0851063829787234,0.819883619597099,47,69,65,4,43,4
"2898","RMDQ3_v1","D2",0.0833333333333333,0.656449010120284,36,82,77,5,33,3
"2899","RMDQ4_v1","D2",0.0384615384615385,0.500408304194632,26,92,85,7,25,1
"2900","RMDQ5_v1","D2",0.0909090909090909,0.533767282950704,33,85,80,5,30,3
"2901","RMDQ6_v1","D2",0.103448275862069,0.379207441847455,29,89,84,5,26,3
"2902","RMDQ7_v1","D2",0.2,0.0104238620744466,20,97,93,4,16,4
"2903","RMDQ8_v1","D2",0.25,0.143061967523735,4,113,106,7,3,1
"2904","RMDQ9_v1","D2",0.166666666666667,0.0724650214267889,18,99,94,5,15,3
"2905","RMDQ10_v1","D2",0.136363636363636,0.160865525892034,22,95,90,5,19,3
"2906","RMDQ11_v1","D2",0.130434782608696,0.188308893144328,23,94,89,5,20,3
"2907","RMDQ12_v1","D2",0.136363636363636,0.160865525892034,22,95,90,5,19,3
"2908","RMDQ13_v1","D2",0.136363636363636,0.160865525892034,22,95,90,5,19,3
"2909","RMDQ14_v1","D2",0.12,0.248781358310119,25,92,87,5,22,3
"2910","RMDQ15_v1","D2",0.133333333333333,0.285717336283617,15,102,96,6,13,2
"2911","RMDQ16_v1","D2",0.157894736842105,0.0911685513036505,19,98,93,5,16,3
"2912","RMDQ17_v1","D2",0.0909090909090909,0.642133382304007,22,95,89,6,20,2
"2913","RMDQ18_v1","D2",0.1,0.538283058858107,20,97,91,6,18,2
"2914","RMDQ19_v1","D2",0.125,0.334107901877522,16,101,95,6,14,2
"2915","RMDQ20_v1","D2",0.142857142857143,0.135454549151766,21,96,91,5,18,3
"2916","RMDQ21_v1","D2",0.125,0.217658768652099,24,93,88,5,21,3
"2917","RMDQ22_v1","D2",0.1,0.538283058858107,20,97,91,6,18,2
"2918","RMDQ23_v1","D2",0.105263157894737,0.486379185682309,19,98,92,6,17,2
"2919","RMDQ24_v1","D2",0.157894736842105,0.0911685513036505,19,98,93,5,16,3
"2920","DN4 - Queimação","D2",0.113207547169811,0.0252527584039801,53,65,64,1,47,6
"2921","DN4 - Sensação de frio dolorosa","D2",0.0416666666666667,0.681634787454959,24,94,88,6,23,1
"2922","DN4 - Choque elétrico","D2",0.138888888888889,0.014498692935062,36,83,81,2,31,5
"2923","DN4 - Formigamento","D2",0.0967741935483871,0.296351034805344,31,88,84,4,28,3
"2924","DN4 - Alfinetada e agulhada","D2",0.138888888888889,0.014498692935062,36,83,81,2,31,5
"2925","DN4 - Adormecimento","D2",0.0606060606060606,0.970652158540852,33,85,80,5,31,2
"2926","DN4 - Coceira","D2",0.333333333333333,0.0033610855800127,6,113,108,5,4,2
"2927","DH4 - Hipoestesia ao toque","D2",0.4,0.000924203167710576,5,114,109,5,3,2
"2928","DN4 - Hipoestesia a picada de agulha","D2",0.4,0.000924203167710576,5,114,109,5,3,2
"2929","DN4 - Escovação","D2",0.5,0.000136370593411503,4,115,110,5,2,2
"2930","Fuma","D20",0.0652173913043478,0.924214003182506,46,82,77,5,43,3
"2931","Cirurgia na coluna","D20",0.0181818181818182,0.131253173863049,55,63,58,5,54,1
"2932","Aposentado","D20",0.0645161290322581,0.916926461823846,31,101,95,6,29,2
"2933","Desempregado","D20",0.08,0.669088834458672,25,105,99,6,23,2
"2934","Licenca_Medica","D20",0.111111111111111,0.333881043695306,18,114,108,6,16,2
"2935","Aposentado_Invalidez","D20",0.125,0.435791732583084,8,123,116,7,7,1
"2936","Analgésicos","D20",0.0681818181818182,0.29454223267992,88,42,41,1,82,6
"2937","OutraDoenca","D20",0.04,0.419161860625561,50,80,74,6,48,2
"2938","Dor nas costas","D20",0.0879120879120879,0.0625065347527681,91,37,37,0,83,8
"2939","Dor nas pernas","D20",0.0363636363636364,0.280335999058053,55,72,66,6,53,2
"2940","Retornar_trabalho","D20",0.15,0.105083597731138,20,99,94,5,17,3
"2941","Masc","D20",0.0568181818181818,0.892946837110376,88,48,45,3,83,5
"2942","Fem","D20",0.0625,0.892946837110376,48,88,83,5,45,3
"2943","Casado/Amasiaado","D20",0.0727272727272727,0.570140971181601,55,81,77,4,51,4
"2944","Solteiro","D20",0.0677966101694915,0.697056755680715,59,77,73,4,55,4
"2945","Separado_Divorciado","D20",0,0.497044882450256,7,129,121,8,7,0
"2946","X4","D20",0,0.66148119738657,3,133,125,8,3,0
"2947","X5","D20",0,0.721704213787294,2,134,126,8,2,0
"2948","X6","D20",0,0.411451319476889,10,126,118,8,10,0
"2949","Livrar_costas","D20",0.0813953488372093,0.268321791516394,86,14,14,0,79,7
"2950","Livrar_perna","D20",0,0.268321791516394,14,86,79,7,14,0
"2951","Livrar_perda_sens","D20",NA,NA,0,100,93,7,0,0
"2952","D1","D20",0,0.801872700366009,1,135,127,8,1,0
"2953","D15","D20",0,0.497044882450256,7,129,121,8,7,0
"2954","D16","D20",0,0.226054306034848,20,116,108,8,20,0
"2955","D17","D20",0,0.568958961171041,5,131,123,8,5,0
"2956","D18","D20",0.3125,4.41112891277472e-06,16,120,117,3,11,5
"2957","D19","D20",0.571428571428571,3.25328093603584e-09,7,129,125,4,3,4
"2958","D2","D20",0.125,0.412228871095719,8,128,121,7,7,1
"2959","D20","D20",1,1.99530445797665e-31,8,128,128,0,0,8
"2960","D21","D20",0.571428571428571,3.25328093603584e-09,7,129,125,4,3,4
"2961","D22","D20",1,1.20573574480081e-08,2,134,128,6,0,2
"2962","D23","D20",0,0.721704213787294,2,134,126,8,2,0
"2963","D24","D20",0.153846153846154,0.0220395842889348,26,110,106,4,22,4
"2964","D25","D20",0.5,0.000141007605342292,4,132,126,6,2,2
"2965","D26","D20",0.5,0.00755433235506732,2,134,127,7,1,1
"2966","D27","D20",0,0.568958961171041,5,131,123,8,5,0
"2967","D28","D20",0.166666666666667,0.25084530450745,6,130,123,7,5,1
"2968","D29","D20",0.0238095238095238,0.246045641215853,42,94,87,7,41,1
"2969","D3","D20",0,0.721704213787294,2,134,126,8,2,0
"2970","Lombalgia","D20",0.0806451612903226,0.322184815759104,62,74,71,3,57,5
"2971","D31","D20",0,0.270485005102042,17,119,111,8,17,0
"2972","D32","D20",0,0.0746923495739824,37,99,91,8,37,0
"2973","D33","D20",0,0.364426724716409,12,124,116,8,12,0
"2974","D34","D20",0,0.66148119738657,3,133,125,8,3,0
"2975","D35","D20",0,0.721704213787294,2,134,126,8,2,0
"2976","D36","D20",0,0.466081807166599,8,128,120,8,8,0
"2977","D37","D20",0,0.200277333185376,22,114,106,8,22,0
"2978","D38","D20",0,0.66148119738657,3,133,125,8,3,0
"2979","D39","D20",0,0.304652117988235,15,121,113,8,15,0
"2980","D4","D20",0,0.611790554856623,4,132,124,8,4,0
"2981","D40","D20",0,0.568958961171041,5,131,123,8,5,0
"2982","D41","D20",0,0.497044882450256,7,129,121,8,7,0
"2983","D42","D20",0.666666666666667,6.04963738671134e-06,3,133,127,6,1,2
"2984","D43","D20",0.666666666666667,6.04963738671134e-06,3,133,127,6,1,2
"2985","D44","D20",0,0.0694522599947637,38,98,90,8,38,0
"2986","D45","D20",0,0.364426724716409,12,124,116,8,12,0
"2987","D46","D20",0,0.0694522599947637,38,98,90,8,38,0
"2988","D47","D20",0,0.364426724716409,12,124,116,8,12,0
"2989","D48","D20",0,0.156358988235655,26,110,102,8,26,0
"2990","D49","D20",0,0.343218080309131,13,123,115,8,13,0
"2991","D5","D20",0,0.66148119738657,3,133,125,8,3,0
"2992","D50","D20",0,0.721704213787294,2,134,126,8,2,0
"2993","D51","D20",0,0.801872700366009,1,135,127,8,1,0
"2994","D52","D20",0,0.721704213787294,2,134,126,8,2,0
"2995","D53","D20",0.5,0.00755433235506732,2,134,127,7,1,1
"2996","D9","D20",0,0.801872700366009,1,135,127,8,1,0
"2997","RMDQ1_v1","D20",0.0697674418604651,0.000296752146878429,43,73,70,3,40,3
"2998","RMDQ2_v1","D20",0.0851063829787234,0.000165330320094573,47,69,67,2,43,4
"2999","RMDQ3_v1","D20",0.0833333333333333,0.464413990014066,36,82,78,4,33,3
"3000","RMDQ4_v1","D20",0.115384615384615,0.17053155106964,26,92,88,4,23,3
"3001","RMDQ5_v1","D20",0.0303030303030303,0.405712579214709,33,85,79,6,32,1
"3002","RMDQ6_v1","D20",0.0689655172413793,0.8001646885775,29,89,84,5,27,2
"3003","RMDQ7_v1","D20",0.05,0.838703911858419,20,97,91,6,19,1
"3004","RMDQ8_v1","D20",0,0.607687652229803,4,113,106,7,4,0
"3005","RMDQ9_v1","D20",0.0555555555555556,0.933766669511119,18,99,93,6,17,1
"3006","RMDQ10_v1","D20",0.0909090909090909,0.495159471383125,22,95,90,5,20,2
"3007","RMDQ11_v1","D20",0.0869565217391304,0.540545998072804,23,94,89,5,21,2
"3008","RMDQ12_v1","D20",0.0909090909090909,0.495159471383125,22,95,90,5,20,2
"3009","RMDQ13_v1","D20",0.0454545454545455,0.752394853272729,22,95,89,6,21,1
"3010","RMDQ14_v1","D20",0.08,0.631546019495452,25,92,87,5,23,2
"3011","RMDQ15_v1","D20",0,0.295383708358243,15,102,95,7,15,0
"3012","RMDQ16_v1","D20",0.0526315789473684,0.88507678924591,19,98,92,6,18,1
"3013","RMDQ17_v1","D20",0.0454545454545455,0.752394853272729,22,95,89,6,21,1
"3014","RMDQ18_v1","D20",0.05,0.838703911858419,20,97,91,6,19,1
"3015","RMDQ19_v1","D20",0,0.277462300625661,16,101,94,7,16,0
"3016","RMDQ20_v1","D20",0.0952380952380952,0.450066836690652,21,96,91,5,19,2
"3017","RMDQ21_v1","D20",0.0833333333333333,0.586057318067706,24,93,88,5,22,2
"3018","RMDQ22_v1","D20",0.05,0.838703911858419,20,97,91,6,19,1
"3019","RMDQ23_v1","D20",0.0526315789473684,0.88507678924591,19,98,92,6,18,1
"3020","RMDQ24_v1","D20",0.105263157894737,0.36156501382498,19,98,93,5,17,2
"3021","DN4 - Queimação","D20",0.0377358490566038,0.821358502889077,53,65,62,3,51,2
"3022","DN4 - Sensação de frio dolorosa","D20",0.0416666666666667,0.984647097685877,24,94,90,4,23,1
"3023","DN4 - Choque elétrico","D20",0.0555555555555556,0.627809401675126,36,83,80,3,34,2
"3024","DN4 - Formigamento","D20",0.032258064516129,0.752813516034861,31,88,84,4,30,1
"3025","DN4 - Alfinetada e agulhada","D20",0.0555555555555556,0.627809401675126,36,83,80,3,34,2
"3026","DN4 - Adormecimento","D20",0.0606060606060606,0.540111281186488,33,85,82,3,31,2
"3027","DN4 - Coceira","D20",0.166666666666667,0.11834715083047,6,113,109,4,5,1
"3028","DH4 - Hipoestesia ao toque","D20",0.2,0.0720217504435083,5,114,110,4,4,1
"3029","DN4 - Hipoestesia a picada de agulha","D20",0.2,0.0720217504435083,5,114,110,4,4,1
"3030","DN4 - Escovação","D20",0.25,0.0349379793761989,4,115,111,4,3,1
"3031","Fuma","D21",0.0434782608695652,0.676126454476383,46,82,77,5,44,2
"3032","Cirurgia na coluna","D21",0,0.0327610202654722,55,63,58,5,55,0
"3033","Aposentado","D21",0.0645161290322581,0.744241612082321,31,101,96,5,29,2
"3034","Desempregado","D21",0.04,0.732888589755174,25,105,99,6,24,1
"3035","Licenca_Medica","D21",0.0555555555555556,0.95897070656557,18,114,108,6,17,1
"3036","Aposentado_Invalidez","D21",0,0.487975992982874,8,123,116,7,8,0
"3037","Analgésicos","D21",0.0681818181818182,0.29454223267992,88,42,41,1,82,6
"3038","OutraDoenca","D21",0.02,0.17648876461611,50,80,74,6,49,1
"3039","Dor nas costas","D21",0.0769230769230769,0.0827110839918079,91,37,37,0,84,7
"3040","Dor nas pernas","D21",0.0363636363636364,0.418260753637334,55,72,67,5,53,2
"3041","Retornar_trabalho","D21",0.1,0.390868853825774,20,99,94,5,18,2
"3042","Masc","D21",0.0568181818181818,0.702343753340064,88,48,46,2,83,5
"3043","Fem","D21",0.0416666666666667,0.702343753340064,48,88,83,5,46,2
"3044","Casado/Amasiaado","D21",0.0909090909090909,0.0863020701366355,55,81,79,2,50,5
"3045","Solteiro","D21",0.0338983050847458,0.416880359309015,59,77,72,5,57,2
"3046","Separado_Divorciado","D21",0,0.526853490497434,7,129,122,7,7,0
"3047","X4","D21",0,0.683274873050331,3,133,126,7,3,0
"3048","X5","D21",0,0.739976909027013,2,134,127,7,2,0
"3049","X6","D21",0,0.444085965332051,10,126,119,7,10,0
"3050","Livrar_costas","D21",0.0813953488372093,0.268321791516394,86,14,14,0,79,7
"3051","Livrar_perna","D21",0,0.268321791516394,14,86,79,7,14,0
"3052","Livrar_perda_sens","D21",NA,NA,0,100,93,7,0,0
"3053","D1","D21",0,0.815135138754741,1,135,128,7,1,0
"3054","D15","D21",0,0.526853490497434,7,129,122,7,7,0
"3055","D16","D21",0.05,0.974289740376286,20,116,110,6,19,1
"3056","D17","D21",0.2,0.125637765953246,5,131,125,6,4,1
"3057","D18","D21",0.1875,0.00875176992011601,16,120,116,4,13,3
"3058","D19","D21",0.571428571428571,1.62941368146417e-10,7,129,126,3,3,4
"3059","D2","D21",0.125,0.331942004087524,8,128,122,6,7,1
"3060","D20","D21",0.5,3.25328093603584e-09,8,128,125,3,4,4
"3061","D21","D21",1,1.99530445797665e-31,7,129,129,0,0,7
"3062","D22","D21",0.5,0.00382637942754141,2,134,128,6,1,1
"3063","D23","D21",0,0.739976909027013,2,134,127,7,2,0
"3064","D24","D21",0.115384615384615,0.100999550305803,26,110,106,4,23,3
"3065","D25","D21",0.5,3.77296235126334e-05,4,132,127,5,2,2
"3066","D26","D21",0.5,0.00382637942754141,2,134,128,6,1,1
"3067","D27","D21",0,0.595606456103754,5,131,124,7,5,0
"3068","D28","D21",0.166666666666667,0.19148818093848,6,130,124,6,5,1
"3069","D29","D21",0.0238095238095238,0.329126521909262,42,94,88,6,41,1
"3070","D3","D21",0,0.739976909027013,2,134,127,7,2,0
"3071","Lombalgia","D21",0.0806451612903226,0.158702812311957,62,74,72,2,57,5
"3072","D31","D21",0,0.30452718874533,17,119,112,7,17,0
"3073","D32","D21",0.027027027027027,0.430286953545862,37,99,93,6,36,1
"3074","D33","D21",0.166666666666667,0.0585717946693723,12,124,119,5,10,2
"3075","D34","D21",0,0.683274873050331,3,133,126,7,3,0
"3076","D35","D21",0,0.739976909027013,2,134,127,7,2,0
"3077","D36","D21",0,0.497044882450256,8,128,121,7,8,0
"3078","D37","D21",0.0454545454545455,0.889065179747181,22,114,108,6,21,1
"3079","D38","D21",0,0.683274873050331,3,133,126,7,3,0
"3080","D39","D21",0.0666666666666667,0.777644659047461,15,121,115,6,14,1
"3081","D4","D21",0,0.63628659530033,4,132,125,7,4,0
"3082","D40","D21",0,0.595606456103754,5,131,124,7,5,0
"3083","D41","D21",0,0.526853490497434,7,129,122,7,7,0
"3084","D42","D21",0.333333333333333,0.0254648673683159,3,133,127,6,2,1
"3085","D43","D21",0.666666666666667,1.07956281323173e-06,3,133,128,5,1,2
"3086","D44","D21",0,0.0907187714181211,38,98,91,7,38,0
"3087","D45","D21",0,0.398060116685702,12,124,117,7,12,0
"3088","D46","D21",0.0263157894736842,0.408389684189003,38,98,92,6,37,1
"3089","D47","D21",0,0.398060116685702,12,124,117,7,12,0
"3090","D48","D21",0,0.186591501022522,26,110,103,7,26,0
"3091","D49","D21",0.153846153846154,0.0789811536453963,13,123,118,5,11,2
"3092","D5","D21",0,0.683274873050331,3,133,126,7,3,0
"3093","D50","D21",0,0.739976909027013,2,134,127,7,2,0
"3094","D51","D21",0,0.815135138754741,1,135,128,7,1,0
"3095","D52","D21",0,0.739976909027013,2,134,127,7,2,0
"3096","D53","D21",0.5,0.00382637942754141,2,134,128,6,1,1
"3097","D9","D21",0,0.815135138754741,1,135,128,7,1,0
"3098","RMDQ1_v1","D21",0.0697674418604651,0.917577367895651,43,73,69,4,40,3
"3099","RMDQ2_v1","D21",0.106382978723404,0.21854888010462,47,69,67,2,42,5
"3100","RMDQ3_v1","D21",0.0833333333333333,0.464413990014066,36,82,78,4,33,3
"3101","RMDQ4_v1","D21",0.0769230769230769,0.666997373764384,26,92,87,5,24,2
"3102","RMDQ5_v1","D21",0.0606060606060606,0.970652158540852,33,85,80,5,31,2
"3103","RMDQ6_v1","D21",0.0689655172413793,0.8001646885775,29,89,84,5,27,2
"3104","RMDQ7_v1","D21",0.1,0.405461680142142,20,97,92,5,18,2
"3105","RMDQ8_v1","D21",0,0.607687652229803,4,113,106,7,4,0
"3106","RMDQ9_v1","D21",0.0555555555555556,0.933766669511119,18,99,93,6,17,1
"3107","RMDQ10_v1","D21",0.136363636363636,0.0930089772607866,22,95,91,4,19,3
"3108","RMDQ11_v1","D21",0.0869565217391304,0.540545998072804,23,94,89,5,21,2
"3109","RMDQ12_v1","D21",0.0909090909090909,0.495159471383125,22,95,90,5,20,2
"3110","RMDQ13_v1","D21",0.0454545454545455,0.752394853272729,22,95,89,6,21,1
"3111","RMDQ14_v1","D21",0.08,0.631546019495452,25,92,87,5,23,2
"3112","RMDQ15_v1","D21",0,0.295383708358243,15,102,95,7,15,0
"3113","RMDQ16_v1","D21",0.0526315789473684,0.88507678924591,19,98,92,6,18,1
"3114","RMDQ17_v1","D21",0.0454545454545455,0.752394853272729,22,95,89,6,21,1
"3115","RMDQ18_v1","D21",0.05,0.838703911858419,20,97,91,6,19,1
"3116","RMDQ19_v1","D21",0,0.277462300625661,16,101,94,7,16,0
"3117","RMDQ20_v1","D21",0.0952380952380952,0.450066836690652,21,96,91,5,19,2
"3118","RMDQ21_v1","D21",0.0833333333333333,0.586057318067706,24,93,88,5,22,2
"3119","RMDQ22_v1","D21",0.05,0.838703911858419,20,97,91,6,19,1
"3120","RMDQ23_v1","D21",0.105263157894737,0.36156501382498,19,98,93,5,17,2
"3121","RMDQ24_v1","D21",0.105263157894737,0.36156501382498,19,98,93,5,17,2
"3122","DN4 - Queimação","D21",0.0566037735849057,0.488330641908803,53,65,63,2,50,3
"3123","DN4 - Sensação de frio dolorosa","D21",0.0833333333333333,0.264377007831233,24,94,91,3,22,2
"3124","DN4 - Choque elétrico","D21",0.0833333333333333,0.139003043752015,36,83,81,2,33,3
"3125","DN4 - Formigamento","D21",0.0645161290322581,0.467782054809843,31,88,85,3,29,2
"3126","DN4 - Alfinetada e agulhada","D21",0.0555555555555556,0.627809401675126,36,83,80,3,34,2
"3127","DN4 - Adormecimento","D21",0.0303030303030303,0.685070666079238,33,85,81,4,32,1
"3128","DN4 - Coceira","D21",0.166666666666667,0.11834715083047,6,113,109,4,5,1
"3129","DH4 - Hipoestesia ao toque","D21",0,0.632328327021753,5,114,109,5,5,0
"3130","DN4 - Hipoestesia a picada de agulha","D21",0,0.632328327021753,5,114,109,5,5,0
"3131","DN4 - Escovação","D21",0,0.670052424301302,4,115,110,5,4,0
"3132","Fuma","D22",0.0217391304347826,0.676126454476383,46,82,81,1,45,1
"3133","Cirurgia na coluna","D22",0,0.348070916478987,55,63,62,1,55,0
"3134","Aposentado","D22",0.032258064516129,0.372732044491854,31,101,100,1,30,1
"3135","Desempregado","D22",0.04,0.265838463903265,25,105,104,1,24,1
"3136","Licenca_Medica","D22",0.0555555555555556,0.131038190578192,18,114,113,1,17,1
"3137","Aposentado_Invalidez","D22",0,0.71626653488051,8,123,121,2,8,0
"3138","Analgésicos","D22",0.0113636363636364,0.487982136848066,88,42,42,0,87,1
"3139","OutraDoenca","D22",0,0.259854635493349,50,80,78,2,50,0
"3140","Dor nas costas","D22",0.021978021978022,0.363404269902099,91,37,37,0,89,2
"3141","Dor nas pernas","D22",0,0.212807680324934,55,72,70,2,55,0
"3142","Retornar_trabalho","D22",0.05,0.205485590404682,20,99,98,1,19,1
"3143","Masc","D22",0.0227272727272727,0.292693309963762,88,48,48,0,86,2
"3144","Fem","D22",0,0.292693309963762,48,88,86,2,48,0
"3145","Casado/Amasiaado","D22",0.0363636363636364,0.0838103603534032,55,81,81,0,53,2
"3146","Solteiro","D22",0,0.212348813642373,59,77,75,2,59,0
"3147","Separado_Divorciado","D22",0,0.739976909027013,7,129,127,2,7,0
"3148","X4","D22",0,0.830565083280277,3,133,131,2,3,0
"3149","X5","D22",0,0.861819671758601,2,134,132,2,2,0
"3150","X6","D22",0,0.688146459888278,10,126,124,2,10,0
"3151","Livrar_costas","D22",0.0116279069767442,0.685105670480977,86,14,14,0,85,1
"3152","Livrar_perna","D22",0,0.685105670480977,14,86,85,1,14,0
"3153","Livrar_perda_sens","D22",NA,NA,0,100,99,1,0,0
"3154","D1","D22",0,0.902407153906854,1,135,133,2,1,0
"3155","D15","D22",0,0.739976909027013,7,129,127,2,7,0
"3156","D16","D22",0,0.554127697484356,20,116,114,2,20,0
"3157","D17","D22",0,0.780748527710185,5,131,129,2,5,0
"3158","D18","D22",0.125,9.54882562575112e-05,16,120,120,0,14,2
"3159","D19","D22",0.285714285714286,9.58651296580466e-10,7,129,129,0,5,2
"3160","D2","D22",0,0.721704213787294,8,128,126,2,8,0
"3161","D20","D22",0.25,1.20573574480081e-08,8,128,128,0,6,2
"3162","D21","D22",0.142857142857143,0.00382637942754141,7,129,128,1,6,1
"3163","D22","D22",1,1.99530445797663e-31,2,134,134,0,0,2
"3164","D23","D22",0,0.861819671758601,2,134,132,2,2,0
"3165","D24","D22",0,0.488520668794022,26,110,108,2,26,0
"3166","D25","D22",0,0.804124066880639,4,132,130,2,4,0
"3167","D26","D22",0.5,9.25079971216983e-09,2,134,133,1,1,1
"3168","D27","D22",0,0.780748527710185,5,131,129,2,5,0
"3169","D28","D22",0,0.759543172318368,6,130,128,2,6,0
"3170","D29","D22",0,0.340923749246409,42,94,92,2,42,0
"3171","D3","D22",0,0.861819671758601,2,134,132,2,2,0
"3172","Lombalgia","D22",0.0161290322580645,0.899570795089937,62,74,73,1,61,1
"3173","D31","D22",0,0.590234194210651,17,119,117,2,17,0
"3174","D32","D22",0,0.383757260247278,37,99,97,2,37,0
"3175","D33","D22",0,0.657612161666932,12,124,122,2,12,0
"3176","D34","D22",0,0.830565083280277,3,133,131,2,3,0
"3177","D35","D22",0,0.861819671758601,2,134,132,2,2,0
"3178","D36","D22",0,0.721704213787294,8,128,126,2,8,0
"3179","D37","D22",0,0.531393754170243,22,114,112,2,22,0
"3180","D38","D22",0,0.830565083280277,3,133,131,2,3,0
"3181","D39","D22",0,0.615926597177117,15,121,119,2,15,0
"3182","D4","D22",0,0.804124066880639,4,132,130,2,4,0
"3183","D40","D22",0,0.780748527710185,5,131,129,2,5,0
"3184","D41","D22",0,0.739976909027013,7,129,127,2,7,0
"3185","D42","D22",0.666666666666667,2.39360797585802e-21,3,133,133,0,1,2
"3186","D43","D22",0.333333333333333,3.54931258649229e-06,3,133,132,1,2,1
"3187","D44","D22",0,0.374983020515037,38,98,96,2,38,0
"3188","D45","D22",0,0.657612161666932,12,124,122,2,12,0
"3189","D46","D22",0,0.374983020515037,38,98,96,2,38,0
"3190","D47","D22",0,0.657612161666932,12,124,122,2,12,0
"3191","D48","D22",0,0.488520668794022,26,110,108,2,26,0
"3192","D49","D22",0,0.643234299777126,13,123,121,2,13,0
"3193","D5","D22",0,0.830565083280277,3,133,131,2,3,0
"3194","D50","D22",0,0.861819671758601,2,134,132,2,2,0
"3195","D51","D22",0,0.902407153906854,1,135,133,2,1,0
"3196","D52","D22",0,0.861819671758601,2,134,132,2,2,0
"3197","D53","D22",0,0.861819671758601,2,134,132,2,2,0
"3198","D9","D22",0,0.902407153906854,1,135,133,2,1,0
"3199","RMDQ1_v1","D22",0,0.737884567605411,43,73,72,1,43,0
"3200","RMDQ2_v1","D22",0.0212765957446809,0.471846992882068,47,69,69,0,46,1
"3201","RMDQ3_v1","D22",0.0277777777777778,0.1296036170137,36,82,82,0,35,1
"3202","RMDQ4_v1","D22",0.0384615384615385,0.0588782180805536,26,92,92,0,25,1
"3203","RMDQ5_v1","D22",0.0303030303030303,0.107014020238433,33,85,85,0,32,1
"3204","RMDQ6_v1","D22",0.0344827586206897,0.0785236958912466,29,89,89,0,28,1
"3205","RMDQ7_v1","D22",0,0.648368667298824,20,97,96,1,20,0
"3206","RMDQ8_v1","D22",0,0.850129340451501,4,113,112,1,4,0
"3207","RMDQ9_v1","D22",0,0.668479726871623,18,99,98,1,18,0
"3208","RMDQ10_v1","D22",0.0454545454545455,0.0368916317321308,22,95,95,0,21,1
"3209","RMDQ11_v1","D22",0.0434782608695652,0.0423242826421271,23,94,94,0,22,1
"3210","RMDQ12_v1","D22",0.0454545454545455,0.0368916317321308,22,95,95,0,21,1
"3211","RMDQ13_v1","D22",0,0.628885363875848,22,95,94,1,22,0
"3212","RMDQ14_v1","D22",0.04,0.0540315515408075,25,92,92,0,24,1
"3213","RMDQ15_v1","D22",0,0.700139702762516,15,102,101,1,15,0
"3214","RMDQ16_v1","D22",0,0.658337884368623,19,98,97,1,19,0
"3215","RMDQ17_v1","D22",0.0454545454545455,0.0368916317321308,22,95,95,0,21,1
"3216","RMDQ18_v1","D22",0.05,0.0269843768229582,20,97,97,0,19,1
"3217","RMDQ19_v1","D22",0,0.689357768311308,16,101,100,1,16,0
"3218","RMDQ20_v1","D22",0.0476190476190476,0.0317705146451596,21,96,96,0,20,1
"3219","RMDQ21_v1","D22",0.0416666666666667,0.0480451702617448,24,93,93,0,23,1
"3220","RMDQ22_v1","D22",0.05,0.0269843768229582,20,97,97,0,19,1
"3221","RMDQ23_v1","D22",0.0526315789473684,0.0225562523721356,19,98,98,0,18,1
"3222","RMDQ24_v1","D22",0.0526315789473684,0.0225562523721356,19,98,98,0,18,1
"3223","DN4 - Queimação","D22",0,NA,53,65,65,0,53,0
"3224","DN4 - Sensação de frio dolorosa","D22",0,NA,24,94,94,0,24,0
"3225","DN4 - Choque elétrico","D22",0,NA,36,83,83,0,36,0
"3226","DN4 - Formigamento","D22",0,NA,31,88,88,0,31,0
"3227","DN4 - Alfinetada e agulhada","D22",0,NA,36,83,83,0,36,0
"3228","DN4 - Adormecimento","D22",0,NA,33,85,85,0,33,0
"3229","DN4 - Coceira","D22",0,NA,6,113,113,0,6,0
"3230","DH4 - Hipoestesia ao toque","D22",0,NA,5,114,114,0,5,0
"3231","DN4 - Hipoestesia a picada de agulha","D22",0,NA,5,114,114,0,5,0
"3232","DN4 - Escovação","D22",0,NA,4,115,115,0,4,0
"3233","Fuma","D23",0,0.452095549051344,46,82,81,1,46,0
"3234","Cirurgia na coluna","D23",0.0181818181818182,0.922786031527084,55,63,62,1,54,1
"3235","Aposentado","D23",0.032258064516129,0.372732044491854,31,101,100,1,30,1
"3236","Desempregado","D23",0.04,0.265838463903265,25,105,104,1,24,1
"3237","Licenca_Medica","D23",0,0.571218616780325,18,114,112,2,18,0
"3238","Aposentado_Invalidez","D23",0,0.71626653488051,8,123,121,2,8,0
"3239","Analgésicos","D23",0.0227272727272727,0.324814833547299,88,42,42,0,86,2
"3240","OutraDoenca","D23",0,0.259854635493349,50,80,78,2,50,0
"3241","Dor nas costas","D23",0.021978021978022,0.363404269902099,91,37,37,0,89,2
"3242","Dor nas pernas","D23",0.0181818181818182,0.847314996250213,55,72,71,1,54,1
"3243","Retornar_trabalho","D23",0.05,0.205485590404682,20,99,98,1,19,1
"3244","Masc","D23",0.0113636363636364,0.661074727453963,88,48,47,1,87,1
"3245","Fem","D23",0.0208333333333333,0.661074727453963,48,88,87,1,47,1
"3246","Casado/Amasiaado","D23",0,0.240392003376903,55,81,79,2,55,0
"3247","Solteiro","D23",0.0338983050847458,0.103606764411036,59,77,77,0,57,2
"3248","Separado_Divorciado","D23",0,0.739976909027013,7,129,127,2,7,0
"3249","X4","D23",0,0.830565083280277,3,133,131,2,3,0
"3250","X5","D23",0,0.861819671758601,2,134,132,2,2,0
"3251","X6","D23",0,0.688146459888278,10,126,124,2,10,0
"3252","Livrar_costas","D23",0.0232558139534884,0.564351319818157,86,14,14,0,84,2
"3253","Livrar_perna","D23",0,0.564351319818157,14,86,84,2,14,0
"3254","Livrar_perda_sens","D23",NA,NA,0,100,98,2,0,0
"3255","D1","D23",0,0.902407153906854,1,135,133,2,1,0
"3256","D15","D23",0,0.739976909027013,7,129,127,2,7,0
"3257","D16","D23",0,0.554127697484356,20,116,114,2,20,0
"3258","D17","D23",0,0.780748527710185,5,131,129,2,5,0
"3259","D18","D23",0,0.602898245770971,16,120,118,2,16,0
"3260","D19","D23",0,0.739976909027013,7,129,127,2,7,0
"3261","D2","D23",0,0.721704213787294,8,128,126,2,8,0
"3262","D20","D23",0,0.721704213787294,8,128,126,2,8,0
"3263","D21","D23",0,0.739976909027013,7,129,127,2,7,0
"3264","D22","D23",0,0.861819671758601,2,134,132,2,2,0
"3265","D23","D23",1,1.99530445797663e-31,2,134,134,0,0,2
"3266","D24","D23",0.0384615384615385,0.263175050261802,26,110,109,1,25,1
"3267","D25","D23",0.25,7.24133478207653e-05,4,132,131,1,3,1
"3268","D26","D23",0,0.861819671758601,2,134,132,2,2,0
"3269","D27","D23",0.2,0.000452966589099755,5,131,130,1,4,1
"3270","D28","D23",0.166666666666667,0.00156241229615405,6,130,129,1,5,1
"3271","D29","D23",0,0.340923749246409,42,94,92,2,42,0
"3272","D3","D23",0,0.861819671758601,2,134,132,2,2,0
"3273","Lombalgia","D23",0.032258064516129,0.119586736538819,62,74,74,0,60,2
"3274","D31","D23",0,0.590234194210651,17,119,117,2,17,0
"3275","D32","D23",0,0.383757260247278,37,99,97,2,37,0
"3276","D33","D23",0,0.657612161666932,12,124,122,2,12,0
"3277","D34","D23",0,0.830565083280277,3,133,131,2,3,0
"3278","D35","D23",0,0.861819671758601,2,134,132,2,2,0
"3279","D36","D23",0,0.721704213787294,8,128,126,2,8,0
"3280","D37","D23",0,0.531393754170243,22,114,112,2,22,0
"3281","D38","D23",0,0.830565083280277,3,133,131,2,3,0
"3282","D39","D23",0,0.615926597177117,15,121,119,2,15,0
"3283","D4","D23",0,0.804124066880639,4,132,130,2,4,0
"3284","D40","D23",0,0.780748527710185,5,131,129,2,5,0
"3285","D41","D23",0,0.739976909027013,7,129,127,2,7,0
"3286","D42","D23",0,0.830565083280277,3,133,131,2,3,0
"3287","D43","D23",0,0.830565083280277,3,133,131,2,3,0
"3288","D44","D23",0.0263157894736842,0.483675186223837,38,98,97,1,37,1
"3289","D45","D23",0.0833333333333333,0.0386095472359837,12,124,123,1,11,1
"3290","D46","D23",0.0263157894736842,0.483675186223837,38,98,97,1,37,1
"3291","D47","D23",0.0833333333333333,0.0386095472359837,12,124,123,1,11,1
"3292","D48","D23",0.0384615384615385,0.263175050261802,26,110,109,1,25,1
"3293","D49","D23",0.0769230769230769,0.0500409359430017,13,123,122,1,12,1
"3294","D5","D23",0,0.830565083280277,3,133,131,2,3,0
"3295","D50","D23",0,0.861819671758601,2,134,132,2,2,0
"3296","D51","D23",0,0.902407153906854,1,135,133,2,1,0
"3297","D52","D23",0,0.861819671758601,2,134,132,2,2,0
"3298","D53","D23",0,0.861819671758601,2,134,132,2,2,0
"3299","D9","D23",0,0.902407153906854,1,135,133,2,1,0
"3300","RMDQ1_v1","D23",0.0232558139534884,0.920972823893012,43,73,72,1,42,1
"3301","RMDQ2_v1","D23",0.0425531914893617,0.21975024120729,47,69,69,0,45,2
"3302","RMDQ3_v1","D23",0,0.344614970744897,36,82,80,2,36,0
"3303","RMDQ4_v1","D23",0.0384615384615385,0.335843434078945,26,92,91,1,25,1
"3304","RMDQ5_v1","D23",0,0.374143062948929,33,85,83,2,33,0
"3305","RMDQ6_v1","D23",0,0.415530488075431,29,89,87,2,29,0
"3306","RMDQ7_v1","D23",0,0.517165263403425,20,97,95,2,20,0
"3307","RMDQ8_v1","D23",0,0.788407006817525,4,113,111,2,4,0
"3308","RMDQ9_v1","D23",0,0.543025813812971,18,99,97,2,18,0
"3309","RMDQ10_v1","D23",0.0454545454545455,0.254752373169046,22,95,94,1,21,1
"3310","RMDQ11_v1","D23",0.0434782608695652,0.276118902707155,23,94,93,1,22,1
"3311","RMDQ12_v1","D23",0,0.492429745624424,22,95,93,2,22,0
"3312","RMDQ13_v1","D23",0,0.492429745624424,22,95,93,2,22,0
"3313","RMDQ14_v1","D23",0.04,0.319048948084802,25,92,91,1,24,1
"3314","RMDQ15_v1","D23",0,0.584363826258582,15,102,100,2,15,0
"3315","RMDQ16_v1","D23",0,0.529944138338696,19,98,96,2,19,0
"3316","RMDQ17_v1","D23",0,0.492429745624424,22,95,93,2,22,0
"3317","RMDQ18_v1","D23",0.05,0.212447592946906,20,97,96,1,19,1
"3318","RMDQ19_v1","D23",0,0.570203696419443,16,101,99,2,16,0
"3319","RMDQ20_v1","D23",0,0.504666956170422,21,96,94,2,21,0
"3320","RMDQ21_v1","D23",0.0416666666666667,0.297563754888929,24,93,92,1,23,1
"3321","RMDQ22_v1","D23",0,0.517165263403425,20,97,95,2,20,0
"3322","RMDQ23_v1","D23",0,0.529944138338696,19,98,96,2,19,0
"3323","RMDQ24_v1","D23",0,0.529944138338696,19,98,96,2,19,0
"3324","DN4 - Queimação","D23",0.0188679245283019,0.266069863620088,53,65,65,0,52,1
"3325","DN4 - Sensação de frio dolorosa","D23",0,0.611841971208142,24,94,93,1,24,0
"3326","DN4 - Choque elétrico","D23",0.0277777777777778,0.127302516839353,36,83,83,0,35,1
"3327","DN4 - Formigamento","D23",0.032258064516129,0.0906514651303281,31,88,88,0,30,1
"3328","DN4 - Alfinetada e agulhada","D23",0.0277777777777778,0.127302516839353,36,83,83,0,35,1
"3329","DN4 - Adormecimento","D23",0.0303030303030303,0.107014020238433,33,85,85,0,32,1
"3330","DN4 - Coceira","D23",0,0.817001778007153,6,113,112,1,6,0
"3331","DH4 - Hipoestesia ao toque","D23",0,0.833423792098798,5,114,113,1,5,0
"3332","DN4 - Hipoestesia a picada de agulha","D23",0,0.833423792098798,5,114,113,1,5,0
"3333","DN4 - Escovação","D23",0,0.851433613762243,4,115,114,1,4,0
"3334","Fuma","D24",0.173913043478261,0.768012132089777,46,82,66,16,38,8
"3335","Cirurgia na coluna","D24",0.163636363636364,0.552312931460711,55,63,50,13,46,9
"3336","Aposentado","D24",0.129032258064516,0.276902884734919,31,101,79,22,27,4
"3337","Desempregado","D24",0.28,0.265838463903265,25,105,86,19,18,7
"3338","Licenca_Medica","D24",0.222222222222222,0.771912292067862,18,114,92,22,14,4
"3339","Aposentado_Invalidez","D24",0.375,0.196392184446184,8,123,100,23,5,3
"3340","Analgésicos","D24",0.193181818181818,0.778466787355829,88,42,33,9,71,17
"3341","OutraDoenca","D24",0.2,1,50,80,64,16,40,10
"3342","Dor nas costas","D24",0.241758241758242,0.0884253744878379,91,37,33,4,69,22
"3343","Dor nas pernas","D24",0.127272727272727,0.0586751327171484,55,72,53,19,48,7
"3344","Retornar_trabalho","D24",0.35,0.0699282056256247,20,99,82,17,13,7
"3345","Masc","D24",0.181818181818182,0.707074768398805,88,48,38,10,72,16
"3346","Fem","D24",0.208333333333333,0.707074768398805,48,88,72,16,38,10
"3347","Casado/Amasiaado","D24",0.2,0.829277200319907,55,81,66,15,44,11
"3348","Solteiro","D24",0.220338983050847,0.449013262929709,59,77,64,13,46,13
"3349","Separado_Divorciado","D24",0,0.186591501022522,7,129,103,26,7,0
"3350","X4","D24",0,0.394480841695529,3,133,107,26,3,0
"3351","X5","D24",0.5,0.263175050261802,2,134,109,25,1,1
"3352","X6","D24",0.1,0.446198351241192,10,126,101,25,9,1
"3353","Livrar_costas","D24",0.290697674418605,0.0198350198079292,86,14,14,0,61,25
"3354","Livrar_perna","D24",0,0.0198350198079292,14,86,61,25,14,0
"3355","Livrar_perda_sens","D24",NA,NA,0,100,75,25,0,0
"3356","D1","D24",0,0.625571266952418,1,135,109,26,1,0
"3357","D15","D24",0,0.186591501022522,7,129,103,26,7,0
"3358","D16","D24",0.1,0.261531536755026,20,116,92,24,18,2
"3359","D17","D24",0.2,0.959227442302328,5,131,106,25,4,1
"3360","D18","D24",0.25,0.524118766695548,16,120,98,22,12,4
"3361","D19","D24",0.571428571428571,0.00861550241929527,7,129,107,22,3,4
"3362","D2","D24",0.375,0.172911591990018,8,128,105,23,5,3
"3363","D20","D24",0.5,0.0220395842889348,8,128,106,22,4,4
"3364","D21","D24",0.428571428571429,0.100999550305803,7,129,106,23,4,3
"3365","D22","D24",0,0.488520668794022,2,134,108,26,2,0
"3366","D23","D24",0.5,0.263175050261802,2,134,109,25,1,1
"3367","D24","D24",1,1.99530445797663e-31,26,110,110,0,0,26
"3368","D25","D24",1,2.97160685748155e-05,4,132,110,22,0,4
"3369","D26","D24",0.5,0.263175050261802,2,134,109,25,1,1
"3370","D27","D24",0.2,0.959227442302328,5,131,106,25,4,1
"3371","D28","D24",0.333333333333333,0.365080576396937,6,130,106,24,4,2
"3372","D29","D24",0.142857142857143,0.338127897443461,42,94,74,20,36,6
"3373","D3","D24",0.5,0.263175050261802,2,134,109,25,1,1
"3374","Lombalgia","D24",0.209677419354839,0.615508442635526,62,74,61,13,49,13
"3375","D31","D24",0.176470588235294,0.869068482970259,17,119,96,23,14,3
"3376","D32","D24",0.108108108108108,0.132050003979671,37,99,77,22,33,4
"3377","D33","D24",0.0833333333333333,0.319764612861751,12,124,99,25,11,1
"3378","D34","D24",0.333333333333333,0.526615348065255,3,133,108,25,2,1
"3379","D35","D24",0,0.488520668794022,2,134,108,26,2,0
"3380","D36","D24",0,0.156358988235655,8,128,102,26,8,0
"3381","D37","D24",0.0909090909090909,0.191449535246389,22,114,90,24,20,2
"3382","D38","D24",0,0.394480841695529,3,133,107,26,3,0
"3383","D39","D24",0.0666666666666667,0.193561484926098,15,121,96,25,14,1
"3384","D4","D24",0.25,0.761369957578402,4,132,107,25,3,1
"3385","D40","D24",0,0.268005741392268,5,131,105,26,5,0
"3386","D41","D24",0,0.186591501022522,7,129,103,26,7,0
"3387","D42","D24",0,0.394480841695529,3,133,107,26,3,0
"3388","D43","D24",0,0.394480841695529,3,133,107,26,3,0
"3389","D44","D24",0.0789473684210526,0.0382121431588958,38,98,75,23,35,3
"3390","D45","D24",0.0833333333333333,0.319764612861751,12,124,99,25,11,1
"3391","D46","D24",0.131578947368421,0.271067685431734,38,98,77,21,33,5
"3392","D47","D24",0.166666666666667,0.821105665434699,12,124,100,24,10,2
"3393","D48","D24",0.0769230769230769,0.0994869787322383,26,110,86,24,24,2
"3394","D49","D24",0.230769230769231,0.702659067598973,13,123,100,23,10,3
"3395","D5","D24",0.666666666666667,0.0341850787437454,3,133,109,24,1,2
"3396","D50","D24",0.5,0.263175050261802,2,134,109,25,1,1
"3397","D51","D24",0,0.625571266952418,1,135,109,26,1,0
"3398","D52","D24",0,0.488520668794022,2,134,108,26,2,0
"3399","D53","D24",0,0.488520668794022,2,134,108,26,2,0
"3400","D9","D24",0,0.625571266952418,1,135,109,26,1,0
"3401","RMDQ1_v1","D24",0.186046511627907,0.801529589035238,43,73,57,16,35,8
"3402","RMDQ2_v1","D24",0.234042553191489,0.734403154588601,47,69,56,13,36,11
"3403","RMDQ3_v1","D24",0.138888888888889,0.24876378904953,36,82,63,19,31,5
"3404","RMDQ4_v1","D24",0.0769230769230769,0.0696228781730831,26,92,70,22,24,2
"3405","RMDQ5_v1","D24",0.121212121212121,0.167023529664458,33,85,65,20,29,4
"3406","RMDQ6_v1","D24",0.0689655172413793,0.0383787700472785,29,89,67,22,27,2
"3407","RMDQ7_v1","D24",0.15,0.502503786304834,20,97,76,21,17,3
"3408","RMDQ8_v1","D24",0.25,0.821085032375238,4,113,90,23,3,1
"3409","RMDQ9_v1","D24",0.0555555555555556,0.0875526820172389,18,99,76,23,17,1
"3410","RMDQ10_v1","D24",0.0909090909090909,0.140918187032406,22,95,73,22,20,2
"3411","RMDQ11_v1","D24",0.130434782608696,0.322309100343378,23,94,73,21,20,3
"3412","RMDQ12_v1","D24",0.0454545454545455,0.0395586887338147,22,95,72,23,21,1
"3413","RMDQ13_v1","D24",0.0454545454545455,0.0395586887338147,22,95,72,23,21,1
"3414","RMDQ14_v1","D24",0.12,0.234548041327828,25,92,71,21,22,3
"3415","RMDQ15_v1","D24",0.0666666666666667,0.154924749544463,15,102,79,23,14,1
"3416","RMDQ16_v1","D24",0.105263157894737,0.238835880237147,19,98,76,22,17,2
"3417","RMDQ17_v1","D24",0.0454545454545455,0.0395586887338147,22,95,72,23,21,1
"3418","RMDQ18_v1","D24",0.1,0.200990882270354,20,97,75,22,18,2
"3419","RMDQ19_v1","D24",0.0625,0.128341404212721,16,101,78,23,15,1
"3420","RMDQ20_v1","D24",0.0952380952380952,0.168580484445162,21,96,74,22,19,2
"3421","RMDQ21_v1","D24",0.0833333333333333,0.0974405496966806,24,93,71,22,22,2
"3422","RMDQ22_v1","D24",0.05,0.0591721923965132,20,97,74,23,19,1
"3423","RMDQ23_v1","D24",0.0526315789473684,0.0720681410405464,19,98,75,23,18,1
"3424","RMDQ24_v1","D24",0.0526315789473684,0.0720681410405464,19,98,75,23,18,1
"3425","DN4 - Queimação","D24",0.113207547169811,0.0279749884872299,53,65,47,18,47,6
"3426","DN4 - Sensação de frio dolorosa","D24",0.125,0.285094982739129,24,94,73,21,21,3
"3427","DN4 - Choque elétrico","D24",0.166666666666667,0.530716507537342,36,83,65,18,30,6
"3428","DN4 - Formigamento","D24",0.032258064516129,0.00626114686302869,31,88,65,23,30,1
"3429","DN4 - Alfinetada e agulhada","D24",0.111111111111111,0.10488602224455,36,83,63,20,32,4
"3430","DN4 - Adormecimento","D24",0.0606060606060606,0.0163533862722201,33,85,63,22,31,2
"3431","DN4 - Coceira","D24",0.166666666666667,0.826379941349948,6,113,90,23,5,1
"3432","DH4 - Hipoestesia ao toque","D24",0.4,0.258835660952616,5,114,92,22,3,2
"3433","DN4 - Hipoestesia a picada de agulha","D24",0.4,0.258835660952616,5,114,92,22,3,2
"3434","DN4 - Escovação","D24",0.5,0.130388916402017,4,115,93,22,2,2
"3435","Fuma","D25",0.0217391304347826,0.924214003182506,46,82,80,2,45,1
"3436","Cirurgia na coluna","D25",0.0363636363636364,0.890027290247415,55,63,61,2,53,2
"3437","Aposentado","D25",0.0645161290322581,0.203944264190864,31,101,99,2,29,2
"3438","Desempregado","D25",0.08,0.11273222362829,25,105,103,2,23,2
"3439","Licenca_Medica","D25",0,0.419642642987081,18,114,110,4,18,0
"3440","Aposentado_Invalidez","D25",0,0.604436248364823,8,123,119,4,8,0
"3441","Analgésicos","D25",0.0340909090909091,0.750902898480624,88,42,41,1,85,3
"3442","OutraDoenca","D25",0.02,0.574038305978992,50,80,77,3,49,1
"3443","Dor nas costas","D25",0.043956043956044,0.195079020743251,91,37,37,0,87,4
"3444","Dor nas pernas","D25",0.0181818181818182,0.452741394658823,55,72,69,3,54,1
"3445","Retornar_trabalho","D25",0.15,0.00154431425368105,20,99,98,1,17,3
"3446","Masc","D25",0.0340909090909091,0.661894461378815,88,48,47,1,85,3
"3447","Fem","D25",0.0208333333333333,0.661894461378815,48,88,85,3,47,1
"3448","Casado/Amasiaado","D25",0.0181818181818182,0.523007578389965,55,81,78,3,54,1
"3449","Solteiro","D25",0.0508474576271186,0.195279287722334,59,77,76,1,56,3
"3450","Separado_Divorciado","D25",0,0.63628659530033,7,129,125,4,7,0
"3451","X4","D25",0,0.760447734150187,3,133,129,4,3,0
"3452","X5","D25",0,0.804124066880639,2,134,130,4,2,0
"3453","X6","D25",0,0.56738337600414,10,126,122,4,10,0
"3454","Livrar_costas","D25",0.0465116279069767,0.410174600795881,86,14,14,0,82,4
"3455","Livrar_perna","D25",0,0.410174600795881,14,86,82,4,14,0
"3456","Livrar_perda_sens","D25",NA,NA,0,100,96,4,0,0
"3457","D1","D25",0,0.861298710023066,1,135,131,4,1,0
"3458","D15","D25",0,0.63628659530033,7,129,125,4,7,0
"3459","D16","D25",0,0.399260020365242,20,116,112,4,20,0
"3460","D17","D25",0,0.691656304093206,5,131,127,4,5,0
"3461","D18","D25",0,0.458524130935477,16,120,116,4,16,0
"3462","D19","D25",0.285714285714286,3.77296235126334e-05,7,129,127,2,5,2
"3463","D2","D25",0,0.611790554856623,8,128,124,4,8,0
"3464","D20","D25",0.25,0.000141007605342292,8,128,126,2,6,2
"3465","D21","D25",0.285714285714286,3.77296235126334e-05,7,129,127,2,5,2
"3466","D22","D25",0,0.804124066880639,2,134,130,4,2,0
"3467","D23","D25",0.5,7.24133478207653e-05,2,134,131,3,1,1
"3468","D24","D25",0.153846153846154,2.97160685748155e-05,26,110,110,0,22,4
"3469","D25","D25",1,1.99530445797665e-31,4,132,132,0,0,4
"3470","D26","D25",0,0.804124066880639,2,134,130,4,2,0
"3471","D27","D25",0.2,0.0214296246108954,5,131,128,3,4,1
"3472","D28","D25",0.166666666666667,0.041823155446835,6,130,127,3,5,1
"3473","D29","D25",0.0238095238095238,0.796042473837201,42,94,91,3,41,1
"3474","D3","D25",0,0.804124066880639,2,134,130,4,2,0
"3475","Lombalgia","D25",0.0483870967741935,0.230590653140493,62,74,73,1,59,3
"3476","D31","D25",0,0.442904989463355,17,119,115,4,17,0
"3477","D32","D25",0,0.214580448957259,37,99,95,4,37,0
"3478","D33","D25",0,0.527695676048595,12,124,120,4,12,0
"3479","D34","D25",0,0.760447734150187,3,133,129,4,3,0
"3480","D35","D25",0,0.804124066880639,2,134,130,4,2,0
"3481","D36","D25",0,0.611790554856623,8,128,124,4,8,0
"3482","D37","D25",0,0.372495814335914,22,114,110,4,22,0
"3483","D38","D25",0,0.760447734150187,3,133,129,4,3,0
"3484","D39","D25",0,0.474752078295636,15,121,117,4,15,0
"3485","D4","D25",0,0.723795314149376,4,132,128,4,4,0
"3486","D40","D25",0,0.691656304093206,5,131,127,4,5,0
"3487","D41","D25",0,0.63628659530033,7,129,125,4,7,0
"3488","D42","D25",0,0.760447734150187,3,133,129,4,3,0
"3489","D43","D25",0,0.760447734150187,3,133,129,4,3,0
"3490","D44","D25",0,0.206183885714472,38,98,94,4,38,0
"3491","D45","D25",0,0.527695676048595,12,124,120,4,12,0
"3492","D46","D25",0,0.206183885714472,38,98,94,4,38,0
"3493","D47","D25",0,0.527695676048595,12,124,120,4,12,0
"3494","D48","D25",0,0.323658611852603,26,110,106,4,26,0
"3495","D49","D25",0,0.509265854764088,13,123,119,4,13,0
"3496","D5","D25",0,0.760447734150187,3,133,129,4,3,0
"3497","D50","D25",0,0.804124066880639,2,134,130,4,2,0
"3498","D51","D25",0,0.861298710023066,1,135,131,4,1,0
"3499","D52","D25",0,0.804124066880639,2,134,130,4,2,0
"3500","D53","D25",0,0.804124066880639,2,134,130,4,2,0
"3501","D9","D25",0,0.861298710023066,1,135,131,4,1,0
"3502","RMDQ1_v1","D25",0.0232558139534884,0.977692589616264,43,73,71,2,42,1
"3503","RMDQ2_v1","D25",0.0425531914893617,0.635197336145884,47,69,68,1,45,2
"3504","RMDQ3_v1","D25",0.0277777777777778,0.914281346421744,36,82,80,2,35,1
"3505","RMDQ4_v1","D25",0.0384615384615385,0.632428483419777,26,92,90,2,25,1
"3506","RMDQ5_v1","D25",0,0.274305339715658,33,85,82,3,33,0
"3507","RMDQ6_v1","D25",0,0.316578729661288,29,89,86,3,29,0
"3508","RMDQ7_v1","D25",0,0.425587509741219,20,97,94,3,20,0
"3509","RMDQ8_v1","D25",0,0.741297764641791,4,113,110,3,4,0
"3510","RMDQ9_v1","D25",0,0.454337365794028,18,99,96,3,18,0
"3511","RMDQ10_v1","D25",0.0454545454545455,0.514082165897887,22,95,93,2,21,1
"3512","RMDQ11_v1","D25",0.0434782608695652,0.545976469961421,23,94,92,2,22,1
"3513","RMDQ12_v1","D25",0,0.398443266068114,22,95,92,3,22,0
"3514","RMDQ13_v1","D25",0,0.398443266068114,22,95,92,3,22,0
"3515","RMDQ14_v1","D25",0.04,0.608489851420513,25,92,90,2,24,1
"3516","RMDQ15_v1","D25",0,0.501014709533698,15,102,99,3,15,0
"3517","RMDQ16_v1","D25",0,0.439748411324023,19,98,95,3,19,0
"3518","RMDQ17_v1","D25",0,0.398443266068114,22,95,92,3,22,0
"3519","RMDQ18_v1","D25",0.05,0.449093732608259,20,97,95,2,19,1
"3520","RMDQ19_v1","D25",0,0.48493089059007,16,101,98,3,16,0
"3521","RMDQ20_v1","D25",0,0.41182715147907,21,96,93,3,21,0
"3522","RMDQ21_v1","D25",0.0416666666666667,0.577448469865294,24,93,91,2,23,1
"3523","RMDQ22_v1","D25",0,0.425587509741219,20,97,94,3,20,0
"3524","RMDQ23_v1","D25",0,0.439748411324023,19,98,95,3,19,0
"3525","RMDQ24_v1","D25",0,0.439748411324023,19,98,95,3,19,0
"3526","DN4 - Queimação","D25",0.0188679245283019,0.68288685723324,53,65,63,2,52,1
"3527","DN4 - Sensação de frio dolorosa","D25",0.0416666666666667,0.571125001077476,24,94,92,2,23,1
"3528","DN4 - Choque elétrico","D25",0.0277777777777778,0.906324738174181,36,83,81,2,35,1
"3529","DN4 - Formigamento","D25",0,0.297771094102592,31,88,85,3,31,0
"3530","DN4 - Alfinetada e agulhada","D25",0,0.247943045876988,36,83,80,3,36,0
"3531","DN4 - Adormecimento","D25",0,0.274305339715658,33,85,82,3,33,0
"3532","DN4 - Coceira","D25",0,0.686034714726899,6,113,110,3,6,0
"3533","DH4 - Hipoestesia ao toque","D25",0,0.71332159403313,5,114,111,3,5,0
"3534","DN4 - Hipoestesia a picada de agulha","D25",0,0.71332159403313,5,114,111,3,5,0
"3535","DN4 - Escovação","D25",0,0.743532065455045,4,115,112,3,4,0
"3536","Fuma","D26",0,0.285703052977686,46,82,80,2,46,0
"3537","Cirurgia na coluna","D26",0,0.348070916478987,55,63,62,1,55,0
"3538","Aposentado","D26",0.032258064516129,0.372732044491854,31,101,100,1,30,1
"3539","Desempregado","D26",0.04,0.265838463903265,25,105,104,1,24,1
"3540","Licenca_Medica","D26",0.0555555555555556,0.131038190578192,18,114,113,1,17,1
"3541","Aposentado_Invalidez","D26",0,0.71626653488051,8,123,121,2,8,0
"3542","Analgésicos","D26",0.0227272727272727,0.324814833547299,88,42,42,0,86,2
"3543","OutraDoenca","D26",0.02,0.73534779052376,50,80,79,1,49,1
"3544","Dor nas costas","D26",0.021978021978022,0.363404269902099,91,37,37,0,89,2
"3545","Dor nas pernas","D26",0,0.212807680324934,55,72,70,2,55,0
"3546","Retornar_trabalho","D26",0.05,0.205485590404682,20,99,98,1,19,1
"3547","Masc","D26",0.0227272727272727,0.292693309963762,88,48,48,0,86,2
"3548","Fem","D26",0,0.292693309963762,48,88,86,2,48,0
"3549","Casado/Amasiaado","D26",0.0363636363636364,0.0838103603534032,55,81,81,0,53,2
"3550","Solteiro","D26",0,0.212348813642373,59,77,75,2,59,0
"3551","Separado_Divorciado","D26",0,0.739976909027013,7,129,127,2,7,0
"3552","X4","D26",0,0.830565083280277,3,133,131,2,3,0
"3553","X5","D26",0,0.861819671758601,2,134,132,2,2,0
"3554","X6","D26",0,0.688146459888278,10,126,124,2,10,0
"3555","Livrar_costas","D26",0.0232558139534884,0.564351319818157,86,14,14,0,84,2
"3556","Livrar_perna","D26",0,0.564351319818157,14,86,84,2,14,0
"3557","Livrar_perda_sens","D26",NA,NA,0,100,98,2,0,0
"3558","D1","D26",0,0.902407153906854,1,135,133,2,1,0
"3559","D15","D26",0,0.739976909027013,7,129,127,2,7,0
"3560","D16","D26",0,0.554127697484356,20,116,114,2,20,0
"3561","D17","D26",0,0.780748527710185,5,131,129,2,5,0
"3562","D18","D26",0.0625,0.0908805539668756,16,120,119,1,15,1
"3563","D19","D26",0.142857142857143,0.00382637942754141,7,129,128,1,6,1
"3564","D2","D26",0,0.721704213787294,8,128,126,2,8,0
"3565","D20","D26",0.125,0.00755433235506732,8,128,127,1,7,1
"3566","D21","D26",0.142857142857143,0.00382637942754141,7,129,128,1,6,1
"3567","D22","D26",0.5,9.25079971216983e-09,2,134,133,1,1,1
"3568","D23","D26",0,0.861819671758601,2,134,132,2,2,0
"3569","D24","D26",0.0384615384615385,0.263175050261802,26,110,109,1,25,1
"3570","D25","D26",0,0.804124066880639,4,132,130,2,4,0
"3571","D26","D26",1,1.99530445797663e-31,2,134,134,0,0,2
"3572","D27","D26",0,0.780748527710185,5,131,129,2,5,0
"3573","D28","D26",0.166666666666667,0.00156241229615405,6,130,129,1,5,1
"3574","D29","D26",0,0.340923749246409,42,94,92,2,42,0
"3575","D3","D26",0,0.861819671758601,2,134,132,2,2,0
"3576","Lombalgia","D26",0.0161290322580645,0.899570795089937,62,74,73,1,61,1
"3577","D31","D26",0.0588235294117647,0.106204613306305,17,119,118,1,16,1
"3578","D32","D26",0,0.383757260247278,37,99,97,2,37,0
"3579","D33","D26",0,0.657612161666932,12,124,122,2,12,0
"3580","D34","D26",0,0.830565083280277,3,133,131,2,3,0
"3581","D35","D26",0,0.861819671758601,2,134,132,2,2,0
"3582","D36","D26",0,0.721704213787294,8,128,126,2,8,0
"3583","D37","D26",0,0.531393754170243,22,114,112,2,22,0
"3584","D38","D26",0,0.830565083280277,3,133,131,2,3,0
"3585","D39","D26",0,0.615926597177117,15,121,119,2,15,0
"3586","D4","D26",0,0.804124066880639,4,132,130,2,4,0
"3587","D40","D26",0,0.780748527710185,5,131,129,2,5,0
"3588","D41","D26",0,0.739976909027013,7,129,127,2,7,0
"3589","D42","D26",0.333333333333333,3.54931258649229e-06,3,133,132,1,2,1
"3590","D43","D26",0.333333333333333,3.54931258649229e-06,3,133,132,1,2,1
"3591","D44","D26",0,0.374983020515037,38,98,96,2,38,0
"3592","D45","D26",0,0.657612161666932,12,124,122,2,12,0
"3593","D46","D26",0,0.374983020515037,38,98,96,2,38,0
"3594","D47","D26",0,0.657612161666932,12,124,122,2,12,0
"3595","D48","D26",0,0.488520668794022,26,110,108,2,26,0
"3596","D49","D26",0,0.643234299777126,13,123,121,2,13,0
"3597","D5","D26",0,0.830565083280277,3,133,131,2,3,0
"3598","D50","D26",0,0.861819671758601,2,134,132,2,2,0
"3599","D51","D26",0,0.902407153906854,1,135,133,2,1,0
"3600","D52","D26",0,0.861819671758601,2,134,132,2,2,0
"3601","D53","D26",0,0.861819671758601,2,134,132,2,2,0
"3602","D9","D26",0,0.902407153906854,1,135,133,2,1,0
"3603","RMDQ1_v1","D26",0.0232558139534884,0.920972823893012,43,73,72,1,42,1
"3604","RMDQ2_v1","D26",0.0425531914893617,0.21975024120729,47,69,69,0,45,2
"3605","RMDQ3_v1","D26",0.0277777777777778,0.545973330618042,36,82,81,1,35,1
"3606","RMDQ4_v1","D26",0.0384615384615385,0.335843434078945,26,92,91,1,25,1
"3607","RMDQ5_v1","D26",0.0303030303030303,0.483790516345729,33,85,84,1,32,1
"3608","RMDQ6_v1","D26",0.0344827586206897,0.399633662575936,29,89,88,1,28,1
"3609","RMDQ7_v1","D26",0,0.517165263403425,20,97,95,2,20,0
"3610","RMDQ8_v1","D26",0,0.788407006817525,4,113,111,2,4,0
"3611","RMDQ9_v1","D26",0,0.543025813812971,18,99,97,2,18,0
"3612","RMDQ10_v1","D26",0.0454545454545455,0.254752373169046,22,95,94,1,21,1
"3613","RMDQ11_v1","D26",0.0434782608695652,0.276118902707155,23,94,93,1,22,1
"3614","RMDQ12_v1","D26",0.0454545454545455,0.254752373169046,22,95,94,1,21,1
"3615","RMDQ13_v1","D26",0,0.492429745624424,22,95,93,2,22,0
"3616","RMDQ14_v1","D26",0.04,0.319048948084802,25,92,91,1,24,1
"3617","RMDQ15_v1","D26",0,0.584363826258582,15,102,100,2,15,0
"3618","RMDQ16_v1","D26",0,0.529944138338696,19,98,96,2,19,0
"3619","RMDQ17_v1","D26",0.0454545454545455,0.254752373169046,22,95,94,1,21,1
"3620","RMDQ18_v1","D26",0.05,0.212447592946906,20,97,96,1,19,1
"3621","RMDQ19_v1","D26",0,0.570203696419443,16,101,99,2,16,0
"3622","RMDQ20_v1","D26",0.0476190476190476,0.233510138206751,21,96,95,1,20,1
"3623","RMDQ21_v1","D26",0.0416666666666667,0.297563754888929,24,93,92,1,23,1
"3624","RMDQ22_v1","D26",0.05,0.212447592946906,20,97,96,1,19,1
"3625","RMDQ23_v1","D26",0.0526315789473684,0.191631215221544,19,98,97,1,18,1
"3626","RMDQ24_v1","D26",0.0526315789473684,0.191631215221544,19,98,97,1,18,1
"3627","DN4 - Queimação","D26",0,0.364492892588794,53,65,64,1,53,0
"3628","DN4 - Sensação de frio dolorosa","D26",0,0.611841971208142,24,94,93,1,24,0
"3629","DN4 - Choque elétrico","D26",0,0.508374874653824,36,83,82,1,36,0
"3630","DN4 - Formigamento","D26",0,0.55115163907239,31,88,87,1,31,0
"3631","DN4 - Alfinetada e agulhada","D26",0,0.508374874653824,36,83,82,1,36,0
"3632","DN4 - Adormecimento","D26",0.0303030303030303,0.107014020238433,33,85,85,0,32,1
"3633","DN4 - Coceira","D26",0,0.817001778007153,6,113,112,1,6,0
"3634","DH4 - Hipoestesia ao toque","D26",0,0.833423792098798,5,114,113,1,5,0
"3635","DN4 - Hipoestesia a picada de agulha","D26",0,0.833423792098798,5,114,113,1,5,0
"3636","DN4 - Escovação","D26",0,0.851433613762243,4,115,114,1,4,0
"3637","Fuma","D27",0.0652173913043478,0.0980711909221135,46,82,81,1,43,3
"3638","Cirurgia na coluna","D27",0.0545454545454545,0.0604130830069361,55,63,63,0,52,3
"3639","Aposentado","D27",0.0645161290322581,0.374461448361999,31,101,98,3,29,2
"3640","Desempregado","D27",0.04,0.964499561927088,25,105,101,4,24,1
"3641","Licenca_Medica","D27",0.0555555555555556,0.672493937177567,18,114,110,4,17,1
"3642","Aposentado_Invalidez","D27",0.125,0.185886669411596,8,123,119,4,7,1
"3643","Analgésicos","D27",0.0454545454545455,0.548410082507464,88,42,41,1,84,4
"3644","OutraDoenca","D27",0.02,0.386856424005249,50,80,76,4,49,1
"3645","Dor nas costas","D27",0.043956043956044,0.654046937992094,91,37,36,1,87,4
"3646","Dor nas pernas","D27",0.0181818181818182,0.283214200884168,55,72,68,4,54,1
"3647","Retornar_trabalho","D27",0.15,0.00831551678443962,20,99,97,2,17,3
"3648","Masc","D27",0.0454545454545455,0.465906514793997,88,48,47,1,84,4
"3649","Fem","D27",0.0208333333333333,0.465906514793997,48,88,84,4,47,1
"3650","Casado/Amasiaado","D27",0,0.0604627999322679,55,81,76,5,55,0
"3651","Solteiro","D27",0.0847457627118644,0.00924701326139621,59,77,77,0,54,5
"3652","Separado_Divorciado","D27",0,0.595606456103754,7,129,124,5,7,0
"3653","X4","D27",0,0.732216032264721,3,133,128,5,3,0
"3654","X5","D27",0,0.780748527710185,2,134,129,5,2,0
"3655","X6","D27",0,0.52097059061678,10,126,121,5,10,0
"3656","Livrar_costas","D27",0.0581395348837209,0.354637665742146,86,14,14,0,81,5
"3657","Livrar_perna","D27",0,0.354637665742146,14,86,81,5,14,0
"3658","Livrar_perda_sens","D27",NA,NA,0,100,95,5,0,0
"3659","D1","D27",0,0.844540967905734,1,135,130,5,1,0
"3660","D15","D27",0,0.595606456103754,7,129,124,5,7,0
"3661","D16","D27",0.05,0.733426772104044,20,116,112,4,19,1
"3662","D17","D27",0,0.656239661480154,5,131,126,5,5,0
"3663","D18","D27",0,0.405446952751703,16,120,115,5,16,0
"3664","D19","D27",0,0.595606456103754,7,129,124,5,7,0
"3665","D2","D27",0,0.568958961171041,8,128,123,5,8,0
"3666","D20","D27",0,0.568958961171041,8,128,123,5,8,0
"3667","D21","D27",0,0.595606456103754,7,129,124,5,7,0
"3668","D22","D27",0,0.780748527710185,2,134,129,5,2,0
"3669","D23","D27",0.5,0.000452966589099755,2,134,130,4,1,1
"3670","D24","D27",0.0384615384615385,0.959227442302328,26,110,106,4,25,1
"3671","D25","D27",0.25,0.0214296246108954,4,132,128,4,3,1
"3672","D26","D27",0,0.780748527710185,2,134,129,5,2,0
"3673","D27","D27",1,1.99530445797665e-31,5,131,131,0,0,5
"3674","D28","D27",0.5,6.94769406229019e-10,6,130,128,2,3,3
"3675","D29","D27",0.0714285714285714,0.151029644017627,42,94,92,2,39,3
"3676","D3","D27",0,0.780748527710185,2,134,129,5,2,0
"3677","Lombalgia","D27",0.0645161290322581,0.115447042524874,62,74,73,1,58,4
"3678","D31","D27",0.0588235294117647,0.605380068057658,17,119,115,4,16,1
"3679","D32","D27",0.0540540540540541,0.512459696857517,37,99,96,3,35,2
"3680","D33","D27",0,0.478474042466117,12,124,119,5,12,0
"3681","D34","D27",0,0.732216032264721,3,133,128,5,3,0
"3682","D35","D27",0,0.780748527710185,2,134,129,5,2,0
"3683","D36","D27",0,0.568958961171041,8,128,123,5,8,0
"3684","D37","D27",0.0454545454545455,0.812990938704793,22,114,110,4,21,1
"3685","D38","D27",0,0.732216032264721,3,133,128,5,3,0
"3686","D39","D27",0,0.422448926031037,15,121,116,5,15,0
"3687","D4","D27",0,0.691656304093206,4,132,127,5,4,0
"3688","D40","D27",0,0.656239661480154,5,131,126,5,5,0
"3689","D41","D27",0,0.595606456103754,7,129,124,5,7,0
"3690","D42","D27",0,0.732216032264721,3,133,128,5,3,0
"3691","D43","D27",0,0.732216032264721,3,133,128,5,3,0
"3692","D44","D27",0.0526315789473684,0.54034529486454,38,98,95,3,36,2
"3693","D45","D27",0,0.478474042466117,12,124,119,5,12,0
"3694","D46","D27",0.0263157894736842,0.686789350124843,38,98,94,4,37,1
"3695","D47","D27",0,0.478474042466117,12,124,119,5,12,0
"3696","D48","D27",0.0384615384615385,0.959227442302328,26,110,106,4,25,1
"3697","D49","D27",0,0.458879926672685,13,123,118,5,13,0
"3698","D5","D27",0,0.732216032264721,3,133,128,5,3,0
"3699","D50","D27",0,0.780748527710185,2,134,129,5,2,0
"3700","D51","D27",0,0.844540967905734,1,135,130,5,1,0
"3701","D52","D27",0,0.780748527710185,2,134,129,5,2,0
"3702","D53","D27",0,0.780748527710185,2,134,129,5,2,0
"3703","D9","D27",0,0.844540967905734,1,135,130,5,1,0
"3704","RMDQ1_v1","D27",0.0232558139534884,0.86220049438478,43,73,70,3,42,1
"3705","RMDQ2_v1","D27",0.0425531914893617,0.908662519064035,47,69,67,2,45,2
"3706","RMDQ3_v1","D27",0.0555555555555556,0.389035941189481,36,82,80,2,34,2
"3707","RMDQ4_v1","D27",0.0769230769230769,0.169770638744954,26,92,90,2,24,2
"3708","RMDQ5_v1","D27",0.0606060606060606,0.317839263222615,33,85,83,2,31,2
"3709","RMDQ6_v1","D27",0.0689655172413793,0.229533656665443,29,89,87,2,27,2
"3710","RMDQ7_v1","D27",0.1,0.0752615085065314,20,97,95,2,18,2
"3711","RMDQ8_v1","D27",0.25,0.0156492038886713,4,113,110,3,3,1
"3712","RMDQ9_v1","D27",0.111111111111111,0.0508821581424617,18,99,97,2,16,2
"3713","RMDQ10_v1","D27",0.136363636363636,0.00342370557055419,22,95,94,1,19,3
"3714","RMDQ11_v1","D27",0.130434782608696,0.00459732870229455,23,94,93,1,20,3
"3715","RMDQ12_v1","D27",0.0909090909090909,0.10420237747905,22,95,93,2,20,2
"3716","RMDQ13_v1","D27",0.0909090909090909,0.10420237747905,22,95,93,2,20,2
"3717","RMDQ14_v1","D27",0.12,0.0077500562032918,25,92,91,1,22,3
"3718","RMDQ15_v1","D27",0.0666666666666667,0.458450662997124,15,102,99,3,14,1
"3719","RMDQ16_v1","D27",0.105263157894737,0.0624754800677752,19,98,96,2,17,2
"3720","RMDQ17_v1","D27",0.0909090909090909,0.10420237747905,22,95,93,2,20,2
"3721","RMDQ18_v1","D27",0.15,0.00174601392465509,20,97,96,1,17,3
"3722","RMDQ19_v1","D27",0.125,0.0314326132122058,16,101,99,2,14,2
"3723","RMDQ20_v1","D27",0.0952380952380952,0.0891892591515812,21,96,94,2,19,2
"3724","RMDQ21_v1","D27",0.125,0.00603078542094925,24,93,92,1,21,3
"3725","RMDQ22_v1","D27",0.1,0.0752615085065314,20,97,95,2,18,2
"3726","RMDQ23_v1","D27",0.105263157894737,0.0624754800677752,19,98,96,2,17,2
"3727","RMDQ24_v1","D27",0.105263157894737,0.0624754800677752,19,98,96,2,17,2
"3728","DN4 - Queimação","D27",0.0377358490566038,0.835224526173344,53,65,63,2,51,2
"3729","DN4 - Sensação de frio dolorosa","D27",0,0.303875056389333,24,94,90,4,24,0
"3730","DN4 - Choque elétrico","D27",0.0555555555555556,0.381766761425683,36,83,81,2,34,2
"3731","DN4 - Formigamento","D27",0.0645161290322581,0.266939273393398,31,88,86,2,29,2
"3732","DN4 - Alfinetada e agulhada","D27",0.111111111111111,0.00200713940072537,36,83,83,0,32,4
"3733","DN4 - Adormecimento","D27",0.0909090909090909,0.032983475967616,33,85,84,1,30,3
"3734","DN4 - Coceira","D27",0,0.63921000981023,6,113,109,4,6,0
"3735","DH4 - Hipoestesia ao toque","D27",0,0.670052424301302,5,114,110,4,5,0
"3736","DN4 - Hipoestesia a picada de agulha","D27",0.2,0.0349379793761989,5,114,111,3,4,1
"3737","DN4 - Escovação","D27",0,0.704366003832738,4,115,111,4,4,0
"3738","Fuma","D28",0.0652173913043478,0.252649548240488,46,82,80,2,43,3
"3739","Cirurgia na coluna","D28",0.0545454545454545,0.539659987297388,55,63,61,2,52,3
"3740","Aposentado","D28",0.0645161290322581,0.560245108322694,31,101,97,4,29,2
"3741","Desempregado","D28",0.08,0.369475560195933,25,105,101,4,23,2
"3742","Licenca_Medica","D28",0.0555555555555556,0.824792496504831,18,114,109,5,17,1
"3743","Aposentado_Invalidez","D28",0,0.522489903787232,8,123,117,6,8,0
"3744","Analgésicos","D28",0.0454545454545455,0.956133769531025,88,42,40,2,84,4
"3745","OutraDoenca","D28",0.06,0.551952663689994,50,80,77,3,47,3
"3746","Dor nas costas","D28",0.0549450549450549,0.498141763008267,91,37,36,1,86,5
"3747","Dor nas pernas","D28",0.0181818181818182,0.177267085933399,55,72,67,5,54,1
"3748","Retornar_trabalho","D28",0.1,0.266574970439957,20,99,95,4,18,2
"3749","Masc","D28",0.0340909090909091,0.440720541547737,88,48,45,3,85,3
"3750","Fem","D28",0.0625,0.440720541547737,48,88,85,3,45,3
"3751","Casado/Amasiaado","D28",0.0363636363636364,0.716717460270094,55,81,77,4,53,2
"3752","Solteiro","D28",0.0677966101694915,0.239165302464729,59,77,75,2,55,4
"3753","Separado_Divorciado","D28",0,0.55947835087211,7,129,123,6,7,0
"3754","X4","D28",0,0.706710630318467,3,133,127,6,3,0
"3755","X5","D28",0,0.759543172318368,2,134,128,6,2,0
"3756","X6","D28",0,0.480305975474933,10,126,120,6,10,0
"3757","Livrar_costas","D28",0.0697674418604651,0.308033310809975,86,14,14,0,80,6
"3758","Livrar_perna","D28",0,0.308033310809975,14,86,80,6,14,0
"3759","Livrar_perda_sens","D28",NA,NA,0,100,94,6,0,0
"3760","D1","D28",0,0.829277200319907,1,135,129,6,1,0
"3761","D15","D28",0,0.55947835087211,7,129,123,6,7,0
"3762","D16","D28",0,0.298199645327366,20,116,110,6,20,0
"3763","D17","D28",0,0.62451163800975,5,131,125,6,5,0
"3764","D18","D28",0.0625,0.703068761135366,16,120,115,5,15,1
"3765","D19","D28",0,0.55947835087211,7,129,123,6,7,0
"3766","D2","D28",0.125,0.25084530450745,8,128,123,5,7,1
"3767","D20","D28",0.125,0.25084530450745,8,128,123,5,7,1
"3768","D21","D28",0.142857142857143,0.19148818093848,7,129,124,5,6,1
"3769","D22","D28",0,0.759543172318368,2,134,128,6,2,0
"3770","D23","D28",0.5,0.00156241229615405,2,134,129,5,1,1
"3771","D24","D28",0.0769230769230769,0.365080576396937,26,110,106,4,24,2
"3772","D25","D28",0.25,0.041823155446835,4,132,127,5,3,1
"3773","D26","D28",0.5,0.00156241229615405,2,134,129,5,1,1
"3774","D27","D28",0.6,6.94769406229019e-10,5,131,128,3,2,3
"3775","D28","D28",1,1.99530445797665e-31,6,130,130,0,0,6
"3776","D29","D28",0.0238095238095238,0.440773020872459,42,94,89,5,41,1
"3777","D3","D28",0,0.759543172318368,2,134,128,6,2,0
"3778","Lombalgia","D28",0.0483870967741935,0.824369595142971,62,74,71,3,59,3
"3779","D31","D28",0.176470588235294,0.00449959296490556,17,119,116,3,14,3
"3780","D32","D28",0,0.12561132373008,37,99,93,6,37,0
"3781","D33","D28",0,0.435751751824147,12,124,118,6,12,0
"3782","D34","D28",0,0.706710630318467,3,133,127,6,3,0
"3783","D35","D28",0,0.759543172318368,2,134,128,6,2,0
"3784","D36","D28",0,0.531088868258827,8,128,122,6,8,0
"3785","D37","D28",0,0.271067685431734,22,114,108,6,22,0
"3786","D38","D28",0,0.706710630318467,3,133,127,6,3,0
"3787","D39","D28",0,0.377713368845329,15,121,115,6,15,0
"3788","D4","D28",0,0.662742068301712,4,132,126,6,4,0
"3789","D40","D28",0,0.62451163800975,5,131,125,6,5,0
"3790","D41","D28",0,0.55947835087211,7,129,123,6,7,0
"3791","D42","D28",0,0.706710630318467,3,133,127,6,3,0
"3792","D43","D28",0.333333333333333,0.0136361570561041,3,133,128,5,2,1
"3793","D44","D28",0,0.118736483429802,38,98,92,6,38,0
"3794","D45","D28",0,0.435751751824147,12,124,118,6,12,0
"3795","D46","D28",0,0.118736483429802,38,98,92,6,38,0
"3796","D47","D28",0,0.435751751824147,12,124,118,6,12,0
"3797","D48","D28",0,0.2232064450424,26,110,104,6,26,0
"3798","D49","D28",0,0.41535703107105,13,123,117,6,13,0
"3799","D5","D28",0,0.706710630318467,3,133,127,6,3,0
"3800","D50","D28",0,0.759543172318368,2,134,128,6,2,0
"3801","D51","D28",0,0.829277200319907,1,135,129,6,1,0
"3802","D52","D28",0,0.759543172318368,2,134,128,6,2,0
"3803","D53","D28",0.5,0.00156241229615405,2,134,129,5,1,1
"3804","D9","D28",0,0.829277200319907,1,135,129,6,1,0
"3805","RMDQ1_v1","D28",0.0697674418604651,0.539955041804364,43,73,71,2,40,3
"3806","RMDQ2_v1","D28",0.0851063829787234,0.177938334542549,47,69,68,1,43,4
"3807","RMDQ3_v1","D28",0.0277777777777778,0.602021867512018,36,82,78,4,35,1
"3808","RMDQ4_v1","D28",0.115384615384615,0.0363427095107848,26,92,90,2,23,3
"3809","RMDQ5_v1","D28",0.0303030303030303,0.685070666079238,33,85,81,4,32,1
"3810","RMDQ6_v1","D28",0.0689655172413793,0.413022811044145,29,89,86,3,27,2
"3811","RMDQ7_v1","D28",0.1,0.164346148470325,20,97,94,3,18,2
"3812","RMDQ8_v1","D28",0.25,0.0370277526940214,4,113,109,4,3,1
"3813","RMDQ9_v1","D28",0.111111111111111,0.118944180443227,18,99,96,3,16,2
"3814","RMDQ10_v1","D28",0.136363636363636,0.0159705379392901,22,95,93,2,19,3
"3815","RMDQ11_v1","D28",0.130434782608696,0.0203422960878968,23,94,92,2,20,3
"3816","RMDQ12_v1","D28",0.0909090909090909,0.215053785112352,22,95,92,3,20,2
"3817","RMDQ13_v1","D28",0.0909090909090909,0.215053785112352,22,95,92,3,20,2
"3818","RMDQ14_v1","D28",0.12,0.0312410511415248,25,92,90,2,22,3
"3819","RMDQ15_v1","D28",0,0.380799352580873,15,102,97,5,15,0
"3820","RMDQ16_v1","D28",0.105263157894737,0.14091465862111,19,98,95,3,17,2
"3821","RMDQ17_v1","D28",0.0454545454545455,0.944203181175876,22,95,91,4,21,1
"3822","RMDQ18_v1","D28",0.1,0.164346148470325,20,97,94,3,18,2
"3823","RMDQ19_v1","D28",0.0625,0.673968889771742,16,101,97,4,15,1
"3824","RMDQ20_v1","D28",0.0952380952380952,0.189102841692137,21,96,93,3,19,2
"3825","RMDQ21_v1","D28",0.125,0.0254219862501702,24,93,91,2,21,3
"3826","RMDQ22_v1","D28",0.05,0.859964262675104,20,97,93,4,19,1
"3827","RMDQ23_v1","D28",0.0526315789473684,0.815729808427971,19,98,94,4,18,1
"3828","RMDQ24_v1","D28",0.105263157894737,0.14091465862111,19,98,95,3,17,2
"3829","DN4 - Queimação","D28",0.0188679245283019,0.415250383291776,53,65,62,3,52,1
"3830","DN4 - Sensação de frio dolorosa","D28",0,0.303875056389333,24,94,90,4,24,0
"3831","DN4 - Choque elétrico","D28",0.0277777777777778,0.816057649600488,36,83,80,3,35,1
"3832","DN4 - Formigamento","D28",0,0.227232231770622,31,88,84,4,31,0
"3833","DN4 - Alfinetada e agulhada","D28",0.0833333333333333,0.0474893437654903,36,83,82,1,33,3
"3834","DN4 - Adormecimento","D28",0.121212121212121,0.00109208999839961,33,85,85,0,29,4
"3835","DN4 - Coceira","D28",0,0.63921000981023,6,113,109,4,6,0
"3836","DH4 - Hipoestesia ao toque","D28",0,0.670052424301302,5,114,110,4,5,0
"3837","DN4 - Hipoestesia a picada de agulha","D28",0.2,0.0349379793761989,5,114,111,3,4,1
"3838","DN4 - Escovação","D28",0,0.704366003832738,4,115,111,4,4,0
"3839","Fuma","D29",0.282608695652174,0.584747959399826,46,82,55,27,33,13
"3840","Cirurgia na coluna","D29",0.345454545454545,0.485316958495754,55,63,45,18,36,19
"3841","Aposentado","D29",0.419354838709677,0.166784306030934,31,101,72,29,18,13
"3842","Desempregado","D29",0.28,0.608321591123927,25,105,70,35,18,7
"3843","Licenca_Medica","D29",0.444444444444444,0.215871453602474,18,114,80,34,10,8
"3844","Aposentado_Invalidez","D29",0.625,0.0569431985251796,8,123,86,37,3,5
"3845","Analgésicos","D29",0.397727272727273,0.00842622352289202,88,42,35,7,53,35
"3846","OutraDoenca","D29",0.36,0.386780078685942,50,80,57,23,32,18
"3847","Dor nas costas","D29",0.406593406593407,0.00103462733480009,91,37,33,4,54,37
"3848","Dor nas pernas","D29",0.545454545454545,2.73628343171399e-06,55,72,61,11,25,30
"3849","Retornar_trabalho","D29",0.5,0.0719425090297561,20,99,70,29,10,10
"3850","Masc","D29",0.340909090909091,0.272814178064602,88,48,36,12,58,30
"3851","Fem","D29",0.25,0.272814178064602,48,88,58,30,36,12
"3852","Casado/Amasiaado","D29",0.4,0.0579005623592612,55,81,61,20,33,22
"3853","Solteiro","D29",0.220338983050847,0.0505718596724715,59,77,48,29,46,13
"3854","Separado_Divorciado","D29",0.285714285714286,0.891915120108973,7,129,89,40,5,2
"3855","X4","D29",0,0.241698399730683,3,133,91,42,3,0
"3856","X5","D29",0,0.340923749246409,2,134,92,42,2,0
"3857","X6","D29",0.5,0.173998367457132,10,126,89,37,5,5
"3858","Livrar_costas","D29",0.383720930232558,0.410174600795881,86,14,7,7,53,33
"3859","Livrar_perna","D29",0.5,0.410174600795881,14,86,53,33,7,7
"3860","Livrar_perda_sens","D29",NA,NA,0,100,60,40,0,0
"3861","D1","D29",0,0.502278826842558,1,135,93,42,1,0
"3862","D15","D29",0.571428571428571,0.122562737228077,7,129,91,38,3,4
"3863","D16","D29",0.8,2.63198503318329e-07,20,116,90,26,4,16
"3864","D17","D29",0.4,0.65297976041166,5,131,91,40,3,2
"3865","D18","D29",0.125,0.090208328874367,16,120,80,40,14,2
"3866","D19","D29",0.142857142857143,0.329126521909262,7,129,88,41,6,1
"3867","D2","D29",0.125,0.246045641215853,8,128,87,41,7,1
"3868","D20","D29",0.125,0.246045641215853,8,128,87,41,7,1
"3869","D21","D29",0.142857142857143,0.329126521909262,7,129,88,41,6,1
"3870","D22","D29",0,0.340923749246409,2,134,92,42,2,0
"3871","D23","D29",0,0.340923749246409,2,134,92,42,2,0
"3872","D24","D29",0.230769230769231,0.338127897443461,26,110,74,36,20,6
"3873","D25","D29",0.25,0.796042473837201,4,132,91,41,3,1
"3874","D26","D29",0,0.340923749246409,2,134,92,42,2,0
"3875","D27","D29",0.6,0.151029644017627,5,131,92,39,2,3
"3876","D28","D29",0.166666666666667,0.440773020872459,6,130,89,41,5,1
"3877","D29","D29",1,1.99530445797665e-31,42,94,94,0,0,42
"3878","D3","D29",0,0.340923749246409,2,134,92,42,2,0
"3879","Lombalgia","D29",0.629032258064516,1.37921187526488e-13,62,74,71,3,23,39
"3880","D31","D29",0.470588235294118,0.122754395430684,17,119,85,34,9,8
"3881","D32","D29",0.891891891891892,2.30886330246683e-19,37,99,90,9,4,33
"3882","D33","D29",0.166666666666667,0.26430861560947,12,124,84,40,10,2
"3883","D34","D29",0.333333333333333,0.925969626755765,3,133,92,41,2,1
"3884","D35","D29",0,0.340923749246409,2,134,92,42,2,0
"3885","D36","D29",0.5,0.227660180407857,8,128,90,38,4,4
"3886","D37","D29",0.772727272727273,2.68854159917071e-07,22,114,89,25,5,17
"3887","D38","D29",0,0.241698399730683,3,133,91,42,3,0
"3888","D39","D29",0.8,1.26970631245721e-05,15,121,91,30,3,12
"3889","D4","D29",0,0.174787807854308,4,132,90,42,4,0
"3890","D40","D29",0.4,0.65297976041166,5,131,91,40,3,2
"3891","D41","D29",0.857142857142857,0.00126372517647517,7,129,93,36,1,6
"3892","D42","D29",0,0.241698399730683,3,133,91,42,3,0
"3893","D43","D29",0,0.241698399730683,3,133,91,42,3,0
"3894","D44","D29",0.815789473684211,1.60593740326931e-15,38,98,87,11,7,31
"3895","D45","D29",0.25,0.644150984248652,12,124,85,39,9,3
"3896","D46","D29",0.789473684210526,4.19242449205523e-14,38,98,86,12,8,30
"3897","D47","D29",0.25,0.644150984248652,12,124,85,39,9,3
"3898","D48","D29",0.769230769230769,1.60401477515038e-08,26,110,88,22,6,20
"3899","D49","D29",0.307692307692308,0.992593373067213,13,123,85,38,9,4
"3900","D5","D29",0.333333333333333,0.925969626755765,3,133,92,41,2,1
"3901","D50","D29",0.5,0.555495854264715,2,134,93,41,1,1
"3902","D51","D29",0,0.502278826842558,1,135,93,42,1,0
"3903","D52","D29",0,0.340923749246409,2,134,92,42,2,0
"3904","D53","D29",0,0.340923749246409,2,134,92,42,2,0
"3905","D9","D29",0,0.502278826842558,1,135,93,42,1,0
"3906","RMDQ1_v1","D29",0.372093023255814,0.74279722869292,43,73,47,26,27,16
"3907","RMDQ2_v1","D29",0.319148936170213,0.549534480400945,47,69,42,27,32,15
"3908","RMDQ3_v1","D29",0.444444444444444,0.183329022795282,36,82,56,26,20,16
"3909","RMDQ4_v1","D29",0.384615384615385,0.729381301984325,26,92,60,32,16,10
"3910","RMDQ5_v1","D29",0.515151515151515,0.0243988930803844,33,85,60,25,16,17
"3911","RMDQ6_v1","D29",0.482758620689655,0.100486495604777,29,89,61,28,15,14
"3912","RMDQ7_v1","D29",0.45,0.351335992977655,20,97,64,33,11,9
"3913","RMDQ8_v1","D29",0.25,0.6438549649288,4,113,72,41,3,1
"3914","RMDQ9_v1","D29",0.5,0.175118476880782,18,99,66,33,9,9
"3915","RMDQ10_v1","D29",0.409090909090909,0.586566166961994,22,95,62,33,13,9
"3916","RMDQ11_v1","D29",0.434782608695652,0.397803086724352,23,94,62,32,13,10
"3917","RMDQ12_v1","D29",0.454545454545455,0.299712642157489,22,95,63,32,12,10
"3918","RMDQ13_v1","D29",0.5,0.125947232882611,22,95,64,31,11,11
"3919","RMDQ14_v1","D29",0.4,0.62964197037303,25,92,60,32,15,10
"3920","RMDQ15_v1","D29",0.4,0.722775646432368,15,102,66,36,9,6
"3921","RMDQ16_v1","D29",0.473684210526316,0.254742236818866,19,98,65,33,10,9
"3922","RMDQ17_v1","D29",0.363636363636364,0.959653987902759,22,95,61,34,14,8
"3923","RMDQ18_v1","D29",0.4,0.674443958608444,20,97,63,34,12,8
"3924","RMDQ19_v1","D29",0.5625,0.0677608838433293,16,101,68,33,7,9
"3925","RMDQ20_v1","D29",0.428571428571429,0.462956524719494,21,96,63,33,12,9
"3926","RMDQ21_v1","D29",0.458333333333333,0.255063039636742,24,93,62,31,13,11
"3927","RMDQ22_v1","D29",0.5,0.14875437441928,20,97,65,32,10,10
"3928","RMDQ23_v1","D29",0.473684210526316,0.254742236818866,19,98,65,33,10,9
"3929","RMDQ24_v1","D29",0.473684210526316,0.254742236818866,19,98,65,33,10,9
"3930","DN4 - Queimação","D29",0.377358490566038,0.426492950580159,53,65,45,20,33,20
"3931","DN4 - Sensação de frio dolorosa","D29",0.375,0.676215800887989,24,94,63,31,15,9
"3932","DN4 - Choque elétrico","D29",0.388888888888889,0.50254031345675,36,83,56,27,22,14
"3933","DN4 - Formigamento","D29",0.354838709677419,0.888387738139097,31,88,58,30,20,11
"3934","DN4 - Alfinetada e agulhada","D29",0.277777777777778,0.31284224067714,36,83,52,31,26,10
"3935","DN4 - Adormecimento","D29",0.393939393939394,0.431985702698184,33,85,58,27,20,13
"3936","DN4 - Coceira","D29",0.166666666666667,0.346778696019672,6,113,73,40,5,1
"3937","DH4 - Hipoestesia ao toque","D29",0,0.0976520625454602,5,114,73,41,5,0
"3938","DN4 - Hipoestesia a picada de agulha","D29",0,0.0976520625454602,5,114,73,41,5,0
"3939","DN4 - Escovação","D29",0,0.140206003079748,4,115,74,41,4,0
"3940","Fuma","D3",0.0434782608695652,0.0570268627122226,46,82,82,0,44,2
"3941","Cirurgia na coluna","D3",0,0.348070916478987,55,63,62,1,55,0
"3942","Aposentado","D3",0,0.429821621542201,31,101,99,2,31,0
"3943","Desempregado","D3",0.04,0.265838463903265,25,105,104,1,24,1
"3944","Licenca_Medica","D3",0,0.571218616780325,18,114,112,2,18,0
"3945","Aposentado_Invalidez","D3",0.125,0.00899304927632024,8,123,122,1,7,1
"3946","Analgésicos","D3",0.0227272727272727,0.324814833547299,88,42,42,0,86,2
"3947","OutraDoenca","D3",0.04,0.0714234577298519,50,80,80,0,48,2
"3948","Dor nas costas","D3",0.021978021978022,0.363404269902099,91,37,37,0,89,2
"3949","Dor nas pernas","D3",0.0181818181818182,0.847314996250213,55,72,71,1,54,1
"3950","Retornar_trabalho","D3",0.05,0.205485590404682,20,99,98,1,19,1
"3951","Masc","D3",0.0227272727272727,0.292693309963762,88,48,48,0,86,2
"3952","Fem","D3",0,0.292693309963762,48,88,86,2,48,0
"3953","Casado/Amasiaado","D3",0,0.240392003376903,55,81,79,2,55,0
"3954","Solteiro","D3",0.0169491525423729,0.849120602315612,59,77,76,1,58,1
"3955","Separado_Divorciado","D3",0,0.739976909027013,7,129,127,2,7,0
"3956","X4","D3",0.333333333333333,3.54931258649229e-06,3,133,132,1,2,1
"3957","X5","D3",0,0.861819671758601,2,134,132,2,2,0
"3958","X6","D3",0,0.688146459888278,10,126,124,2,10,0
"3959","Livrar_costas","D3",0.0116279069767442,0.685105670480977,86,14,14,0,85,1
"3960","Livrar_perna","D3",0,0.685105670480977,14,86,85,1,14,0
"3961","Livrar_perda_sens","D3",NA,NA,0,100,99,1,0,0
"3962","D1","D3",0,0.902407153906854,1,135,133,2,1,0
"3963","D15","D3",0,0.739976909027013,7,129,127,2,7,0
"3964","D16","D3",0,0.554127697484356,20,116,114,2,20,0
"3965","D17","D3",0,0.780748527710185,5,131,129,2,5,0
"3966","D18","D3",0.0625,0.0908805539668756,16,120,119,1,15,1
"3967","D19","D3",0.285714285714286,9.58651296580466e-10,7,129,129,0,5,2
"3968","D2","D3",0.25,1.20573574480081e-08,8,128,128,0,6,2
"3969","D20","D3",0,0.721704213787294,8,128,126,2,8,0
"3970","D21","D3",0,0.739976909027013,7,129,127,2,7,0
"3971","D22","D3",0,0.861819671758601,2,134,132,2,2,0
"3972","D23","D3",0,0.861819671758601,2,134,132,2,2,0
"3973","D24","D3",0.0384615384615385,0.263175050261802,26,110,109,1,25,1
"3974","D25","D3",0,0.804124066880639,4,132,130,2,4,0
"3975","D26","D3",0,0.861819671758601,2,134,132,2,2,0
"3976","D27","D3",0,0.780748527710185,5,131,129,2,5,0
"3977","D28","D3",0,0.759543172318368,6,130,128,2,6,0
"3978","D29","D3",0,0.340923749246409,42,94,92,2,42,0
"3979","D3","D3",1,1.99530445797663e-31,2,134,134,0,0,2
"3980","Lombalgia","D3",0.0161290322580645,0.899570795089937,62,74,73,1,61,1
"3981","D31","D3",0,0.590234194210651,17,119,117,2,17,0
"3982","D32","D3",0,0.383757260247278,37,99,97,2,37,0
"3983","D33","D3",0,0.657612161666932,12,124,122,2,12,0
"3984","D34","D3",0,0.830565083280277,3,133,131,2,3,0
"3985","D35","D3",0,0.861819671758601,2,134,132,2,2,0
"3986","D36","D3",0,0.721704213787294,8,128,126,2,8,0
"3987","D37","D3",0,0.531393754170243,22,114,112,2,22,0
"3988","D38","D3",0,0.830565083280277,3,133,131,2,3,0
"3989","D39","D3",0,0.615926597177117,15,121,119,2,15,0
"3990","D4","D3",0.5,2.73570508534012e-16,4,132,132,0,2,2
"3991","D40","D3",0,0.780748527710185,5,131,129,2,5,0
"3992","D41","D3",0,0.739976909027013,7,129,127,2,7,0
"3993","D42","D3",0,0.830565083280277,3,133,131,2,3,0
"3994","D43","D3",0,0.830565083280277,3,133,131,2,3,0
"3995","D44","D3",0,0.374983020515037,38,98,96,2,38,0
"3996","D45","D3",0,0.657612161666932,12,124,122,2,12,0
"3997","D46","D3",0.0263157894736842,0.483675186223837,38,98,97,1,37,1
"3998","D47","D3",0.0833333333333333,0.0386095472359837,12,124,123,1,11,1
"3999","D48","D3",0,0.488520668794022,26,110,108,2,26,0
"4000","D49","D3",0,0.643234299777126,13,123,121,2,13,0
"4001","D5","D3",0,0.830565083280277,3,133,131,2,3,0
"4002","D50","D3",0,0.861819671758601,2,134,132,2,2,0
"4003","D51","D3",0,0.902407153906854,1,135,133,2,1,0
"4004","D52","D3",0,0.861819671758601,2,134,132,2,2,0
"4005","D53","D3",0,0.861819671758601,2,134,132,2,2,0
"4006","D9","D3",0,0.902407153906854,1,135,133,2,1,0
"4007","RMDQ1_v1","D3",0.0232558139534884,0.920972823893012,43,73,72,1,42,1
"4008","RMDQ2_v1","D3",0.0212765957446809,0.954032179312802,47,69,68,1,46,1
"4009","RMDQ3_v1","D3",0.0277777777777778,0.545973330618042,36,82,81,1,35,1
"4010","RMDQ4_v1","D3",0,0.448293654715812,26,92,90,2,26,0
"4011","RMDQ5_v1","D3",0.0303030303030303,0.483790516345729,33,85,84,1,32,1
"4012","RMDQ6_v1","D3",0.0344827586206897,0.399633662575936,29,89,88,1,28,1
"4013","RMDQ7_v1","D3",0.05,0.212447592946906,20,97,96,1,19,1
"4014","RMDQ8_v1","D3",0,0.788407006817525,4,113,111,2,4,0
"4015","RMDQ9_v1","D3",0.0555555555555556,0.17114046257831,18,99,98,1,17,1
"4016","RMDQ10_v1","D3",0.0454545454545455,0.254752373169046,22,95,94,1,21,1
"4017","RMDQ11_v1","D3",0.0434782608695652,0.276118902707155,23,94,93,1,22,1
"4018","RMDQ12_v1","D3",0.0454545454545455,0.254752373169046,22,95,94,1,21,1
"4019","RMDQ13_v1","D3",0.0454545454545455,0.254752373169046,22,95,94,1,21,1
"4020","RMDQ14_v1","D3",0.04,0.319048948084802,25,92,91,1,24,1
"4021","RMDQ15_v1","D3",0.0666666666666667,0.112657006702594,15,102,101,1,14,1
"4022","RMDQ16_v1","D3",0.0526315789473684,0.191631215221544,19,98,97,1,18,1
"4023","RMDQ17_v1","D3",0.0454545454545455,0.254752373169046,22,95,94,1,21,1
"4024","RMDQ18_v1","D3",0.05,0.212447592946906,20,97,96,1,19,1
"4025","RMDQ19_v1","D3",0.0625,0.131531494087171,16,101,100,1,15,1
"4026","RMDQ20_v1","D3",0.0476190476190476,0.233510138206751,21,96,95,1,20,1
"4027","RMDQ21_v1","D3",0.0416666666666667,0.297563754888929,24,93,92,1,23,1
"4028","RMDQ22_v1","D3",0.05,0.212447592946906,20,97,96,1,19,1
"4029","RMDQ23_v1","D3",0.0526315789473684,0.191631215221544,19,98,97,1,18,1
"4030","RMDQ24_v1","D3",0.0526315789473684,0.191631215221544,19,98,97,1,18,1
"4031","DN4 - Queimação","D3",0.0377358490566038,0.114199645019226,53,65,65,0,51,2
"4032","DN4 - Sensação de frio dolorosa","D3",0,0.471079632468736,24,94,92,2,24,0
"4033","DN4 - Choque elétrico","D3",0.0555555555555556,0.0303398211599874,36,83,83,0,34,2
"4034","DN4 - Formigamento","D3",0,0.39726507436377,31,88,86,2,31,0
"4035","DN4 - Alfinetada e agulhada","D3",0.0555555555555556,0.0303398211599874,36,83,83,0,34,2
"4036","DN4 - Adormecimento","D3",0.0303030303030303,0.483790516345729,33,85,84,1,32,1
"4037","DN4 - Coceira","D3",0.166666666666667,0.00338470231249276,6,113,112,1,5,1
"4038","DH4 - Hipoestesia ao toque","D3",0.2,0.00113082615896294,5,114,113,1,4,1
"4039","DN4 - Hipoestesia a picada de agulha","D3",0.2,0.00113082615896294,5,114,113,1,4,1
"4040","DN4 - Escovação","D3",0.25,0.000223631269562627,4,115,114,1,3,1
"4041","Fuma","Lombalgia",0.369565217391304,0.120355302225518,46,82,40,42,29,17
"4042","Cirurgia na coluna","Lombalgia",0.490909090909091,0.497745388138535,55,63,36,27,28,27
"4043","Aposentado","Lombalgia",0.645161290322581,0.0252328425788867,31,101,59,42,11,20
"4044","Desempregado","Lombalgia",0.52,0.631350353730321,25,105,56,49,12,13
"4045","Licenca_Medica","Lombalgia",0.555555555555556,0.432226825910745,18,114,62,52,8,10
"4046","Aposentado_Invalidez","Lombalgia",0.875,0.0166013910290389,8,123,69,54,1,7
"4047","Analgésicos","Lombalgia",0.602272727272727,3.4436982135305e-05,88,42,33,9,35,53
"4048","OutraDoenca","Lombalgia",0.52,0.359146156585886,50,80,45,35,24,26
"4049","Dor nas costas","Lombalgia",0.615384615384615,8.1543225775394e-07,91,37,32,5,35,56
"4050","Dor nas pernas","Lombalgia",0.727272727272727,1.12376429601106e-06,55,72,51,21,15,40
"4051","Retornar_trabalho","Lombalgia",0.85,0.000193739782631283,20,99,60,39,3,17
"4052","Masc","Lombalgia",0.477272727272727,0.497666697348367,88,48,28,20,46,42
"4053","Fem","Lombalgia",0.416666666666667,0.497666697348367,48,88,46,42,28,20
"4054","Casado/Amasiaado","Lombalgia",0.527272727272727,0.16837384044546,55,81,48,33,26,29
"4055","Solteiro","Lombalgia",0.406779661016949,0.314209850376933,59,77,39,38,35,24
"4056","Separado_Divorciado","Lombalgia",0.428571428571429,0.881580443764654,7,129,70,59,4,3
"4057","X4","Lombalgia",0,0.108893323090039,3,133,71,62,3,0
"4058","X5","Lombalgia",0,0.192198319028589,2,134,72,62,2,0
"4059","X6","Lombalgia",0.6,0.341773301122051,10,126,70,56,4,6
"4060","Livrar_costas","Lombalgia",0.593023255813954,0.388321448368179,86,14,4,10,35,51
"4061","Livrar_perna","Lombalgia",0.714285714285714,0.388321448368179,14,86,35,51,4,10
"4062","Livrar_perda_sens","Lombalgia",NA,NA,0,100,39,61,0,0
"4063","D1","Lombalgia",0,0.358242727739549,1,135,73,62,1,0
"4064","D15","Lombalgia",0.285714285714286,0.353317884063431,7,129,69,60,5,2
"4065","D16","Lombalgia",0.8,0.000820691942325468,20,116,70,46,4,16
"4066","D17","Lombalgia",0.2,0.241783630662983,5,131,70,61,4,1
"4067","D18","Lombalgia",0.25,0.0783580118101856,16,120,62,58,12,4
"4068","D19","Lombalgia",0.571428571428571,0.528537006380904,7,129,71,58,3,4
"4069","D2","Lombalgia",0.25,0.228129672633251,8,128,68,60,6,2
"4070","D20","Lombalgia",0.625,0.322184815759104,8,128,71,57,3,5
"4071","D21","Lombalgia",0.714285714285714,0.158702812311957,7,129,72,57,2,5
"4072","D22","Lombalgia",0.5,0.899570795089937,2,134,73,61,1,1
"4073","D23","Lombalgia",1,0.119586736538819,2,134,74,60,0,2
"4074","D24","Lombalgia",0.5,0.615508442635526,26,110,61,49,13,13
"4075","D25","Lombalgia",0.75,0.230590653140493,4,132,73,59,1,3
"4076","D26","Lombalgia",0.5,0.899570795089937,2,134,73,61,1,1
"4077","D27","Lombalgia",0.8,0.115447042524874,5,131,73,58,1,4
"4078","D28","Lombalgia",0.5,0.824369595142971,6,130,71,59,3,3
"4079","D29","Lombalgia",0.928571428571429,1.37921187526488e-13,42,94,71,23,3,39
"4080","D3","Lombalgia",0.5,0.899570795089937,2,134,73,61,1,1
"4081","Lombalgia","Lombalgia",1,1.99530445797665e-31,62,74,74,0,0,62
"4082","D31","Lombalgia",0.647058823529412,0.0906595540722505,17,119,68,51,6,11
"4083","D32","Lombalgia",0.918918918918919,3.39818683286669e-11,37,99,71,28,3,34
"4084","D33","Lombalgia",0.75,0.0321625129820207,12,124,71,53,3,9
"4085","D34","Lombalgia",0,0.108893323090039,3,133,71,62,3,0
"4086","D35","Lombalgia",0,0.192198319028589,2,134,72,62,2,0
"4087","D36","Lombalgia",0.25,0.228129672633251,8,128,68,60,6,2
"4088","D37","Lombalgia",0.681818181818182,0.0201241874750731,22,114,67,47,7,15
"4089","D38","Lombalgia",0,0.108893323090039,3,133,71,62,3,0
"4090","D39","Lombalgia",0.8,0.00455422104548561,15,121,71,50,3,12
"4091","D4","Lombalgia",0.25,0.401364312380006,4,132,71,61,3,1
"4092","D40","Lombalgia",0.2,0.241783630662983,5,131,70,61,4,1
"4093","D41","Lombalgia",0.571428571428571,0.528537006380904,7,129,71,58,3,4
"4094","D42","Lombalgia",0.333333333333333,0.666494321244379,3,133,72,61,2,1
"4095","D43","Lombalgia",0.333333333333333,0.666494321244379,3,133,72,61,2,1
"4096","D44","Lombalgia",0.868421052631579,1.79817778216813e-09,38,98,69,29,5,33
"4097","D45","Lombalgia",0.833333333333333,0.00597055526165822,12,124,72,52,2,10
"4098","D46","Lombalgia",0.868421052631579,1.79817778216813e-09,38,98,69,29,5,33
"4099","D47","Lombalgia",0.75,0.0321625129820207,12,124,71,53,3,9
"4100","D48","Lombalgia",0.884615384615385,1.05759235370063e-06,26,110,71,39,3,23
"4101","D49","Lombalgia",0.846153846153846,0.00296964331889492,13,123,72,51,2,11
"4102","D5","Lombalgia",0.333333333333333,0.666494321244379,3,133,72,61,2,1
"4103","D50","Lombalgia",0,0.192198319028589,2,134,72,62,2,0
"4104","D51","Lombalgia",0,0.358242727739549,1,135,73,62,1,0
"4105","D52","Lombalgia",0,0.192198319028589,2,134,72,62,2,0
"4106","D53","Lombalgia",0,0.192198319028589,2,134,72,62,2,0
"4107","D9","Lombalgia",0,0.358242727739549,1,135,73,62,1,0
"4108","RMDQ1_v1","Lombalgia",0.627906976744186,0.138764242058155,43,73,39,34,16,27
"4109","RMDQ2_v1","Lombalgia",0.595744680851064,0.266469052617695,47,69,36,33,19,28
"4110","RMDQ3_v1","Lombalgia",0.666666666666667,0.0417661530807971,36,82,44,38,12,24
"4111","RMDQ4_v1","Lombalgia",0.576923076923077,0.551467259341997,26,92,45,47,11,15
"4112","RMDQ5_v1","Lombalgia",0.727272727272727,0.00622015451316101,33,85,47,38,9,24
"4113","RMDQ6_v1","Lombalgia",0.689655172413793,0.0414143166396466,29,89,47,42,9,20
"4114","RMDQ7_v1","Lombalgia",0.65,0.205966241630309,20,97,49,48,7,13
"4115","RMDQ8_v1","Lombalgia",0.75,0.351633021218575,4,113,55,58,1,3
"4116","RMDQ9_v1","Lombalgia",0.666666666666667,0.179747246137126,18,99,50,49,6,12
"4117","RMDQ10_v1","Lombalgia",0.681818181818182,0.0945435791383965,22,95,49,46,7,15
"4118","RMDQ11_v1","Lombalgia",0.652173913043478,0.161203767460244,23,94,48,46,8,15
"4119","RMDQ12_v1","Lombalgia",0.636363636363636,0.230814196634122,22,95,48,47,8,14
"4120","RMDQ13_v1","Lombalgia",0.636363636363636,0.230814196634122,22,95,48,47,8,14
"4121","RMDQ14_v1","Lombalgia",0.68,0.0733644710807919,25,92,48,44,8,17
"4122","RMDQ15_v1","Lombalgia",0.666666666666667,0.227623540145872,15,102,51,51,5,10
"4123","RMDQ16_v1","Lombalgia",0.684210526315789,0.120524579592681,19,98,50,48,6,13
"4124","RMDQ17_v1","Lombalgia",0.590909090909091,0.468681529434374,22,95,47,48,9,13
"4125","RMDQ18_v1","Lombalgia",0.7,0.0790298022673549,20,97,50,47,6,14
"4126","RMDQ19_v1","Lombalgia",0.75,0.0487911470170059,16,101,52,49,4,12
"4127","RMDQ20_v1","Lombalgia",0.666666666666667,0.141158982275601,21,96,49,47,7,14
"4128","RMDQ21_v1","Lombalgia",0.666666666666667,0.109985422370149,24,93,48,45,8,16
"4129","RMDQ22_v1","Lombalgia",0.7,0.0790298022673549,20,97,50,47,6,14
"4130","RMDQ23_v1","Lombalgia",0.736842105263158,0.0399394320646895,19,98,51,47,5,14
"4131","RMDQ24_v1","Lombalgia",0.684210526315789,0.120524579592681,19,98,50,48,6,13
"4132","DN4 - Queimação","Lombalgia",0.584905660377358,0.0302170854629842,53,65,40,25,22,31
"4133","DN4 - Sensação de frio dolorosa","Lombalgia",0.541666666666667,0.460846035509305,24,94,51,43,11,13
"4134","DN4 - Choque elétrico","Lombalgia",0.638888888888889,0.0214744404722358,36,83,49,34,13,23
"4135","DN4 - Formigamento","Lombalgia",0.612903225806452,0.0826378864105217,31,88,50,38,12,19
"4136","DN4 - Alfinetada e agulhada","Lombalgia",0.555555555555556,0.270856455210731,36,83,46,37,16,20
"4137","DN4 - Adormecimento","Lombalgia",0.636363636363636,0.0283122434292819,33,85,50,35,12,21
"4138","DN4 - Coceira","Lombalgia",0.5,0.915812340238761,6,113,59,54,3,3
"4139","DH4 - Hipoestesia ao toque","Lombalgia",0.4,0.717917055169856,5,114,59,55,3,2
"4140","DN4 - Hipoestesia a picada de agulha","Lombalgia",0.4,0.717917055169856,5,114,59,55,3,2
"4141","DN4 - Escovação","Lombalgia",0.5,0.931817682458751,4,115,60,55,2,2
"4142","Fuma","D31",0.173913043478261,0.210109578976528,46,82,74,8,38,8
"4143","Cirurgia na coluna","D31",0.145454545454545,0.25269735986155,55,63,58,5,47,8
"4144","Aposentado","D31",0.0967741935483871,0.633645101438005,31,101,88,13,28,3
"4145","Desempregado","D31",0.16,0.531786062941489,25,105,93,12,21,4
"4146","Licenca_Medica","D31",0.222222222222222,0.157676405918824,18,114,102,12,14,4
"4147","Aposentado_Invalidez","D31",0.125,0.979641612736218,8,123,108,15,7,1
"4148","Analgésicos","D31",0.102272727272727,0.163029976970274,88,42,34,8,79,9
"4149","OutraDoenca","D31",0.16,0.434505708431121,50,80,71,9,42,8
"4150","Dor nas costas","D31",0.153846153846154,0.271474624108083,91,37,34,3,77,14
"4151","Dor nas pernas","D31",0.2,0.0557139595987118,55,72,66,6,44,11
"4152","Retornar_trabalho","D31",0.15,0.82319184115033,20,99,86,13,17,3
"4153","Masc","D31",0.113636363636364,0.58743218885099,88,48,41,7,78,10
"4154","Fem","D31",0.145833333333333,0.58743218885099,48,88,78,10,41,7
"4155","Casado/Amasiaado","D31",0.0909090909090909,0.321892619823972,55,81,69,12,50,5
"4156","Solteiro","D31",0.169491525423729,0.169656213236931,59,77,70,7,49,10
"4157","Separado_Divorciado","D31",0,0.30452718874533,7,129,112,17,7,0
"4158","X4","D31",0.333333333333333,0.269885467194664,3,133,117,16,2,1
"4159","X5","D31",0,0.590234194210651,2,134,117,17,2,0
"4160","X6","D31",0.1,0.803863176758422,10,126,110,16,9,1
"4161","Livrar_costas","D31",0.151162790697674,0.213902495888319,86,14,10,4,73,13
"4162","Livrar_perna","D31",0.285714285714286,0.213902495888319,14,86,73,13,10,4
"4163","Livrar_perda_sens","D31",NA,NA,0,100,83,17,0,0
"4164","D1","D31",0,0.704419244092944,1,135,118,17,1,0
"4165","D15","D31",0.571428571428571,0.000245366968341328,7,129,116,13,3,4
"4166","D16","D31",0.05,0.272143386891802,20,116,100,16,19,1
"4167","D17","D31",0.2,0.605380068057658,5,131,115,16,4,1
"4168","D18","D31",0.0625,0.420965220516746,16,120,104,16,15,1
"4169","D19","D31",0,0.30452718874533,7,129,112,17,7,0
"4170","D2","D31",0.125,1,8,128,112,16,7,1
"4171","D20","D31",0,0.270485005102042,8,128,111,17,8,0
"4172","D21","D31",0,0.30452718874533,7,129,112,17,7,0
"4173","D22","D31",0,0.590234194210651,2,134,117,17,2,0
"4174","D23","D31",0,0.590234194210651,2,134,117,17,2,0
"4175","D24","D31",0.115384615384615,0.869068482970259,26,110,96,14,23,3
"4176","D25","D31",0,0.442904989463355,4,132,115,17,4,0
"4177","D26","D31",0.5,0.106204613306305,2,134,118,16,1,1
"4178","D27","D31",0.2,0.605380068057658,5,131,115,16,4,1
"4179","D28","D31",0.5,0.00449959296490556,6,130,116,14,3,3
"4180","D29","D31",0.19047619047619,0.122754395430684,42,94,85,9,34,8
"4181","D3","D31",0,0.590234194210651,2,134,117,17,2,0
"4182","Lombalgia","D31",0.17741935483871,0.0906595540722505,62,74,68,6,51,11
"4183","D31","D31",1,1.99530445797665e-31,17,119,119,0,0,17
"4184","D32","D31",0.0810810810810811,0.343755059633725,37,99,85,14,34,3
"4185","D33","D31",0.666666666666667,2.81808467319097e-09,12,124,115,9,4,8
"4186","D34","D31",0.333333333333333,0.269885467194664,3,133,117,16,2,1
"4187","D35","D31",0,0.590234194210651,2,134,117,17,2,0
"4188","D36","D31",0.375,0.0275318938756295,8,128,114,14,5,3
"4189","D37","D31",0.0454545454545455,0.217870675476856,22,114,98,16,21,1
"4190","D38","D31",0.666666666666667,0.00412229618707091,3,133,118,15,1,2
"4191","D39","D31",0,0.120677904754018,15,121,104,17,15,0
"4192","D4","D31",0,0.442904989463355,4,132,115,17,4,0
"4193","D40","D31",0.6,0.00106675541333213,5,131,117,14,2,3
"4194","D41","D31",0.142857142857143,0.883383097185362,7,129,113,16,6,1
"4195","D42","D31",0,0.507973906584138,3,133,116,17,3,0
"4196","D43","D31",0,0.507973906584138,3,133,116,17,3,0
"4197","D44","D31",0.105263157894737,0.66474018967914,38,98,85,13,34,4
"4198","D45","D31",0.583333333333333,4.96329069364611e-07,12,124,114,10,5,7
"4199","D46","D31",0.105263157894737,0.66474018967914,38,98,85,13,34,4
"4200","D47","D31",0.666666666666667,2.81808467319097e-09,12,124,115,9,4,8
"4201","D48","D31",0.0384615384615385,0.137921328212535,26,110,94,16,25,1
"4202","D49","D31",0.538461538461538,2.13875802145062e-06,13,123,113,10,6,7
"4203","D5","D31",0.333333333333333,0.269885467194664,3,133,117,16,2,1
"4204","D50","D31",0.5,0.106204613306305,2,134,118,16,1,1
"4205","D51","D31",0,0.704419244092944,1,135,118,17,1,0
"4206","D52","D31",0,0.590234194210651,2,134,117,17,2,0
"4207","D53","D31",0,0.590234194210651,2,134,117,17,2,0
"4208","D9","D31",0,0.704419244092944,1,135,118,17,1,0
"4209","RMDQ1_v1","D31",0.186046511627907,0.597590232588871,43,73,64,9,35,8
"4210","RMDQ2_v1","D31",0.170212765957447,0.76810092592651,47,69,60,9,39,8
"4211","RMDQ3_v1","D31",0.0833333333333333,0.213186511666148,36,82,68,14,33,3
"4212","RMDQ4_v1","D31",0.0769230769230769,0.26951218312028,26,92,77,15,24,2
"4213","RMDQ5_v1","D31",0.0909090909090909,0.3055459316822,33,85,71,14,30,3
"4214","RMDQ6_v1","D31",0.103448275862069,0.473213640547643,29,89,75,14,26,3
"4215","RMDQ7_v1","D31",0.15,0.947761616195463,20,97,83,14,17,3
"4216","RMDQ8_v1","D31",0.25,0.545419649321645,4,113,97,16,3,1
"4217","RMDQ9_v1","D31",0.166666666666667,0.779739960140811,18,99,85,14,15,3
"4218","RMDQ10_v1","D31",0.136363636363636,0.894996496016723,22,95,81,14,19,3
"4219","RMDQ11_v1","D31",0.130434782608696,0.821447265417518,23,94,80,14,20,3
"4220","RMDQ12_v1","D31",0.136363636363636,0.894996496016723,22,95,81,14,19,3
"4221","RMDQ13_v1","D31",0.136363636363636,0.894996496016723,22,95,81,14,19,3
"4222","RMDQ14_v1","D31",0.12,0.685627428475482,25,92,78,14,22,3
"4223","RMDQ15_v1","D31",0.0666666666666667,0.354677720671371,15,102,86,16,14,1
"4224","RMDQ16_v1","D31",0.157894736842105,0.864829085571817,19,98,84,14,16,3
"4225","RMDQ17_v1","D31",0.136363636363636,0.894996496016723,22,95,81,14,19,3
"4226","RMDQ18_v1","D31",0.15,0.947761616195463,20,97,83,14,17,3
"4227","RMDQ19_v1","D31",0.125,0.804143372262422,16,101,86,15,14,2
"4228","RMDQ20_v1","D31",0.142857142857143,0.972034308139522,21,96,82,14,18,3
"4229","RMDQ21_v1","D31",0.125,0.751610571829307,24,93,79,14,21,3
"4230","RMDQ22_v1","D31",0.15,0.947761616195463,20,97,83,14,17,3
"4231","RMDQ23_v1","D31",0.157894736842105,0.864829085571817,19,98,84,14,16,3
"4232","RMDQ24_v1","D31",0.157894736842105,0.864829085571817,19,98,84,14,16,3
"4233","DN4 - Queimação","D31",0.188679245283019,0.128264070919867,53,65,59,6,43,10
"4234","DN4 - Sensação de frio dolorosa","D31",0.0416666666666667,0.132095622319054,24,94,79,15,23,1
"4235","DN4 - Choque elétrico","D31",0.305555555555556,0.000314120929291655,36,83,78,5,25,11
"4236","DN4 - Formigamento","D31",0.225806451612903,0.0829510273928639,31,88,79,9,24,7
"4237","DN4 - Alfinetada e agulhada","D31",0.277777777777778,0.00254135637681665,36,83,77,6,26,10
"4238","DN4 - Adormecimento","D31",0.242424242424242,0.0346806473890254,33,85,77,8,25,8
"4239","DN4 - Coceira","D31",0,0.32182195153957,6,113,97,16,6,0
"4240","DH4 - Hipoestesia ao toque","D31",0,0.367894241007966,5,114,98,16,5,0
"4241","DN4 - Hipoestesia a picada de agulha","D31",0,0.367894241007966,5,114,98,16,5,0
"4242","DN4 - Escovação","D31",0,0.422636739271226,4,115,99,16,4,0
"4243","Fuma","D32",0.239130434782609,0.427296371965607,46,82,57,25,35,11
"4244","Cirurgia na coluna","D32",0.272727272727273,0.9719381907556,55,63,46,17,40,15
"4245","Aposentado","D32",0.32258064516129,0.549079018955791,31,101,74,27,21,10
"4246","Desempregado","D32",0.12,0.04239340512222,25,105,71,34,22,3
"4247","Licenca_Medica","D32",0.333333333333333,0.589871951342166,18,114,83,31,12,6
"4248","Aposentado_Invalidez","D32",0.5,0.140902609084574,8,123,91,32,4,4
"4249","Analgésicos","D32",0.375,0.000946868254264692,88,42,38,4,55,33
"4250","OutraDoenca","D32",0.3,0.642035101825467,50,80,59,21,35,15
"4251","Dor nas costas","D32",0.362637362637363,0.00131912599647501,91,37,34,3,58,33
"4252","Dor nas pernas","D32",0.545454545454545,1.02969545357968e-08,55,72,66,6,25,30
"4253","Retornar_trabalho","D32",0.35,0.425959883996565,20,99,73,26,13,7
"4254","Masc","D32",0.318181818181818,0.101725444761412,88,48,39,9,60,28
"4255","Fem","D32",0.1875,0.101725444761412,48,88,60,28,39,9
"4256","Casado/Amasiaado","D32",0.327272727272727,0.233152621693,55,81,62,19,37,18
"4257","Solteiro","D32",0.220338983050847,0.235468053998213,59,77,53,24,46,13
"4258","Separado_Divorciado","D32",0.285714285714286,0.933566397165882,7,129,94,35,5,2
"4259","X4","D32",0,0.284282472208915,3,133,96,37,3,0
"4260","X5","D32",0,0.383757260247278,2,134,97,37,2,0
"4261","X6","D32",0.4,0.344899751882013,10,126,93,33,6,4
"4262","Livrar_costas","D32",0.337209302325581,0.239276499269037,86,14,7,7,57,29
"4263","Livrar_perna","D32",0.5,0.239276499269037,14,86,57,29,7,7
"4264","Livrar_perda_sens","D32",NA,NA,0,100,64,36,0,0
"4265","D1","D32",0,0.539479231806348,1,135,98,37,1,0
"4266","D15","D32",0.142857142857143,0.430286953545862,7,129,93,36,6,1
"4267","D16","D32",0.85,3.20175248906849e-10,20,116,96,20,3,17
"4268","D17","D32",0.2,0.712191012113425,5,131,95,36,4,1
"4269","D18","D32",0.0625,0.0449379562318231,16,120,84,36,15,1
"4270","D19","D32",0.142857142857143,0.430286953545862,7,129,93,36,6,1
"4271","D2","D32",0,0.0746923495739824,8,128,91,37,8,0
"4272","D20","D32",0,0.0746923495739824,8,128,91,37,8,0
"4273","D21","D32",0.142857142857143,0.430286953545862,7,129,93,36,6,1
"4274","D22","D32",0,0.383757260247278,2,134,97,37,2,0
"4275","D23","D32",0,0.383757260247278,2,134,97,37,2,0
"4276","D24","D32",0.153846153846154,0.132050003979671,26,110,77,33,22,4
"4277","D25","D32",0,0.214580448957259,4,132,95,37,4,0
"4278","D26","D32",0,0.383757260247278,2,134,97,37,2,0
"4279","D27","D32",0.4,0.512459696857517,5,131,96,35,3,2
"4280","D28","D32",0,0.12561132373008,6,130,93,37,6,0
"4281","D29","D32",0.785714285714286,2.30886330246683e-19,42,94,90,4,9,33
"4282","D3","D32",0,0.383757260247278,2,134,97,37,2,0
"4283","Lombalgia","D32",0.548387096774194,3.39818683286669e-11,62,74,71,3,28,34
"4284","D31","D32",0.176470588235294,0.343755059633725,17,119,85,34,14,3
"4285","D32","D32",1,1.99530445797665e-31,37,99,99,0,0,37
"4286","D33","D32",0.25,0.857289318892686,12,124,90,34,9,3
"4287","D34","D32",0,0.284282472208915,3,133,96,37,3,0
"4288","D35","D32",0,0.383757260247278,2,134,97,37,2,0
"4289","D36","D32",0.125,0.335330849506851,8,128,92,36,7,1
"4290","D37","D32",0.727272727272727,1.60229963404033e-07,22,114,93,21,6,16
"4291","D38","D32",0,0.284282472208915,3,133,96,37,3,0
"4292","D39","D32",0.866666666666667,4.10617765272736e-08,15,121,97,24,2,13
"4293","D4","D32",0,0.214580448957259,4,132,95,37,4,0
"4294","D40","D32",0,0.16366736200703,5,131,94,37,5,0
"4295","D41","D32",0.571428571428571,0.0676280434071588,7,129,96,33,3,4
"4296","D42","D32",0.333333333333333,0.809431421074835,3,133,97,36,2,1
"4297","D43","D32",0,0.284282472208915,3,133,96,37,3,0
"4298","D44","D32",0.842105263157895,1.37757029319158e-20,38,98,93,5,6,32
"4299","D45","D32",0.25,0.857289318892686,12,124,90,34,9,3
"4300","D46","D32",0.789473684210526,3.08741234119152e-17,38,98,91,7,8,30
"4301","D47","D32",0.166666666666667,0.390247963076714,12,124,89,35,10,2
"4302","D48","D32",0.807692307692308,8.84533478750784e-12,26,110,94,16,5,21
"4303","D49","D32",0.307692307692308,0.76145100328292,13,123,90,33,9,4
"4304","D5","D32",0,0.284282472208915,3,133,96,37,3,0
"4305","D50","D32",0,0.383757260247278,2,134,97,37,2,0
"4306","D51","D32",0,0.539479231806348,1,135,98,37,1,0
"4307","D52","D32",0.5,0.465541796275196,2,134,98,36,1,1
"4308","D53","D32",0,0.383757260247278,2,134,97,37,2,0
"4309","D9","D32",0,0.539479231806348,1,135,98,37,1,0
"4310","RMDQ1_v1","D32",0.348837209302326,0.687819627425963,43,73,51,22,28,15
"4311","RMDQ2_v1","D32",0.297872340425532,0.730128878109783,47,69,46,23,33,14
"4312","RMDQ3_v1","D32",0.416666666666667,0.109685573722337,36,82,60,22,21,15
"4313","RMDQ4_v1","D32",0.307692307692308,0.94178381711529,26,92,63,29,18,8
"4314","RMDQ5_v1","D32",0.484848484848485,0.0124562963042038,33,85,64,21,17,16
"4315","RMDQ6_v1","D32",0.448275862068966,0.0717742484575685,29,89,65,24,16,13
"4316","RMDQ7_v1","D32",0.5,0.0522641699448741,20,97,70,27,10,10
"4317","RMDQ8_v1","D32",0.25,0.771897165960905,4,113,77,36,3,1
"4318","RMDQ9_v1","D32",0.444444444444444,0.203508542098318,18,99,70,29,10,8
"4319","RMDQ10_v1","D32",0.363636363636364,0.595724348514155,22,95,66,29,14,8
"4320","RMDQ11_v1","D32",0.391304347826087,0.387744320673872,23,94,66,28,14,9
"4321","RMDQ12_v1","D32",0.454545454545455,0.121576839489585,22,95,68,27,12,10
"4322","RMDQ13_v1","D32",0.454545454545455,0.121576839489585,22,95,68,27,12,10
"4323","RMDQ14_v1","D32",0.36,0.595674078532934,25,92,64,28,16,9
"4324","RMDQ15_v1","D32",0.466666666666667,0.179643317519845,15,102,72,30,8,7
"4325","RMDQ16_v1","D32",0.421052631578947,0.28303452459432,19,98,69,29,11,8
"4326","RMDQ17_v1","D32",0.318181818181818,0.982651985520405,22,95,65,30,15,7
"4327","RMDQ18_v1","D32",0.35,0.721396218577618,20,97,67,30,13,7
"4328","RMDQ19_v1","D32",0.5625,0.0226100314380063,16,101,73,28,7,9
"4329","RMDQ20_v1","D32",0.380952380952381,0.481406246914079,21,96,67,29,13,8
"4330","RMDQ21_v1","D32",0.416666666666667,0.235337191916833,24,93,66,27,14,10
"4331","RMDQ22_v1","D32",0.45,0.157705102959809,20,97,69,28,11,9
"4332","RMDQ23_v1","D32",0.421052631578947,0.28303452459432,19,98,69,29,11,8
"4333","RMDQ24_v1","D32",0.421052631578947,0.28303452459432,19,98,69,29,11,8
"4334","DN4 - Queimação","D32",0.339622641509434,0.355648448700288,53,65,48,17,35,18
"4335","DN4 - Sensação de frio dolorosa","D32",0.333333333333333,0.658997444668027,24,94,67,27,16,8
"4336","DN4 - Choque elétrico","D32",0.333333333333333,0.629869187939028,36,83,59,24,24,12
"4337","DN4 - Formigamento","D32",0.354838709677419,0.460863469086601,31,88,63,25,20,11
"4338","DN4 - Alfinetada e agulhada","D32",0.25,0.411396162515402,36,83,56,27,27,9
"4339","DN4 - Adormecimento","D32",0.363636363636364,0.320606593923282,33,85,62,23,21,12
"4340","DN4 - Coceira","D32",0.166666666666667,0.457221398349819,6,113,78,35,5,1
"4341","DH4 - Hipoestesia ao toque","D32",0,0.132429438284423,5,114,78,36,5,0
"4342","DN4 - Hipoestesia a picada de agulha","D32",0,0.132429438284423,5,114,78,36,5,0
"4343","DN4 - Escovação","D32",0,0.180283502753194,4,115,79,36,4,0
"4344","Fuma","D33",0.0869565217391304,0.975421663860221,46,82,75,7,42,4
"4345","Cirurgia na coluna","D33",0.0727272727272727,0.892205853201895,55,63,58,5,51,4
"4346","Aposentado","D33",0.032258064516129,0.239491685490066,31,101,91,10,30,1
"4347","Desempregado","D33",0.04,0.372458603077569,25,105,95,10,24,1
"4348","Licenca_Medica","D33",0,0.168668618887815,18,114,103,11,18,0
"4349","Aposentado_Invalidez","D33",0,0.401389692847172,8,123,113,10,8,0
"4350","Analgésicos","D33",0.0909090909090909,0.936441443032889,88,42,38,4,80,8
"4351","OutraDoenca","D33",0.08,0.701522711884324,50,80,72,8,46,4
"4352","Dor nas costas","D33",0.0989010989010989,0.753858312966399,91,37,34,3,82,9
"4353","Dor nas pernas","D33",0.163636363636364,0.0198896607881082,55,72,69,3,46,9
"4354","Retornar_trabalho","D33",0.05,0.547528200173061,20,99,90,9,19,1
"4355","Masc","D33",0.0795454545454545,0.628548760174048,88,48,43,5,81,7
"4356","Fem","D33",0.104166666666667,0.628548760174048,48,88,81,7,43,5
"4357","Casado/Amasiaado","D33",0.0727272727272727,0.599295017189989,55,81,73,8,51,4
"4358","Solteiro","D33",0.11864406779661,0.273768136718333,59,77,72,5,52,7
"4359","Separado_Divorciado","D33",0,0.398060116685702,7,129,117,12,7,0
"4360","X4","D33",0.333333333333333,0.130153483589304,3,133,122,11,2,1
"4361","X5","D33",0,0.657612161666932,2,134,122,12,2,0
"4362","X6","D33",0,0.306766347454945,10,126,114,12,10,0
"4363","Livrar_costas","D33",0.0930232558139535,0.0396368172231428,86,14,10,4,78,8
"4364","Livrar_perna","D33",0.285714285714286,0.0396368172231428,14,86,78,8,10,4
"4365","Livrar_perda_sens","D33",NA,NA,0,100,88,12,0,0
"4366","D1","D33",0,0.75486151575449,1,135,123,12,1,0
"4367","D15","D33",0.285714285714286,0.0585717946693723,7,129,119,10,5,2
"4368","D16","D33",0.05,0.513907330318457,20,116,105,11,19,1
"4369","D17","D33",0,0.478474042466117,5,131,119,12,5,0
"4370","D18","D33",0,0.185269593670831,16,120,108,12,16,0
"4371","D19","D33",0,0.398060116685702,7,129,117,12,7,0
"4372","D2","D33",0,0.364426724716409,8,128,116,12,8,0
"4373","D20","D33",0,0.364426724716409,8,128,116,12,8,0
"4374","D21","D33",0.285714285714286,0.0585717946693723,7,129,119,10,5,2
"4375","D22","D33",0,0.657612161666932,2,134,122,12,2,0
"4376","D23","D33",0,0.657612161666932,2,134,122,12,2,0
"4377","D24","D33",0.0384615384615385,0.319764612861751,26,110,99,11,25,1
"4378","D25","D33",0,0.527695676048595,4,132,120,12,4,0
"4379","D26","D33",0,0.657612161666932,2,134,122,12,2,0
"4380","D27","D33",0,0.478474042466117,5,131,119,12,5,0
"4381","D28","D33",0,0.435751751824147,6,130,118,12,6,0
"4382","D29","D33",0.0476190476190476,0.26430861560947,42,94,84,10,40,2
"4383","D3","D33",0,0.657612161666932,2,134,122,12,2,0
"4384","Lombalgia","D33",0.145161290322581,0.0321625129820207,62,74,71,3,53,9
"4385","D31","D33",0.470588235294118,2.81808467319097e-09,17,119,115,4,9,8
"4386","D32","D33",0.0810810810810811,0.857289318892686,37,99,90,9,34,3
"4387","D33","D33",1,1.99530445797665e-31,12,124,124,0,0,12
"4388","D34","D33",0,0.585850572100077,3,133,121,12,3,0
"4389","D35","D33",0,0.657612161666932,2,134,122,12,2,0
"4390","D36","D33",0.25,0.096359635700202,8,128,118,10,6,2
"4391","D37","D33",0,0.111001947689872,22,114,102,12,22,0
"4392","D38","D33",0.666666666666667,0.000354464736547489,3,133,123,10,1,2
"4393","D39","D33",0,0.201486735257118,15,121,109,12,15,0
"4394","D4","D33",0,0.527695676048595,4,132,120,12,4,0
"4395","D40","D33",0.4,0.0122700258445425,5,131,121,10,3,2
"4396","D41","D33",0,0.398060116685702,7,129,117,12,7,0
"4397","D42","D33",0,0.585850572100077,3,133,121,12,3,0
"4398","D43","D33",0,0.585850572100077,3,133,121,12,3,0
"4399","D44","D33",0.0789473684210526,0.812039387153345,38,98,89,9,35,3
"4400","D45","D33",0.666666666666667,1.37822593414904e-13,12,124,120,4,4,8
"4401","D46","D33",0.0789473684210526,0.812039387153345,38,98,89,9,35,3
"4402","D47","D33",0.583333333333333,2.41159060124652e-10,12,124,119,5,5,7
"4403","D48","D33",0.0384615384615385,0.319764612861751,26,110,99,11,25,1
"4404","D49","D33",0.692307692307692,6.77601989263865e-16,13,123,120,3,4,9
"4405","D5","D33",0,0.585850572100077,3,133,121,12,3,0
"4406","D50","D33",0,0.657612161666932,2,134,122,12,2,0
"4407","D51","D33",0,0.75486151575449,1,135,123,12,1,0
"4408","D52","D33",0,0.657612161666932,2,134,122,12,2,0
"4409","D53","D33",0,0.657612161666932,2,134,122,12,2,0
"4410","D9","D33",0,0.75486151575449,1,135,123,12,1,0
"4411","RMDQ1_v1","D33",0.13953488372093,0.582170908878456,43,73,67,6,37,6
"4412","RMDQ2_v1","D33",0.106382978723404,0.940510844341231,47,69,62,7,42,5
"4413","RMDQ3_v1","D33",0.0277777777777778,0.0783691601235595,36,82,71,11,35,1
"4414","RMDQ4_v1","D33",0,0.0520168860438896,26,92,80,12,26,0
"4415","RMDQ5_v1","D33",0.0303030303030303,0.109880046842287,33,85,74,11,32,1
"4416","RMDQ6_v1","D33",0.0344827586206897,0.16792704685569,29,89,78,11,28,1
"4417","RMDQ7_v1","D33",0.05,0.394788570407184,20,97,86,11,19,1
"4418","RMDQ8_v1","D33",0,0.491461520297486,4,113,101,12,4,0
"4419","RMDQ9_v1","D33",0.0555555555555556,0.474829810654609,18,99,88,11,17,1
"4420","RMDQ10_v1","D33",0.0909090909090909,0.8415073123212,22,95,85,10,20,2
"4421","RMDQ11_v1","D33",0.0434782608695652,0.297401424086814,23,94,83,11,22,1
"4422","RMDQ12_v1","D33",0.0454545454545455,0.327168795969465,22,95,84,11,21,1
"4423","RMDQ13_v1","D33",0.0454545454545455,0.327168795969465,22,95,84,11,21,1
"4424","RMDQ14_v1","D33",0.04,0.244921732627562,25,92,81,11,24,1
"4425","RMDQ15_v1","D33",0.0666666666666667,0.623569558117348,15,102,91,11,14,1
"4426","RMDQ16_v1","D33",0.0526315789473684,0.433119831393324,19,98,87,11,18,1
"4427","RMDQ17_v1","D33",0.0454545454545455,0.327168795969465,22,95,84,11,21,1
"4428","RMDQ18_v1","D33",0.05,0.394788570407184,20,97,86,11,19,1
"4429","RMDQ19_v1","D33",0.0625,0.569679711109244,16,101,90,11,15,1
"4430","RMDQ20_v1","D33",0.0476190476190476,0.359555505535032,21,96,85,11,20,1
"4431","RMDQ21_v1","D33",0.0416666666666667,0.27004794320233,24,93,82,11,23,1
"4432","RMDQ22_v1","D33",0.05,0.394788570407184,20,97,86,11,19,1
"4433","RMDQ23_v1","D33",0.105263157894737,0.966202918505237,19,98,88,10,17,2
"4434","RMDQ24_v1","D33",0.0526315789473684,0.433119831393324,19,98,87,11,18,1
"4435","DN4 - Queimação","D33",0.132075471698113,0.324155928560668,53,65,60,5,46,7
"4436","DN4 - Sensação de frio dolorosa","D33",0.0833333333333333,0.738794323369912,24,94,84,10,22,2
"4437","DN4 - Choque elétrico","D33",0.194444444444444,0.0255298524370368,36,83,78,5,29,7
"4438","DN4 - Formigamento","D33",0.290322580645161,4.61660587381643e-05,31,88,85,3,22,9
"4439","DN4 - Alfinetada e agulhada","D33",0.194444444444444,0.0255298524370368,36,83,78,5,29,7
"4440","DN4 - Adormecimento","D33",0.181818181818182,0.072771525257529,33,85,79,6,27,6
"4441","DN4 - Coceira","D33",0.166666666666667,0.582656910389208,6,113,102,11,5,1
"4442","DH4 - Hipoestesia ao toque","D33",0,0.444226067014997,5,114,102,12,5,0
"4443","DN4 - Hipoestesia a picada de agulha","D33",0,0.444226067014997,5,114,102,12,5,0
"4444","DN4 - Escovação","D33",0,0.495666894505734,4,115,103,12,4,0
"4445","Fuma","D34",0.0652173913043478,0.0192774091404522,46,82,82,0,43,3
"4446","Cirurgia na coluna","D34",0.0363636363636364,0.126868659625014,55,63,63,0,53,2
"4447","Aposentado","D34",0.032258064516129,0.683966586356629,31,101,99,2,30,1
"4448","Desempregado","D34",0.08,0.0349279503975996,25,105,104,1,23,2
"4449","Licenca_Medica","D34",0.111111111111111,0.0067800176274091,18,114,113,1,16,2
"4450","Aposentado_Invalidez","D34",0,0.654967047400161,8,123,120,3,8,0
"4451","Analgésicos","D34",0.0227272727272727,0.969342526948564,88,42,41,1,86,2
"4452","OutraDoenca","D34",0.02,0.853450236972764,50,80,78,2,49,1
"4453","Dor nas costas","D34",0.021978021978022,0.8640934850506,91,37,36,1,89,2
"4454","Dor nas pernas","D34",0.0181818181818182,0.724215349818446,55,72,70,2,54,1
"4455","Retornar_trabalho","D34",0,0.43040343200463,20,99,96,3,20,0
"4456","Masc","D34",0.0113636363636364,0.250216747845471,88,48,46,2,87,1
"4457","Fem","D34",0.0416666666666667,0.250216747845471,48,88,87,1,46,2
"4458","Casado/Amasiaado","D34",0.0181818181818182,0.799755909415403,55,81,79,2,54,1
"4459","Solteiro","D34",0.0338983050847458,0.410577598948078,59,77,76,1,57,2
"4460","Separado_Divorciado","D34",0,0.683274873050331,7,129,126,3,7,0
"4461","X4","D34",0,0.792511685634946,3,133,130,3,3,0
"4462","X5","D34",0,0.830565083280277,2,134,131,3,2,0
"4463","X6","D34",0,0.621714056090023,10,126,123,3,10,0
"4464","Livrar_costas","D34",0.0232558139534884,0.564351319818157,86,14,14,0,84,2
"4465","Livrar_perna","D34",0,0.564351319818157,14,86,84,2,14,0
"4466","Livrar_perda_sens","D34",NA,NA,0,100,98,2,0,0
"4467","D1","D34",0,0.880178390709511,1,135,132,3,1,0
"4468","D15","D34",0.142857142857143,0.0254648673683159,7,129,127,2,6,1
"4469","D16","D34",0.05,0.356947483268678,20,116,114,2,19,1
"4470","D17","D34",0,0.732216032264721,5,131,128,3,5,0
"4471","D18","D34",0,0.522466034450895,16,120,117,3,16,0
"4472","D19","D34",0,0.683274873050331,7,129,126,3,7,0
"4473","D2","D34",0.25,6.04963738671134e-06,8,128,127,1,6,2
"4474","D20","D34",0,0.66148119738657,8,128,125,3,8,0
"4475","D21","D34",0,0.683274873050331,7,129,126,3,7,0
"4476","D22","D34",0,0.830565083280277,2,134,131,3,2,0
"4477","D23","D34",0,0.830565083280277,2,134,131,3,2,0
"4478","D24","D34",0.0384615384615385,0.526615348065255,26,110,108,2,25,1
"4479","D25","D34",0,0.760447734150187,4,132,129,3,4,0
"4480","D26","D34",0,0.830565083280277,2,134,131,3,2,0
"4481","D27","D34",0,0.732216032264721,5,131,128,3,5,0
"4482","D28","D34",0,0.706710630318467,6,130,127,3,6,0
"4483","D29","D34",0.0238095238095238,0.925969626755765,42,94,92,2,41,1
"4484","D3","D34",0,0.830565083280277,2,134,131,3,2,0
"4485","Lombalgia","D34",0,0.108893323090039,62,74,71,3,62,0
"4486","D31","D34",0.0588235294117647,0.269885467194664,17,119,117,2,16,1
"4487","D32","D34",0,0.284282472208915,37,99,96,3,37,0
"4488","D33","D34",0,0.585850572100077,12,124,121,3,12,0
"4489","D34","D34",1,1.99530445797668e-31,3,133,133,0,0,3
"4490","D35","D34",0.5,3.54931258649229e-06,2,134,132,2,1,1
"4491","D36","D34",0,0.66148119738657,8,128,125,3,8,0
"4492","D37","D34",0.0454545454545455,0.414470989930587,22,114,112,2,21,1
"4493","D38","D34",0,0.792511685634946,3,133,130,3,3,0
"4494","D39","D34",0,0.537448305795192,15,121,118,3,15,0
"4495","D4","D34",0.25,0.00162957881054941,4,132,130,2,3,1
"4496","D40","D34",0,0.732216032264721,5,131,128,3,5,0
"4497","D41","D34",0,0.683274873050331,7,129,126,3,7,0
"4498","D42","D34",0,0.792511685634946,3,133,130,3,3,0
"4499","D43","D34",0.333333333333333,0.000205681391078371,3,133,131,2,2,1
"4500","D44","D34",0,0.275429552882231,38,98,95,3,38,0
"4501","D45","D34",0,0.585850572100077,12,124,121,3,12,0
"4502","D46","D34",0,0.275429552882231,38,98,95,3,38,0
"4503","D47","D34",0,0.585850572100077,12,124,121,3,12,0
"4504","D48","D34",0,0.394480841695529,26,110,107,3,26,0
"4505","D49","D34",0,0.569079451848605,13,123,120,3,13,0
"4506","D5","D34",0.666666666666667,1.50720442587269e-14,3,133,132,1,1,2
"4507","D50","D34",1,2.39360797585802e-21,2,134,133,1,0,2
"4508","D51","D34",1,2.34190534565149e-11,1,135,133,2,0,1
"4509","D52","D34",0.5,3.54931258649229e-06,2,134,132,2,1,1
"4510","D53","D34",0.5,3.54931258649229e-06,2,134,132,2,1,1
"4511","D9","D34",1,2.34190534565149e-11,1,135,133,2,0,1
"4512","RMDQ1_v1","D34",0.0232558139534884,0.920972823893012,43,73,72,1,42,1
"4513","RMDQ2_v1","D34",0.0212765957446809,0.954032179312802,47,69,68,1,46,1
"4514","RMDQ3_v1","D34",0.0277777777777778,0.545973330618042,36,82,81,1,35,1
"4515","RMDQ4_v1","D34",0,0.448293654715812,26,92,90,2,26,0
"4516","RMDQ5_v1","D34",0.0303030303030303,0.483790516345729,33,85,84,1,32,1
"4517","RMDQ6_v1","D34",0.0344827586206897,0.399633662575936,29,89,88,1,28,1
"4518","RMDQ7_v1","D34",0.05,0.212447592946906,20,97,96,1,19,1
"4519","RMDQ8_v1","D34",0,0.788407006817525,4,113,111,2,4,0
"4520","RMDQ9_v1","D34",0.0555555555555556,0.17114046257831,18,99,98,1,17,1
"4521","RMDQ10_v1","D34",0.0454545454545455,0.254752373169046,22,95,94,1,21,1
"4522","RMDQ11_v1","D34",0.0434782608695652,0.276118902707155,23,94,93,1,22,1
"4523","RMDQ12_v1","D34",0.0454545454545455,0.254752373169046,22,95,94,1,21,1
"4524","RMDQ13_v1","D34",0.0454545454545455,0.254752373169046,22,95,94,1,21,1
"4525","RMDQ14_v1","D34",0.04,0.319048948084802,25,92,91,1,24,1
"4526","RMDQ15_v1","D34",0.0666666666666667,0.112657006702594,15,102,101,1,14,1
"4527","RMDQ16_v1","D34",0.0526315789473684,0.191631215221544,19,98,97,1,18,1
"4528","RMDQ17_v1","D34",0.0454545454545455,0.254752373169046,22,95,94,1,21,1
"4529","RMDQ18_v1","D34",0.05,0.212447592946906,20,97,96,1,19,1
"4530","RMDQ19_v1","D34",0.0625,0.131531494087171,16,101,100,1,15,1
"4531","RMDQ20_v1","D34",0.0476190476190476,0.233510138206751,21,96,95,1,20,1
"4532","RMDQ21_v1","D34",0.0416666666666667,0.297563754888929,24,93,92,1,23,1
"4533","RMDQ22_v1","D34",0.05,0.212447592946906,20,97,96,1,19,1
"4534","RMDQ23_v1","D34",0.0526315789473684,0.191631215221544,19,98,97,1,18,1
"4535","RMDQ24_v1","D34",0.0526315789473684,0.191631215221544,19,98,97,1,18,1
"4536","DN4 - Queimação","D34",0.0377358490566038,0.442942687132334,53,65,64,1,51,2
"4537","DN4 - Sensação de frio dolorosa","D34",0.0416666666666667,0.571125001077476,24,94,92,2,23,1
"4538","DN4 - Choque elétrico","D34",0.0555555555555556,0.164313056647265,36,83,82,1,34,2
"4539","DN4 - Formigamento","D34",0.0645161290322581,0.104500621656448,31,88,87,1,29,2
"4540","DN4 - Alfinetada e agulhada","D34",0.0555555555555556,0.164313056647265,36,83,82,1,34,2
"4541","DN4 - Adormecimento","D34",0.0606060606060606,0.130326862481361,33,85,84,1,31,2
"4542","DN4 - Coceira","D34",0.166666666666667,0.0233141434108428,6,113,111,2,5,1
"4543","DH4 - Hipoestesia ao toque","D34",0.4,4.70813487421436e-08,5,114,113,1,3,2
"4544","DN4 - Hipoestesia a picada de agulha","D34",0.4,4.70813487421436e-08,5,114,113,1,3,2
"4545","DN4 - Escovação","D34",0.5,7.18853818890754e-10,4,115,114,1,2,2
"4546","Fuma","D35",0.0434782608695652,0.0570268627122226,46,82,82,0,44,2
"4547","Cirurgia na coluna","D35",0.0363636363636364,0.126868659625014,55,63,63,0,53,2
"4548","Aposentado","D35",0.032258064516129,0.372732044491854,31,101,100,1,30,1
"4549","Desempregado","D35",0.08,0.00349099856431804,25,105,105,0,23,2
"4550","Licenca_Medica","D35",0.0555555555555556,0.131038190578192,18,114,113,1,17,1
"4551","Aposentado_Invalidez","D35",0,0.71626653488051,8,123,121,2,8,0
"4552","Analgésicos","D35",0.0227272727272727,0.324814833547299,88,42,42,0,86,2
"4553","OutraDoenca","D35",0.02,0.73534779052376,50,80,79,1,49,1
"4554","Dor nas costas","D35",0.021978021978022,0.363404269902099,91,37,37,0,89,2
"4555","Dor nas pernas","D35",0.0181818181818182,0.847314996250213,55,72,71,1,54,1
"4556","Retornar_trabalho","D35",0,0.52148919720768,20,99,97,2,20,0
"4557","Masc","D35",0.0227272727272727,0.292693309963762,88,48,48,0,86,2
"4558","Fem","D35",0,0.292693309963762,48,88,86,2,48,0
"4559","Casado/Amasiaado","D35",0,0.240392003376903,55,81,79,2,55,0
"4560","Solteiro","D35",0.0338983050847458,0.103606764411036,59,77,77,0,57,2
"4561","Separado_Divorciado","D35",0,0.739976909027013,7,129,127,2,7,0
"4562","X4","D35",0,0.830565083280277,3,133,131,2,3,0
"4563","X5","D35",0,0.861819671758601,2,134,132,2,2,0
"4564","X6","D35",0,0.688146459888278,10,126,124,2,10,0
"4565","Livrar_costas","D35",0.0116279069767442,0.685105670480977,86,14,14,0,85,1
"4566","Livrar_perna","D35",0,0.685105670480977,14,86,85,1,14,0
"4567","Livrar_perda_sens","D35",NA,NA,0,100,99,1,0,0
"4568","D1","D35",0,0.902407153906854,1,135,133,2,1,0
"4569","D15","D35",0.142857142857143,0.00382637942754141,7,129,128,1,6,1
"4570","D16","D35",0.05,0.155663891032951,20,116,115,1,19,1
"4571","D17","D35",0,0.780748527710185,5,131,129,2,5,0
"4572","D18","D35",0.0625,0.0908805539668756,16,120,119,1,15,1
"4573","D19","D35",0,0.739976909027013,7,129,127,2,7,0
"4574","D2","D35",0.125,0.00755433235506732,8,128,127,1,7,1
"4575","D20","D35",0,0.721704213787294,8,128,126,2,8,0
"4576","D21","D35",0,0.739976909027013,7,129,127,2,7,0
"4577","D22","D35",0,0.861819671758601,2,134,132,2,2,0
"4578","D23","D35",0,0.861819671758601,2,134,132,2,2,0
"4579","D24","D35",0,0.488520668794022,26,110,108,2,26,0
"4580","D25","D35",0,0.804124066880639,4,132,130,2,4,0
"4581","D26","D35",0,0.861819671758601,2,134,132,2,2,0
"4582","D27","D35",0,0.780748527710185,5,131,129,2,5,0
"4583","D28","D35",0,0.759543172318368,6,130,128,2,6,0
"4584","D29","D35",0,0.340923749246409,42,94,92,2,42,0
"4585","D3","D35",0,0.861819671758601,2,134,132,2,2,0
"4586","Lombalgia","D35",0,0.192198319028589,62,74,72,2,62,0
"4587","D31","D35",0,0.590234194210651,17,119,117,2,17,0
"4588","D32","D35",0,0.383757260247278,37,99,97,2,37,0
"4589","D33","D35",0,0.657612161666932,12,124,122,2,12,0
"4590","D34","D35",0.333333333333333,3.54931258649229e-06,3,133,132,1,2,1
"4591","D35","D35",1,1.99530445797663e-31,2,134,134,0,0,2
"4592","D36","D35",0,0.721704213787294,8,128,126,2,8,0
"4593","D37","D35",0.0454545454545455,0.190650271604753,22,114,113,1,21,1
"4594","D38","D35",0,0.830565083280277,3,133,131,2,3,0
"4595","D39","D35",0,0.615926597177117,15,121,119,2,15,0
"4596","D4","D35",0.5,2.73570508534012e-16,4,132,132,0,2,2
"4597","D40","D35",0,0.780748527710185,5,131,129,2,5,0
"4598","D41","D35",0,0.739976909027013,7,129,127,2,7,0
"4599","D42","D35",0,0.830565083280277,3,133,131,2,3,0
"4600","D43","D35",0,0.830565083280277,3,133,131,2,3,0
"4601","D44","D35",0,0.374983020515037,38,98,96,2,38,0
"4602","D45","D35",0,0.657612161666932,12,124,122,2,12,0
"4603","D46","D35",0,0.374983020515037,38,98,96,2,38,0
"4604","D47","D35",0,0.657612161666932,12,124,122,2,12,0
"4605","D48","D35",0,0.488520668794022,26,110,108,2,26,0
"4606","D49","D35",0,0.643234299777126,13,123,121,2,13,0
"4607","D5","D35",0.333333333333333,3.54931258649229e-06,3,133,132,1,2,1
"4608","D50","D35",0,0.861819671758601,2,134,132,2,2,0
"4609","D51","D35",1,2.11083244888566e-16,1,135,134,1,0,1
"4610","D52","D35",0,0.861819671758601,2,134,132,2,2,0
"4611","D53","D35",0,0.861819671758601,2,134,132,2,2,0
"4612","D9","D35",1,2.11083244888566e-16,1,135,134,1,0,1
"4613","RMDQ1_v1","D35",0.0232558139534884,0.419839443150142,43,73,73,0,42,1
"4614","RMDQ2_v1","D35",0.0212765957446809,0.471846992882068,47,69,69,0,46,1
"4615","RMDQ3_v1","D35",0.0277777777777778,0.1296036170137,36,82,82,0,35,1
"4616","RMDQ4_v1","D35",0,0.593426957598424,26,92,91,1,26,0
"4617","RMDQ5_v1","D35",0.0303030303030303,0.107014020238433,33,85,85,0,32,1
"4618","RMDQ6_v1","D35",0.0344827586206897,0.0785236958912466,29,89,89,0,28,1
"4619","RMDQ7_v1","D35",0.05,0.0269843768229582,20,97,97,0,19,1
"4620","RMDQ8_v1","D35",0,0.850129340451501,4,113,112,1,4,0
"4621","RMDQ9_v1","D35",0.0555555555555556,0.0185080139064539,18,99,99,0,17,1
"4622","RMDQ10_v1","D35",0.0454545454545455,0.0368916317321308,22,95,95,0,21,1
"4623","RMDQ11_v1","D35",0.0434782608695652,0.0423242826421271,23,94,94,0,22,1
"4624","RMDQ12_v1","D35",0.0454545454545455,0.0368916317321308,22,95,95,0,21,1
"4625","RMDQ13_v1","D35",0.0454545454545455,0.0368916317321308,22,95,95,0,21,1
"4626","RMDQ14_v1","D35",0.04,0.0540315515408075,25,92,92,0,24,1
"4627","RMDQ15_v1","D35",0.0666666666666667,0.00882146183803565,15,102,102,0,14,1
"4628","RMDQ16_v1","D35",0.0526315789473684,0.0225562523721356,19,98,98,0,18,1
"4629","RMDQ17_v1","D35",0.0454545454545455,0.0368916317321308,22,95,95,0,21,1
"4630","RMDQ18_v1","D35",0.05,0.0269843768229582,20,97,97,0,19,1
"4631","RMDQ19_v1","D35",0.0625,0.0116267347685025,16,101,101,0,15,1
"4632","RMDQ20_v1","D35",0.0476190476190476,0.0317705146451596,21,96,96,0,20,1
"4633","RMDQ21_v1","D35",0.0416666666666667,0.0480451702617448,24,93,93,0,23,1
"4634","RMDQ22_v1","D35",0.05,0.0269843768229582,20,97,97,0,19,1
"4635","RMDQ23_v1","D35",0.0526315789473684,0.0225562523721356,19,98,98,0,18,1
"4636","RMDQ24_v1","D35",0.0526315789473684,0.0225562523721356,19,98,98,0,18,1
"4637","DN4 - Queimação","D35",0.0188679245283019,0.266069863620088,53,65,65,0,52,1
"4638","DN4 - Sensação de frio dolorosa","D35",0,0.611841971208142,24,94,93,1,24,0
"4639","DN4 - Choque elétrico","D35",0.0277777777777778,0.127302516839353,36,83,83,0,35,1
"4640","DN4 - Formigamento","D35",0.032258064516129,0.0906514651303281,31,88,88,0,30,1
"4641","DN4 - Alfinetada e agulhada","D35",0.0277777777777778,0.127302516839353,36,83,83,0,35,1
"4642","DN4 - Adormecimento","D35",0.0303030303030303,0.107014020238433,33,85,85,0,32,1
"4643","DN4 - Coceira","D35",0.166666666666667,1.31203161243512e-05,6,113,113,0,5,1
"4644","DH4 - Hipoestesia ao toque","D35",0.2,1.6257371427835e-06,5,114,114,0,4,1
"4645","DN4 - Hipoestesia a picada de agulha","D35",0.2,1.6257371427835e-06,5,114,114,0,4,1
"4646","DN4 - Escovação","D35",0.25,7.26161658379463e-08,4,115,115,0,3,1
"4647","Fuma","D36",0.0869565217391304,0.108087059239421,46,82,80,2,42,4
"4648","Cirurgia na coluna","D36",0.109090909090909,0.00712608896570684,55,63,63,0,49,6
"4649","Aposentado","D36",0.0645161290322581,0.744241612082321,31,101,96,5,29,2
"4650","Desempregado","D36",0.08,0.519153654398101,25,105,100,5,23,2
"4651","Licenca_Medica","D36",0.166666666666667,0.0206108814462578,18,114,110,4,15,3
"4652","Aposentado_Invalidez","D36",0,0.487975992982874,8,123,116,7,8,0
"4653","Analgésicos","D36",0.0340909090909091,0.0594303771813325,88,42,37,5,85,3
"4654","OutraDoenca","D36",0.06,0.953983258857795,50,80,75,5,47,3
"4655","Dor nas costas","D36",0.043956043956044,0.17406518157812,91,37,33,4,87,4
"4656","Dor nas pernas","D36",0.0909090909090909,0.257717744087945,55,72,69,3,50,5
"4657","Retornar_trabalho","D36",0,0.188073875208292,20,99,91,8,20,0
"4658","Masc","D36",0.0568181818181818,0.892946837110376,88,48,45,3,83,5
"4659","Fem","D36",0.0625,0.892946837110376,48,88,83,5,45,3
"4660","Casado/Amasiaado","D36",0.0727272727272727,0.570140971181601,55,81,77,4,51,4
"4661","Solteiro","D36",0.0508474576271186,0.729311589180158,59,77,72,5,56,3
"4662","Separado_Divorciado","D36",0,0.497044882450256,7,129,121,8,7,0
"4663","X4","D36",0.333333333333333,0.0410139457284451,3,133,126,7,2,1
"4664","X5","D36",0,0.721704213787294,2,134,126,8,2,0
"4665","X6","D36",0,0.411451319476889,10,126,118,8,10,0
"4666","Livrar_costas","D36",0.0465116279069767,0.0225104448699356,86,14,11,3,82,4
"4667","Livrar_perna","D36",0.214285714285714,0.0225104448699356,14,86,82,4,11,3
"4668","Livrar_perda_sens","D36",NA,NA,0,100,93,7,0,0
"4669","D1","D36",0,0.801872700366009,1,135,127,8,1,0
"4670","D15","D36",0.714285714285714,3.80079434300703e-14,7,129,126,3,2,5
"4671","D16","D36",0.05,0.855906204792587,20,116,109,7,19,1
"4672","D17","D36",0.4,0.000954535942054647,5,131,125,6,3,2
"4673","D18","D36",0.125,0.23105176113783,16,120,114,6,14,2
"4674","D19","D36",0,0.497044882450256,7,129,121,8,7,0
"4675","D2","D36",0,0.466081807166599,8,128,120,8,8,0
"4676","D20","D36",0,0.466081807166599,8,128,120,8,8,0
"4677","D21","D36",0,0.497044882450256,7,129,121,8,7,0
"4678","D22","D36",0,0.721704213787294,2,134,126,8,2,0
"4679","D23","D36",0,0.721704213787294,2,134,126,8,2,0
"4680","D24","D36",0,0.156358988235655,26,110,102,8,26,0
"4681","D25","D36",0,0.611790554856623,4,132,124,8,4,0
"4682","D26","D36",0,0.721704213787294,2,134,126,8,2,0
"4683","D27","D36",0,0.568958961171041,5,131,123,8,5,0
"4684","D28","D36",0,0.531088868258827,6,130,122,8,6,0
"4685","D29","D36",0.0952380952380952,0.227660180407857,42,94,90,4,38,4
"4686","D3","D36",0,0.721704213787294,2,134,126,8,2,0
"4687","Lombalgia","D36",0.032258064516129,0.228129672633251,62,74,68,6,60,2
"4688","D31","D36",0.176470588235294,0.0275318938756295,17,119,114,5,14,3
"4689","D32","D36",0.027027027027027,0.335330849506851,37,99,92,7,36,1
"4690","D33","D36",0.166666666666667,0.096359635700202,12,124,118,6,10,2
"4691","D34","D36",0,0.66148119738657,3,133,125,8,3,0
"4692","D35","D36",0,0.721704213787294,2,134,126,8,2,0
"4693","D36","D36",1,1.99530445797665e-31,8,128,128,0,0,8
"4694","D37","D36",0.227272727272727,0.000244803192071176,22,114,111,3,17,5
"4695","D38","D36",1,2.45394149904231e-12,3,133,128,5,0,3
"4696","D39","D36",0.133333333333333,0.193517466648222,15,121,115,6,13,2
"4697","D4","D36",0,0.611790554856623,4,132,124,8,4,0
"4698","D40","D36",1,7.98650294510506e-20,5,131,128,3,0,5
"4699","D41","D36",0.571428571428571,3.25328093603584e-09,7,129,125,4,3,4
"4700","D42","D36",0,0.66148119738657,3,133,125,8,3,0
"4701","D43","D36",0,0.66148119738657,3,133,125,8,3,0
"4702","D44","D36",0.0789473684210526,0.534546578737972,38,98,93,5,35,3
"4703","D45","D36",0.166666666666667,0.096359635700202,12,124,118,6,10,2
"4704","D46","D36",0.0789473684210526,0.534546578737972,38,98,93,5,35,3
"4705","D47","D36",0.25,0.00320222636878169,12,124,119,5,9,3
"4706","D48","D36",0.0384615384615385,0.623676291683334,26,110,103,7,25,1
"4707","D49","D36",0.153846153846154,0.125743835469762,13,123,117,6,11,2
"4708","D5","D36",0,0.66148119738657,3,133,125,8,3,0
"4709","D50","D36",0,0.721704213787294,2,134,126,8,2,0
"4710","D51","D36",0,0.801872700366009,1,135,127,8,1,0
"4711","D52","D36",0,0.721704213787294,2,134,126,8,2,0
"4712","D53","D36",0,0.721704213787294,2,134,126,8,2,0
"4713","D9","D36",0,0.801872700366009,1,135,127,8,1,0
"4714","RMDQ1_v1","D36",0.0465116279069767,0.86215728196132,43,73,68,5,41,2
"4715","RMDQ2_v1","D36",0.0425531914893617,0.775367547407954,47,69,64,5,45,2
"4716","RMDQ3_v1","D36",0.0277777777777778,0.336492389359646,36,82,76,6,35,1
"4717","RMDQ4_v1","D36",0.0384615384615385,0.610084612119384,26,92,86,6,25,1
"4718","RMDQ5_v1","D36",0.0303030303030303,0.405712579214709,33,85,79,6,32,1
"4719","RMDQ6_v1","D36",0,0.119433106213211,29,89,82,7,29,0
"4720","RMDQ7_v1","D36",0,0.215341871421237,20,97,90,7,20,0
"4721","RMDQ8_v1","D36",0,0.607687652229803,4,113,106,7,4,0
"4722","RMDQ9_v1","D36",0,0.244629005571412,18,99,92,7,18,0
"4723","RMDQ10_v1","D36",0,0.189151958767347,22,95,88,7,22,0
"4724","RMDQ11_v1","D36",0,0.177103903498898,23,94,87,7,23,0
"4725","RMDQ12_v1","D36",0,0.189151958767347,22,95,88,7,22,0
"4726","RMDQ13_v1","D36",0,0.189151958767347,22,95,88,7,22,0
"4727","RMDQ14_v1","D36",0.04,0.63733801517531,25,92,86,6,24,1
"4728","RMDQ15_v1","D36",0,0.295383708358243,15,102,95,7,15,0
"4729","RMDQ16_v1","D36",0,0.229572755395786,19,98,91,7,19,0
"4730","RMDQ17_v1","D36",0,0.189151958767347,22,95,88,7,22,0
"4731","RMDQ18_v1","D36",0,0.215341871421237,20,97,90,7,20,0
"4732","RMDQ19_v1","D36",0,0.277462300625661,16,101,94,7,16,0
"4733","RMDQ20_v1","D36",0,0.201883895175961,21,96,89,7,21,0
"4734","RMDQ21_v1","D36",0,0.165701567692758,24,93,86,7,24,0
"4735","RMDQ22_v1","D36",0,0.215341871421237,20,97,90,7,20,0
"4736","RMDQ23_v1","D36",0,0.229572755395786,19,98,91,7,19,0
"4737","RMDQ24_v1","D36",0,0.229572755395786,19,98,91,7,19,0
"4738","DN4 - Queimação","D36",0.0754716981132075,0.764585157400898,53,65,61,4,49,4
"4739","DN4 - Sensação de frio dolorosa","D36",0.0416666666666667,0.568333107790654,24,94,87,7,23,1
"4740","DN4 - Choque elétrico","D36",0.0833333333333333,0.644017374799388,36,83,78,5,33,3
"4741","DN4 - Formigamento","D36",0.0967741935483871,0.444890353815475,31,88,83,5,28,3
"4742","DN4 - Alfinetada e agulhada","D36",0.166666666666667,0.00433224746463042,36,83,81,2,30,6
"4743","DN4 - Adormecimento","D36",0.0909090909090909,0.533767282950704,33,85,80,5,30,3
"4744","DN4 - Coceira","D36",0,0.499784758338323,6,113,105,8,6,0
"4745","DH4 - Hipoestesia ao toque","D36",0,0.539662498936668,5,114,106,8,5,0
"4746","DN4 - Hipoestesia a picada de agulha","D36",0,0.539662498936668,5,114,106,8,5,0
"4747","DN4 - Escovação","D36",0,0.584940252839,4,115,107,8,4,0
"4748","Fuma","D37",0.173913043478261,0.680180580869204,46,82,70,12,38,8
"4749","Cirurgia na coluna","D37",0.181818181818182,0.565684335979093,55,63,54,9,45,10
"4750","Aposentado","D37",0.290322580645161,0.0346888053005873,31,101,88,13,22,9
"4751","Desempregado","D37",0.12,0.465101502813925,25,105,86,19,22,3
"4752","Licenca_Medica","D37",0.333333333333333,0.0411841631553894,18,114,98,16,12,6
"4753","Aposentado_Invalidez","D37",0.25,0.521662740748473,8,123,103,20,6,2
"4754","Analgésicos","D37",0.204545454545455,0.120088133755193,88,42,38,4,70,18
"4755","OutraDoenca","D37",0.16,0.824386794072651,50,80,66,14,42,8
"4756","Dor nas costas","D37",0.208791208791209,0.082537057868517,91,37,34,3,72,19
"4757","Dor nas pernas","D37",0.345454545454545,7.37964654446395e-06,55,72,69,3,36,19
"4758","Retornar_trabalho","D37",0.35,0.017051652435814,20,99,86,13,13,7
"4759","Masc","D37",0.193181818181818,0.177916323257352,88,48,43,5,71,17
"4760","Fem","D37",0.104166666666667,0.177916323257352,48,88,71,17,43,5
"4761","Casado/Amasiaado","D37",0.2,0.318371483495956,55,81,70,11,44,11
"4762","Solteiro","D37",0.11864406779661,0.231933830894422,59,77,62,15,52,7
"4763","Separado_Divorciado","D37",0.142857142857143,0.889065179747181,7,129,108,21,6,1
"4764","X4","D37",0,0.441644329784114,3,133,111,22,3,0
"4765","X5","D37",0,0.531393754170243,2,134,112,22,2,0
"4766","X6","D37",0.3,0.217453761221712,10,126,107,19,7,3
"4767","Livrar_costas","D37",0.197674418604651,0.885423396371719,86,14,11,3,69,17
"4768","Livrar_perna","D37",0.214285714285714,0.885423396371719,14,86,69,17,11,3
"4769","Livrar_perda_sens","D37",NA,NA,0,100,80,20,0,0
"4770","D1","D37",0,0.659269674875409,1,135,113,22,1,0
"4771","D15","D37",0.571428571428571,0.0025092611761976,7,129,111,18,3,4
"4772","D16","D37",0.9,2.79019726204524e-22,20,116,112,4,2,18
"4773","D17","D37",0.6,0.00669900195187523,5,131,112,19,2,3
"4774","D18","D37",0.1875,0.766003152898813,16,120,101,19,13,3
"4775","D19","D37",0.142857142857143,0.889065179747181,7,129,108,21,6,1
"4776","D2","D37",0.125,0.770988426241838,8,128,107,21,7,1
"4777","D20","D37",0,0.200277333185376,8,128,106,22,8,0
"4778","D21","D37",0.142857142857143,0.889065179747181,7,129,108,21,6,1
"4779","D22","D37",0,0.531393754170243,2,134,112,22,2,0
"4780","D23","D37",0,0.531393754170243,2,134,112,22,2,0
"4781","D24","D37",0.0769230769230769,0.191449535246389,26,110,90,20,24,2
"4782","D25","D37",0,0.372495814335914,4,132,110,22,4,0
"4783","D26","D37",0,0.531393754170243,2,134,112,22,2,0
"4784","D27","D37",0.2,0.812990938704793,5,131,110,21,4,1
"4785","D28","D37",0,0.271067685431734,6,130,108,22,6,0
"4786","D29","D37",0.404761904761905,2.68854159917071e-07,42,94,89,5,25,17
"4787","D3","D37",0,0.531393754170243,2,134,112,22,2,0
"4788","Lombalgia","D37",0.241935483870968,0.0201241874750731,62,74,67,7,47,15
"4789","D31","D37",0.0588235294117647,0.217870675476856,17,119,98,21,16,1
"4790","D32","D37",0.432432432432432,1.60229963404033e-07,37,99,93,6,21,16
"4791","D33","D37",0,0.111001947689872,12,124,102,22,12,0
"4792","D34","D37",0.333333333333333,0.414470989930587,3,133,112,21,2,1
"4793","D35","D37",0.5,0.190650271604753,2,134,113,21,1,1
"4794","D36","D37",0.625,0.000244803192071176,8,128,111,17,3,5
"4795","D37","D37",1,1.99530445797665e-31,22,114,114,0,0,22
"4796","D38","D37",0.333333333333333,0.414470989930587,3,133,112,21,2,1
"4797","D39","D37",1,9.03297464573835e-21,15,121,114,7,0,15
"4798","D4","D37",0.25,0.626654692659365,4,132,111,21,3,1
"4799","D40","D37",0.6,0.00669900195187523,5,131,112,19,2,3
"4800","D41","D37",1,6.25243149640233e-10,7,129,114,15,0,7
"4801","D42","D37",0,0.441644329784114,3,133,111,22,3,0
"4802","D43","D37",0,0.441644329784114,3,133,111,22,3,0
"4803","D44","D37",0.421052631578947,3.16492530850497e-07,38,98,92,6,22,16
"4804","D45","D37",0.0833333333333333,0.43969649223599,12,124,103,21,11,1
"4805","D46","D37",0.447368421052632,1.77802875412139e-08,38,98,93,5,21,17
"4806","D47","D37",0.0833333333333333,0.43969649223599,12,124,103,21,11,1
"4807","D48","D37",0.576923076923077,1.63541453360409e-10,26,110,103,7,11,15
"4808","D49","D37",0,0.0958108631307896,13,123,101,22,13,0
"4809","D5","D37",0.333333333333333,0.414470989930587,3,133,112,21,2,1
"4810","D50","D37",0,0.531393754170243,2,134,112,22,2,0
"4811","D51","D37",1,0.022325957274565,1,135,114,21,0,1
"4812","D52","D37",0,0.531393754170243,2,134,112,22,2,0
"4813","D53","D37",0,0.531393754170243,2,134,112,22,2,0
"4814","D9","D37",1,0.022325957274565,1,135,114,21,0,1
"4815","RMDQ1_v1","D37",0.186046511627907,0.890345772774969,43,73,60,13,35,8
"4816","RMDQ2_v1","D37",0.170212765957447,0.867852209541283,47,69,56,13,39,8
"4817","RMDQ3_v1","D37",0.333333333333333,0.0034590960277488,36,82,73,9,24,12
"4818","RMDQ4_v1","D37",0.269230769230769,0.168229038481836,26,92,78,14,19,7
"4819","RMDQ5_v1","D37",0.393939393939394,0.000132447566781264,33,85,77,8,20,13
"4820","RMDQ6_v1","D37",0.344827586206897,0.00682783619766193,29,89,78,11,19,10
"4821","RMDQ7_v1","D37",0.3,0.122977375694485,20,97,82,15,14,6
"4822","RMDQ8_v1","D37",0,0.341185042678911,4,113,92,21,4,0
"4823","RMDQ9_v1","D37",0.277777777777778,0.23747929131637,18,99,83,16,13,5
"4824","RMDQ10_v1","D37",0.227272727272727,0.516883970539141,22,95,79,16,17,5
"4825","RMDQ11_v1","D37",0.260869565217391,0.25651978302958,23,94,79,15,17,6
"4826","RMDQ12_v1","D37",0.272727272727273,0.205980720535328,22,95,80,15,16,6
"4827","RMDQ13_v1","D37",0.272727272727273,0.205980720535328,22,95,80,15,16,6
"4828","RMDQ14_v1","D37",0.16,0.774629547697209,25,92,75,17,21,4
"4829","RMDQ15_v1","D37",0.266666666666667,0.346034413595767,15,102,85,17,11,4
"4830","RMDQ16_v1","D37",0.263157894736842,0.299077089450997,19,98,82,16,14,5
"4831","RMDQ17_v1","D37",0.181818181818182,0.974777189156348,22,95,78,17,18,4
"4832","RMDQ18_v1","D37",0.2,0.792908618695523,20,97,80,17,16,4
"4833","RMDQ19_v1","D37",0.375,0.0282821226473738,16,101,86,15,10,6
"4834","RMDQ20_v1","D37",0.238095238095238,0.439748411324023,21,96,80,16,16,5
"4835","RMDQ21_v1","D37",0.291666666666667,0.108220628258227,24,93,79,14,17,7
"4836","RMDQ22_v1","D37",0.3,0.122977375694485,20,97,82,15,14,6
"4837","RMDQ23_v1","D37",0.263157894736842,0.299077089450997,19,98,82,16,14,5
"4838","RMDQ24_v1","D37",0.263157894736842,0.299077089450997,19,98,82,16,14,5
"4839","DN4 - Queimação","D37",0.207547169811321,0.595012907348357,53,65,54,11,42,11
"4840","DN4 - Sensação de frio dolorosa","D37",0.166666666666667,0.871185096473233,24,94,77,17,20,4
"4841","DN4 - Choque elétrico","D37",0.25,0.228092839702289,36,83,70,13,27,9
"4842","DN4 - Formigamento","D37",0.258064516129032,0.222190142389455,31,88,74,14,23,8
"4843","DN4 - Alfinetada e agulhada","D37",0.277777777777778,0.0855472345791167,36,83,71,12,26,10
"4844","DN4 - Adormecimento","D37",0.303030303030303,0.0427437413060908,33,85,73,12,23,10
"4845","DN4 - Coceira","D37",0.333333333333333,0.336392058412393,6,113,93,20,4,2
"4846","DH4 - Hipoestesia ao toque","D37",0.2,0.929067031228355,5,114,93,21,4,1
"4847","DN4 - Hipoestesia a picada de agulha","D37",0.2,0.929067031228355,5,114,93,21,4,1
"4848","DN4 - Escovação","D37",0.25,0.732864282036451,4,115,94,21,3,1
"4849","Fuma","D38",0.0652173913043478,0.0192774091404522,46,82,82,0,43,3
"4850","Cirurgia na coluna","D38",0.0363636363636364,0.126868659625014,55,63,63,0,53,2
"4851","Aposentado","D38",0,0.429821621542201,31,101,99,2,31,0
"4852","Desempregado","D38",0,0.486782231372189,25,105,103,2,25,0
"4853","Licenca_Medica","D38",0.0555555555555556,0.131038190578192,18,114,113,1,17,1
"4854","Aposentado_Invalidez","D38",0,0.71626653488051,8,123,121,2,8,0
"4855","Analgésicos","D38",0.0113636363636364,0.197919276854603,88,42,40,2,87,1
"4856","OutraDoenca","D38",0.02,0.853450236972764,50,80,78,2,49,1
"4857","Dor nas costas","D38",0,0.00598285423779513,91,37,34,3,91,0
"4858","Dor nas pernas","D38",0.0545454545454545,0.0449027745456645,55,72,72,0,52,3
"4859","Retornar_trabalho","D38",0,0.43040343200463,20,99,96,3,20,0
"4860","Masc","D38",0.0113636363636364,0.250216747845471,88,48,46,2,87,1
"4861","Fem","D38",0.0416666666666667,0.250216747845471,48,88,87,1,46,2
"4862","Casado/Amasiaado","D38",0,0.148948627194368,55,81,78,3,55,0
"4863","Solteiro","D38",0.0338983050847458,0.410577598948078,59,77,76,1,57,2
"4864","Separado_Divorciado","D38",0,0.683274873050331,7,129,126,3,7,0
"4865","X4","D38",0.333333333333333,0.000205681391078371,3,133,131,2,2,1
"4866","X5","D38",0,0.830565083280277,2,134,131,3,2,0
"4867","X6","D38",0,0.621714056090023,10,126,123,3,10,0
"4868","Livrar_costas","D38",0,1.30819386914069e-05,86,14,11,3,86,0
"4869","Livrar_perna","D38",0.214285714285714,1.30819386914069e-05,14,86,86,0,11,3
"4870","Livrar_perda_sens","D38",NA,NA,0,100,97,3,0,0
"4871","D1","D38",0,0.880178390709511,1,135,132,3,1,0
"4872","D15","D38",0.285714285714286,1.07956281323173e-06,7,129,128,1,5,2
"4873","D16","D38",0,0.467066119740186,20,116,113,3,20,0
"4874","D17","D38",0,0.732216032264721,5,131,128,3,5,0
"4875","D18","D38",0,0.522466034450895,16,120,117,3,16,0
"4876","D19","D38",0,0.683274873050331,7,129,126,3,7,0
"4877","D2","D38",0,0.66148119738657,8,128,125,3,8,0
"4878","D20","D38",0,0.66148119738657,8,128,125,3,8,0
"4879","D21","D38",0,0.683274873050331,7,129,126,3,7,0
"4880","D22","D38",0,0.830565083280277,2,134,131,3,2,0
"4881","D23","D38",0,0.830565083280277,2,134,131,3,2,0
"4882","D24","D38",0,0.394480841695529,26,110,107,3,26,0
"4883","D25","D38",0,0.760447734150187,4,132,129,3,4,0
"4884","D26","D38",0,0.830565083280277,2,134,131,3,2,0
"4885","D27","D38",0,0.732216032264721,5,131,128,3,5,0
"4886","D28","D38",0,0.706710630318467,6,130,127,3,6,0
"4887","D29","D38",0,0.241698399730683,42,94,91,3,42,0
"4888","D3","D38",0,0.830565083280277,2,134,131,3,2,0
"4889","Lombalgia","D38",0,0.108893323090039,62,74,71,3,62,0
"4890","D31","D38",0.117647058823529,0.00412229618707091,17,119,118,1,15,2
"4891","D32","D38",0,0.284282472208915,37,99,96,3,37,0
"4892","D33","D38",0.166666666666667,0.000354464736547489,12,124,123,1,10,2
"4893","D34","D38",0,0.792511685634946,3,133,130,3,3,0
"4894","D35","D38",0,0.830565083280277,2,134,131,3,2,0
"4895","D36","D38",0.375,2.45394149904231e-12,8,128,128,0,5,3
"4896","D37","D38",0.0454545454545455,0.414470989930587,22,114,112,2,21,1
"4897","D38","D38",1,1.99530445797668e-31,3,133,133,0,0,3
"4898","D39","D38",0.0666666666666667,0.21237683034588,15,121,119,2,14,1
"4899","D4","D38",0,0.760447734150187,4,132,129,3,4,0
"4900","D40","D38",0.6,3.10012884991917e-19,5,131,131,0,2,3
"4901","D41","D38",0.142857142857143,0.0254648673683159,7,129,127,2,6,1
"4902","D42","D38",0,0.792511685634946,3,133,130,3,3,0
"4903","D43","D38",0,0.792511685634946,3,133,130,3,3,0
"4904","D44","D38",0.0263157894736842,0.833296835878753,38,98,96,2,37,1
"4905","D45","D38",0.166666666666667,0.000354464736547489,12,124,123,1,10,2
"4906","D46","D38",0.0263157894736842,0.833296835878753,38,98,96,2,37,1
"4907","D47","D38",0.25,1.79991868350688e-08,12,124,124,0,9,3
"4908","D48","D38",0,0.394480841695529,26,110,107,3,26,0
"4909","D49","D38",0.153846153846154,0.000669322543672837,13,123,122,1,11,2
"4910","D5","D38",0,0.792511685634946,3,133,130,3,3,0
"4911","D50","D38",0,0.830565083280277,2,134,131,3,2,0
"4912","D51","D38",0,0.880178390709511,1,135,132,3,1,0
"4913","D52","D38",0,0.830565083280277,2,134,131,3,2,0
"4914","D53","D38",0,0.830565083280277,2,134,131,3,2,0
"4915","D9","D38",0,0.880178390709511,1,135,132,3,1,0
"4916","RMDQ1_v1","D38",0.0232558139534884,0.977692589616264,43,73,71,2,42,1
"4917","RMDQ2_v1","D38",0.0212765957446809,0.954544274139124,47,69,67,2,46,1
"4918","RMDQ3_v1","D38",0,0.245027998211865,36,82,79,3,36,0
"4919","RMDQ4_v1","D38",0,0.350971009055765,26,92,89,3,26,0
"4920","RMDQ5_v1","D38",0,0.274305339715658,33,85,82,3,33,0
"4921","RMDQ6_v1","D38",0,0.316578729661288,29,89,86,3,29,0
"4922","RMDQ7_v1","D38",0,0.425587509741219,20,97,94,3,20,0
"4923","RMDQ8_v1","D38",0,0.741297764641791,4,113,110,3,4,0
"4924","RMDQ9_v1","D38",0,0.454337365794028,18,99,96,3,18,0
"4925","RMDQ10_v1","D38",0,0.398443266068114,22,95,92,3,22,0
"4926","RMDQ11_v1","D38",0,0.385414685011236,23,94,91,3,23,0
"4927","RMDQ12_v1","D38",0,0.398443266068114,22,95,92,3,22,0
"4928","RMDQ13_v1","D38",0,0.398443266068114,22,95,92,3,22,0
"4929","RMDQ14_v1","D38",0,0.360350754533787,25,92,89,3,25,0
"4930","RMDQ15_v1","D38",0,0.501014709533698,15,102,99,3,15,0
"4931","RMDQ16_v1","D38",0,0.439748411324023,19,98,95,3,19,0
"4932","RMDQ17_v1","D38",0,0.398443266068114,22,95,92,3,22,0
"4933","RMDQ18_v1","D38",0,0.425587509741219,20,97,94,3,20,0
"4934","RMDQ19_v1","D38",0,0.48493089059007,16,101,98,3,16,0
"4935","RMDQ20_v1","D38",0,0.41182715147907,21,96,93,3,21,0
"4936","RMDQ21_v1","D38",0,0.372722708820125,24,93,90,3,24,0
"4937","RMDQ22_v1","D38",0,0.425587509741219,20,97,94,3,20,0
"4938","RMDQ23_v1","D38",0,0.439748411324023,19,98,95,3,19,0
"4939","RMDQ24_v1","D38",0,0.439748411324023,19,98,95,3,19,0
"4940","DN4 - Queimação","D38",0.0377358490566038,0.442942687132334,53,65,64,1,51,2
"4941","DN4 - Sensação de frio dolorosa","D38",0,0.375330930984671,24,94,91,3,24,0
"4942","DN4 - Choque elétrico","D38",0.0555555555555556,0.164313056647265,36,83,82,1,34,2
"4943","DN4 - Formigamento","D38",0.0645161290322581,0.104500621656448,31,88,87,1,29,2
"4944","DN4 - Alfinetada e agulhada","D38",0.0833333333333333,0.00772757479418338,36,83,83,0,33,3
"4945","DN4 - Adormecimento","D38",0.0606060606060606,0.130326862481361,33,85,84,1,31,2
"4946","DN4 - Coceira","D38",0,0.686034714726899,6,113,110,3,6,0
"4947","DH4 - Hipoestesia ao toque","D38",0,0.71332159403313,5,114,111,3,5,0
"4948","DN4 - Hipoestesia a picada de agulha","D38",0,0.71332159403313,5,114,111,3,5,0
"4949","DN4 - Escovação","D38",0,0.743532065455045,4,115,112,3,4,0
"4950","Fuma","D39",0.108695652173913,0.822975388973649,46,82,72,10,41,5
"4951","Cirurgia na coluna","D39",0.109090909090909,0.764293505813152,55,63,55,8,49,6
"4952","Aposentado","D39",0.225806451612903,0.0244696577425095,31,101,93,8,24,7
"4953","Desempregado","D39",0.04,0.18927073883889,25,105,91,14,24,1
"4954","Licenca_Medica","D39",0.0555555555555556,0.40344451989591,18,114,100,14,17,1
"4955","Aposentado_Invalidez","D39",0.125,0.923347464369672,8,123,109,14,7,1
"4956","Analgésicos","D39",0.159090909090909,0.023959531816871,88,42,41,1,74,14
"4957","OutraDoenca","D39",0.14,0.487373850357657,50,80,72,8,43,7
"4958","Dor nas costas","D39",0.131868131868132,0.418037003967513,91,37,34,3,79,12
"4959","Dor nas pernas","D39",0.236363636363636,0.000307450582078348,55,72,70,2,42,13
"4960","Retornar_trabalho","D39",0.25,0.043993319423529,20,99,90,9,15,5
"4961","Masc","D39",0.125,0.458524130935477,88,48,44,4,77,11
"4962","Fem","D39",0.0833333333333333,0.458524130935477,48,88,77,11,44,4
"4963","Casado/Amasiaado","D39",0.145454545454545,0.280763181731797,55,81,74,7,47,8
"4964","Solteiro","D39",0.0508474576271186,0.0527188892105124,59,77,65,12,56,3
"4965","Separado_Divorciado","D39",0.142857142857143,0.777644659047461,7,129,115,14,6,1
"4966","X4","D39",0,0.537448305795192,3,133,118,15,3,0
"4967","X5","D39",0,0.615926597177117,2,134,119,15,2,0
"4968","X6","D39",0.3,0.0466351168508042,10,126,114,12,7,3
"4969","Livrar_costas","D39",0.127906976744186,0.387704704280563,86,14,11,3,75,11
"4970","Livrar_perna","D39",0.214285714285714,0.387704704280563,14,86,75,11,11,3
"4971","Livrar_perda_sens","D39",NA,NA,0,100,86,14,0,0
"4972","D1","D39",0,0.723795314149376,1,135,120,15,1,0
"4973","D15","D39",0,0.338829038839701,7,129,114,15,7,0
"4974","D16","D39",0.65,7.25356607226897e-17,20,116,114,2,7,13
"4975","D17","D39",0.2,0.514117613858902,5,131,117,14,4,1
"4976","D18","D39",0.0625,0.515885059645803,16,120,106,14,15,1
"4977","D19","D39",0.142857142857143,0.777644659047461,7,129,115,14,6,1
"4978","D2","D39",0,0.304652117988235,8,128,113,15,8,0
"4979","D20","D39",0,0.304652117988235,8,128,113,15,8,0
"4980","D21","D39",0.142857142857143,0.777644659047461,7,129,115,14,6,1
"4981","D22","D39",0,0.615926597177117,2,134,119,15,2,0
"4982","D23","D39",0,0.615926597177117,2,134,119,15,2,0
"4983","D24","D39",0.0384615384615385,0.193561484926098,26,110,96,14,25,1
"4984","D25","D39",0,0.474752078295636,4,132,117,15,4,0
"4985","D26","D39",0,0.615926597177117,2,134,119,15,2,0
"4986","D27","D39",0,0.422448926031037,5,131,116,15,5,0
"4987","D28","D39",0,0.377713368845329,6,130,115,15,6,0
"4988","D29","D39",0.285714285714286,1.26970631245721e-05,42,94,91,3,30,12
"4989","D3","D39",0,0.615926597177117,2,134,119,15,2,0
"4990","Lombalgia","D39",0.193548387096774,0.00455422104548561,62,74,71,3,50,12
"4991","D31","D39",0,0.120677904754018,17,119,104,15,17,0
"4992","D32","D39",0.351351351351351,4.10617765272736e-08,37,99,97,2,24,13
"4993","D33","D39",0,0.201486735257118,12,124,109,15,12,0
"4994","D34","D39",0,0.537448305795192,3,133,118,15,3,0
"4995","D35","D39",0,0.615926597177117,2,134,119,15,2,0
"4996","D36","D39",0.25,0.193517466648222,8,128,115,13,6,2
"4997","D37","D39",0.681818181818182,9.03297464573835e-21,22,114,114,0,7,15
"4998","D38","D39",0.333333333333333,0.21237683034588,3,133,119,14,2,1
"4999","D39","D39",1,1.99530445797665e-31,15,121,121,0,0,15
"5000","D4","D39",0,0.474752078295636,4,132,117,15,4,0
"5001","D40","D39",0.2,0.514117613858902,5,131,117,14,4,1
"5002","D41","D39",0.571428571428571,6.36097386871211e-05,7,129,118,11,3,4
"5003","D42","D39",0,0.537448305795192,3,133,118,15,3,0
"5004","D43","D39",0,0.537448305795192,3,133,118,15,3,0
"5005","D44","D39",0.342105263157895,7.70857802857795e-08,38,98,96,2,25,13
"5006","D45","D39",0.0833333333333333,0.75486151575449,12,124,110,14,11,1
"5007","D46","D39",0.394736842105263,4.28364159950422e-11,38,98,98,0,23,15
"5008","D47","D39",0.0833333333333333,0.75486151575449,12,124,110,14,11,1
"5009","D48","D39",0.461538461538462,2.05389186833106e-10,26,110,107,3,14,12
"5010","D49","D39",0,0.181916336185615,13,123,108,15,13,0
"5011","D5","D39",0,0.537448305795192,3,133,118,15,3,0
"5012","D50","D39",0,0.615926597177117,2,134,119,15,2,0
"5013","D51","D39",0,0.723795314149376,1,135,120,15,1,0
"5014","D52","D39",0,0.615926597177117,2,134,119,15,2,0
"5015","D53","D39",0,0.615926597177117,2,134,119,15,2,0
"5016","D9","D39",0,0.723795314149376,1,135,120,15,1,0
"5017","RMDQ1_v1","D39",0.13953488372093,0.832161643305553,43,73,65,8,37,6
"5018","RMDQ2_v1","D39",0.127659574468085,0.916891043399829,47,69,61,8,41,6
"5019","RMDQ3_v1","D39",0.277777777777778,0.000397102052634863,36,82,78,4,26,10
"5020","RMDQ4_v1","D39",0.269230769230769,0.00716253512090891,26,92,85,7,19,7
"5021","RMDQ5_v1","D39",0.333333333333333,7.0009541633534e-06,33,85,82,3,22,11
"5022","RMDQ6_v1","D39",0.275862068965517,0.00257207129991767,29,89,83,6,21,8
"5023","RMDQ7_v1","D39",0.2,0.224055629733022,20,97,87,10,16,4
"5024","RMDQ8_v1","D39",0,0.453080113817211,4,113,99,14,4,0
"5025","RMDQ9_v1","D39",0.166666666666667,0.504118685281497,18,99,88,11,15,3
"5026","RMDQ10_v1","D39",0.136363636363636,0.788760671232565,22,95,84,11,19,3
"5027","RMDQ11_v1","D39",0.173913043478261,0.371104034006289,23,94,84,10,19,4
"5028","RMDQ12_v1","D39",0.181818181818182,0.318806873663325,22,95,85,10,18,4
"5029","RMDQ13_v1","D39",0.181818181818182,0.318806873663325,22,95,85,10,18,4
"5030","RMDQ14_v1","D39",0.08,0.490838093204112,25,92,80,12,23,2
"5031","RMDQ15_v1","D39",0.133333333333333,0.861257534748584,15,102,90,12,13,2
"5032","RMDQ16_v1","D39",0.157894736842105,0.574730143735297,19,98,87,11,16,3
"5033","RMDQ17_v1","D39",0.0909090909090909,0.644746851913485,22,95,83,12,20,2
"5034","RMDQ18_v1","D39",0.1,0.7660951104274,20,97,85,12,18,2
"5035","RMDQ19_v1","D39",0.1875,0.368174471926226,16,101,90,11,13,3
"5036","RMDQ20_v1","D39",0.142857142857143,0.71764382653265,21,96,85,11,18,3
"5037","RMDQ21_v1","D39",0.208333333333333,0.133282392746746,24,93,84,9,19,5
"5038","RMDQ22_v1","D39",0.2,0.224055629733022,20,97,87,10,16,4
"5039","RMDQ23_v1","D39",0.157894736842105,0.574730143735297,19,98,87,11,16,3
"5040","RMDQ24_v1","D39",0.157894736842105,0.574730143735297,19,98,87,11,16,3
"5041","DN4 - Queimação","D39",0.132075471698113,0.883950315603061,53,65,57,8,46,7
"5042","DN4 - Sensação de frio dolorosa","D39",0.125,0.914086480890856,24,94,83,11,21,3
"5043","DN4 - Choque elétrico","D39",0.138888888888889,0.781091566389068,36,83,73,10,31,5
"5044","DN4 - Formigamento","D39",0.129032258064516,0.953615071008199,31,88,77,11,27,4
"5045","DN4 - Alfinetada e agulhada","D39",0.166666666666667,0.37931210066382,36,83,74,9,30,6
"5046","DN4 - Adormecimento","D39",0.212121212121212,0.0841348257973214,33,85,77,8,26,7
"5047","DN4 - Coceira","D39",0.166666666666667,0.758382407367147,6,113,99,14,5,1
"5048","DH4 - Hipoestesia ao toque","D39",0,0.385596417926411,5,114,99,15,5,0
"5049","DN4 - Hipoestesia a picada de agulha","D39",0,0.385596417926411,5,114,99,15,5,0
"5050","DN4 - Escovação","D39",0,0.439728800281152,4,115,100,15,4,0
"5051","Fuma","D4",0.0869565217391304,0.00666741471135697,46,82,82,0,42,4
"5052","Cirurgia na coluna","D4",0.0363636363636364,0.480558585282761,55,63,62,1,53,2
"5053","Aposentado","D4",0.032258064516129,0.942129239847893,31,101,98,3,30,1
"5054","Desempregado","D4",0.12,0.00404435093370527,25,105,104,1,22,3
"5055","Licenca_Medica","D4",0.0555555555555556,0.501243494852576,18,114,111,3,17,1
"5056","Aposentado_Invalidez","D4",0.125,0.109009707129246,8,123,120,3,7,1
"5057","Analgésicos","D4",0.0454545454545455,0.160480030593858,88,42,42,0,84,4
"5058","OutraDoenca","D4",0.06,0.127075082781751,50,80,79,1,47,3
"5059","Dor nas costas","D4",0.043956043956044,0.195079020743251,91,37,37,0,87,4
"5060","Dor nas pernas","D4",0.0363636363636364,0.783696380152113,55,72,70,2,53,2
"5061","Retornar_trabalho","D4",0.05,0.655751723264071,20,99,96,3,19,1
"5062","Masc","D4",0.0454545454545455,0.133792934611541,88,48,48,0,84,4
"5063","Fem","D4",0,0.133792934611541,48,88,84,4,48,0
"5064","Casado/Amasiaado","D4",0,0.0943611379889567,55,81,77,4,55,0
"5065","Solteiro","D4",0.0508474576271186,0.195279287722334,59,77,76,1,56,3
"5066","Separado_Divorciado","D4",0,0.63628659530033,7,129,125,4,7,0
"5067","X4","D4",0.333333333333333,0.00162957881054941,3,133,130,3,2,1
"5068","X5","D4",0,0.804124066880639,2,134,130,4,2,0
"5069","X6","D4",0,0.56738337600414,10,126,122,4,10,0
"5070","Livrar_costas","D4",0.0232558139534884,0.564351319818157,86,14,14,0,84,2
"5071","Livrar_perna","D4",0,0.564351319818157,14,86,84,2,14,0
"5072","Livrar_perda_sens","D4",NA,NA,0,100,98,2,0,0
"5073","D1","D4",0,0.861298710023066,1,135,131,4,1,0
"5074","D15","D4",0.142857142857143,0.0681472853138079,7,129,126,3,6,1
"5075","D16","D4",0.05,0.555150103521647,20,116,113,3,19,1
"5076","D17","D4",0,0.691656304093206,5,131,127,4,5,0
"5077","D18","D4",0.125,0.0159893910801081,16,120,118,2,14,2
"5078","D19","D4",0.285714285714286,3.77296235126334e-05,7,129,127,2,5,2
"5079","D2","D4",0.375,2.4711706269955e-09,8,128,127,1,5,3
"5080","D20","D4",0,0.611790554856623,8,128,124,4,8,0
"5081","D21","D4",0,0.63628659530033,7,129,125,4,7,0
"5082","D22","D4",0,0.804124066880639,2,134,130,4,2,0
"5083","D23","D4",0,0.804124066880639,2,134,130,4,2,0
"5084","D24","D4",0.0384615384615385,0.761369957578402,26,110,107,3,25,1
"5085","D25","D4",0,0.723795314149376,4,132,128,4,4,0
"5086","D26","D4",0,0.804124066880639,2,134,130,4,2,0
"5087","D27","D4",0,0.691656304093206,5,131,127,4,5,0
"5088","D28","D4",0,0.662742068301712,6,130,126,4,6,0
"5089","D29","D4",0,0.174787807854308,42,94,90,4,42,0
"5090","D3","D4",1,2.73570508534012e-16,2,134,132,2,0,2
"5091","Lombalgia","D4",0.0161290322580645,0.401364312380006,62,74,71,3,61,1
"5092","D31","D4",0,0.442904989463355,17,119,115,4,17,0
"5093","D32","D4",0,0.214580448957259,37,99,95,4,37,0
"5094","D33","D4",0,0.527695676048595,12,124,120,4,12,0
"5095","D34","D4",0.333333333333333,0.00162957881054941,3,133,130,3,2,1
"5096","D35","D4",1,2.73570508534012e-16,2,134,132,2,0,2
"5097","D36","D4",0,0.611790554856623,8,128,124,4,8,0
"5098","D37","D4",0.0454545454545455,0.626654692659365,22,114,111,3,21,1
"5099","D38","D4",0,0.760447734150187,3,133,129,4,3,0
"5100","D39","D4",0,0.474752078295636,15,121,117,4,15,0
"5101","D4","D4",1,1.99530445797665e-31,4,132,132,0,0,4
"5102","D40","D4",0,0.691656304093206,5,131,127,4,5,0
"5103","D41","D4",0,0.63628659530033,7,129,125,4,7,0
"5104","D42","D4",0,0.760447734150187,3,133,129,4,3,0
"5105","D43","D4",0,0.760447734150187,3,133,129,4,3,0
"5106","D44","D4",0,0.206183885714472,38,98,94,4,38,0
"5107","D45","D4",0,0.527695676048595,12,124,120,4,12,0
"5108","D46","D4",0.0263157894736842,0.89414105384095,38,98,95,3,37,1
"5109","D47","D4",0.0833333333333333,0.246945495557469,12,124,121,3,11,1
"5110","D48","D4",0,0.323658611852603,26,110,106,4,26,0
"5111","D49","D4",0,0.509265854764088,13,123,119,4,13,0
"5112","D5","D4",0.333333333333333,0.00162957881054941,3,133,130,3,2,1
"5113","D50","D4",0,0.804124066880639,2,134,130,4,2,0
"5114","D51","D4",1,8.1271609988953e-09,1,135,132,3,0,1
"5115","D52","D4",0,0.804124066880639,2,134,130,4,2,0
"5116","D53","D4",0,0.804124066880639,2,134,130,4,2,0
"5117","D9","D4",1,8.1271609988953e-09,1,135,132,3,0,1
"5118","RMDQ1_v1","D4",0.0465116279069767,0.550808395345412,43,73,72,1,41,2
"5119","RMDQ2_v1","D4",0.0425531914893617,0.635197336145884,47,69,68,1,45,2
"5120","RMDQ3_v1","D4",0.0555555555555556,0.168267917974578,36,82,81,1,34,2
"5121","RMDQ4_v1","D4",0,0.350971009055765,26,92,89,3,26,0
"5122","RMDQ5_v1","D4",0.0606060606060606,0.130326862481361,33,85,84,1,31,2
"5123","RMDQ6_v1","D4",0.0689655172413793,0.0863020835729633,29,89,88,1,27,2
"5124","RMDQ7_v1","D4",0.1,0.0208539320778979,20,97,96,1,18,2
"5125","RMDQ8_v1","D4",0,0.741297764641791,4,113,110,3,4,0
"5126","RMDQ9_v1","D4",0.111111111111111,0.0126308285810314,18,99,98,1,16,2
"5127","RMDQ10_v1","D4",0.0909090909090909,0.031603186824878,22,95,94,1,20,2
"5128","RMDQ11_v1","D4",0.0869565217391304,0.037934361203436,23,94,93,1,21,2
"5129","RMDQ12_v1","D4",0.0909090909090909,0.031603186824878,22,95,94,1,20,2
"5130","RMDQ13_v1","D4",0.0909090909090909,0.031603186824878,22,95,94,1,20,2
"5131","RMDQ14_v1","D4",0.08,0.0524821629627642,25,92,91,1,23,2
"5132","RMDQ15_v1","D4",0.133333333333333,0.00471104716586064,15,102,101,1,13,2
"5133","RMDQ16_v1","D4",0.105263157894737,0.0164317176559626,19,98,97,1,17,2
"5134","RMDQ17_v1","D4",0.0909090909090909,0.031603186824878,22,95,94,1,20,2
"5135","RMDQ18_v1","D4",0.1,0.0208539320778979,20,97,96,1,18,2
"5136","RMDQ19_v1","D4",0.125,0.00680423952160824,16,101,100,1,14,2
"5137","RMDQ20_v1","D4",0.0952380952380952,0.0259094208039915,21,96,95,1,19,2
"5138","RMDQ21_v1","D4",0.0833333333333333,0.0448972277463963,24,93,92,1,22,2
"5139","RMDQ22_v1","D4",0.1,0.0208539320778979,20,97,96,1,18,2
"5140","RMDQ23_v1","D4",0.105263157894737,0.0164317176559626,19,98,97,1,17,2
"5141","RMDQ24_v1","D4",0.105263157894737,0.0164317176559626,19,98,97,1,17,2
"5142","DN4 - Queimação","D4",0.0566037735849057,0.0520168860438896,53,65,65,0,50,3
"5143","DN4 - Sensação de frio dolorosa","D4",0,0.375330930984671,24,94,91,3,24,0
"5144","DN4 - Choque elétrico","D4",0.0833333333333333,0.00772757479418338,36,83,83,0,33,3
"5145","DN4 - Formigamento","D4",0.032258064516129,0.770978521413746,31,88,86,2,30,1
"5146","DN4 - Alfinetada e agulhada","D4",0.0833333333333333,0.00772757479418338,36,83,83,0,33,3
"5147","DN4 - Adormecimento","D4",0.0606060606060606,0.130326862481361,33,85,84,1,31,2
"5148","DN4 - Coceira","D4",0.333333333333333,7.78280281738889e-07,6,113,112,1,4,2
"5149","DH4 - Hipoestesia ao toque","D4",0.4,4.70813487421436e-08,5,114,113,1,3,2
"5150","DN4 - Hipoestesia a picada de agulha","D4",0.4,4.70813487421436e-08,5,114,113,1,3,2
"5151","DN4 - Escovação","D4",0.5,7.18853818890754e-10,4,115,114,1,2,2
"5152","Fuma","D40",0.0869565217391304,0.00666741471135697,46,82,82,0,42,4
"5153","Cirurgia na coluna","D40",0.0727272727272727,0.0294248479919993,55,63,63,0,51,4
"5154","Aposentado","D40",0,0.260501644567837,31,101,97,4,31,0
"5155","Desempregado","D40",0.04,0.766175756831519,25,105,102,3,24,1
"5156","Licenca_Medica","D40",0.166666666666667,0.000281575371963658,18,114,113,1,15,3
"5157","Aposentado_Invalidez","D40",0,0.604436248364823,8,123,119,4,8,0
"5158","Analgésicos","D40",0.0227272727272727,0.176911873194487,88,42,39,3,86,2
"5159","OutraDoenca","D40",0.02,0.386856424005249,50,80,76,4,49,1
"5160","Dor nas costas","D40",0.021978021978022,0.117680431791087,91,37,34,3,89,2
"5161","Dor nas pernas","D40",0.0727272727272727,0.0911332797643791,55,72,71,1,51,4
"5162","Retornar_trabalho","D40",0,0.304495053929834,20,99,94,5,20,0
"5163","Masc","D40",0.0340909090909091,0.822480650855677,88,48,46,2,85,3
"5164","Fem","D40",0.0416666666666667,0.822480650855677,48,88,85,3,46,2
"5165","Casado/Amasiaado","D40",0.0181818181818182,0.342650021269306,55,81,77,4,54,1
"5166","Solteiro","D40",0.0508474576271186,0.444906532860642,59,77,75,2,56,3
"5167","Separado_Divorciado","D40",0,0.595606456103754,7,129,124,5,7,0
"5168","X4","D40",0.333333333333333,0.0057757922013957,3,133,129,4,2,1
"5169","X5","D40",0,0.780748527710185,2,134,129,5,2,0
"5170","X6","D40",0,0.52097059061678,10,126,121,5,10,0
"5171","Livrar_costas","D40",0.0116279069767442,0.000332606859565408,86,14,11,3,85,1
"5172","Livrar_perna","D40",0.214285714285714,0.000332606859565408,14,86,85,1,11,3
"5173","Livrar_perda_sens","D40",NA,NA,0,100,96,4,0,0
"5174","D1","D40",0,0.844540967905734,1,135,130,5,1,0
"5175","D15","D40",0.571428571428571,1.17874103972796e-14,7,129,128,1,3,4
"5176","D16","D40",0,0.34413339274707,20,116,111,5,20,0
"5177","D17","D40",0.4,1.09406567191532e-05,5,131,128,3,3,2
"5178","D18","D40",0.125,0.0458644786531582,16,120,117,3,14,2
"5179","D19","D40",0,0.595606456103754,7,129,124,5,7,0
"5180","D2","D40",0,0.568958961171041,8,128,123,5,8,0
"5181","D20","D40",0,0.568958961171041,8,128,123,5,8,0
"5182","D21","D40",0,0.595606456103754,7,129,124,5,7,0
"5183","D22","D40",0,0.780748527710185,2,134,129,5,2,0
"5184","D23","D40",0,0.780748527710185,2,134,129,5,2,0
"5185","D24","D40",0,0.268005741392268,26,110,105,5,26,0
"5186","D25","D40",0,0.691656304093206,4,132,127,5,4,0
"5187","D26","D40",0,0.780748527710185,2,134,129,5,2,0
"5188","D27","D40",0,0.656239661480154,5,131,126,5,5,0
"5189","D28","D40",0,0.62451163800975,6,130,125,5,6,0
"5190","D29","D40",0.0476190476190476,0.65297976041166,42,94,91,3,40,2
"5191","D3","D40",0,0.780748527710185,2,134,129,5,2,0
"5192","Lombalgia","D40",0.0161290322580645,0.241783630662983,62,74,70,4,61,1
"5193","D31","D40",0.176470588235294,0.00106675541333213,17,119,117,2,14,3
"5194","D32","D40",0,0.16366736200703,37,99,94,5,37,0
"5195","D33","D40",0.166666666666667,0.0122700258445425,12,124,121,3,10,2
"5196","D34","D40",0,0.732216032264721,3,133,128,5,3,0
"5197","D35","D40",0,0.780748527710185,2,134,129,5,2,0
"5198","D36","D40",0.625,7.98650294510506e-20,8,128,128,0,3,5
"5199","D37","D40",0.136363636363636,0.00669900195187523,22,114,112,2,19,3
"5200","D38","D40",1,3.10012884991917e-19,3,133,131,2,0,3
"5201","D39","D40",0.0666666666666667,0.514117613858902,15,121,117,4,14,1
"5202","D4","D40",0,0.691656304093206,4,132,127,5,4,0
"5203","D40","D40",1,1.99530445797665e-31,5,131,131,0,0,5
"5204","D41","D40",0.428571428571429,1.54890242167862e-08,7,129,127,2,4,3
"5205","D42","D40",0,0.732216032264721,3,133,128,5,3,0
"5206","D43","D40",0,0.732216032264721,3,133,128,5,3,0
"5207","D44","D40",0.0263157894736842,0.686789350124843,38,98,94,4,37,1
"5208","D45","D40",0.166666666666667,0.0122700258445425,12,124,121,3,10,2
"5209","D46","D40",0.0263157894736842,0.686789350124843,38,98,94,4,37,1
"5210","D47","D40",0.25,3.94286828513817e-05,12,124,122,2,9,3
"5211","D48","D40",0,0.268005741392268,26,110,105,5,26,0
"5212","D49","D40",0.153846153846154,0.018333114640816,13,123,120,3,11,2
"5213","D5","D40",0,0.732216032264721,3,133,128,5,3,0
"5214","D50","D40",0,0.780748527710185,2,134,129,5,2,0
"5215","D51","D40",0,0.844540967905734,1,135,130,5,1,0
"5216","D52","D40",0,0.780748527710185,2,134,129,5,2,0
"5217","D53","D40",0,0.780748527710185,2,134,129,5,2,0
"5218","D9","D40",0,0.844540967905734,1,135,130,5,1,0
"5219","RMDQ1_v1","D40",0.0232558139534884,0.703633355024225,43,73,69,4,42,1
"5220","RMDQ2_v1","D40",0.0212765957446809,0.617174336474835,47,69,65,4,46,1
"5221","RMDQ3_v1","D40",0,0.130021212550665,36,82,77,5,36,0
"5222","RMDQ4_v1","D40",0,0.224469313782964,26,92,87,5,26,0
"5223","RMDQ5_v1","D40",0,0.154518328207651,33,85,80,5,33,0
"5224","RMDQ6_v1","D40",0,0.192117716744612,29,89,84,5,29,0
"5225","RMDQ7_v1","D40",0,0.29938055120971,20,97,92,5,20,0
"5226","RMDQ8_v1","D40",0,0.667201950354723,4,113,108,5,4,0
"5227","RMDQ9_v1","D40",0,0.329801954387474,18,99,94,5,18,0
"5228","RMDQ10_v1","D40",0,0.271414036674767,22,95,90,5,22,0
"5229","RMDQ11_v1","D40",0,0.258267411370114,23,94,89,5,23,0
"5230","RMDQ12_v1","D40",0,0.271414036674767,22,95,90,5,22,0
"5231","RMDQ13_v1","D40",0,0.271414036674767,22,95,90,5,22,0
"5232","RMDQ14_v1","D40",0,0.233510138206751,25,92,87,5,25,0
"5233","RMDQ15_v1","D40",0,0.380799352580873,15,102,97,5,15,0
"5234","RMDQ16_v1","D40",0,0.314265473296222,19,98,93,5,19,0
"5235","RMDQ17_v1","D40",0,0.271414036674767,22,95,90,5,22,0
"5236","RMDQ18_v1","D40",0,0.29938055120971,20,97,92,5,20,0
"5237","RMDQ19_v1","D40",0,0.363013858556909,16,101,96,5,16,0
"5238","RMDQ20_v1","D40",0,0.285108215160341,21,96,91,5,21,0
"5239","RMDQ21_v1","D40",0,0.245640976946185,24,93,88,5,24,0
"5240","RMDQ22_v1","D40",0,0.29938055120971,20,97,92,5,20,0
"5241","RMDQ23_v1","D40",0,0.314265473296222,19,98,93,5,19,0
"5242","RMDQ24_v1","D40",0,0.314265473296222,19,98,93,5,19,0
"5243","DN4 - Queimação","D40",0.0566037735849057,0.488330641908803,53,65,63,2,50,3
"5244","DN4 - Sensação de frio dolorosa","D40",0,0.248257616012612,24,94,89,5,24,0
"5245","DN4 - Choque elétrico","D40",0.0833333333333333,0.139003043752015,36,83,81,2,33,3
"5246","DN4 - Formigamento","D40",0.0645161290322581,0.467782054809843,31,88,85,3,29,2
"5247","DN4 - Alfinetada e agulhada","D40",0.111111111111111,0.0133529243945253,36,83,82,1,32,4
"5248","DN4 - Adormecimento","D40",0.0606060606060606,0.540111281186488,33,85,82,3,31,2
"5249","DN4 - Coceira","D40",0,0.598587935384081,6,113,108,5,6,0
"5250","DH4 - Hipoestesia ao toque","D40",0,0.632328327021753,5,114,109,5,5,0
"5251","DN4 - Hipoestesia a picada de agulha","D40",0,0.632328327021753,5,114,109,5,5,0
"5252","DN4 - Escovação","D40",0,0.670052424301302,4,115,110,5,4,0
"5253","Fuma","D41",0.0652173913043478,0.252649548240488,46,82,80,2,43,3
"5254","Cirurgia na coluna","D41",0.0909090909090909,0.0641869210190012,55,63,62,1,50,5
"5255","Aposentado","D41",0.0645161290322581,0.744241612082321,31,101,96,5,29,2
"5256","Desempregado","D41",0.04,0.732888589755174,25,105,99,6,24,1
"5257","Licenca_Medica","D41",0.166666666666667,0.0206108814462578,18,114,110,4,15,3
"5258","Aposentado_Invalidez","D41",0.125,0.352973574776444,8,123,117,6,7,1
"5259","Analgésicos","D41",0.0568181818181818,0.827965468160177,88,42,40,2,83,5
"5260","OutraDoenca","D41",0.04,0.580300480306315,50,80,75,5,48,2
"5261","Dor nas costas","D41",0.0549450549450549,0.983964821465572,91,37,35,2,86,5
"5262","Dor nas pernas","D41",0.109090909090909,0.0198345060885519,55,72,71,1,49,6
"5263","Retornar_trabalho","D41",0.1,0.390868853825774,20,99,94,5,18,2
"5264","Masc","D41",0.0795454545454545,0.0448207879789162,88,48,48,0,81,7
"5265","Fem","D41",0,0.0448207879789162,48,88,81,7,48,0
"5266","Casado/Amasiaado","D41",0.0545454545454545,0.893615907253868,55,81,77,4,52,3
"5267","Solteiro","D41",0.0508474576271186,0.977032998995578,59,77,73,4,56,3
"5268","Separado_Divorciado","D41",0,0.526853490497434,7,129,122,7,7,0
"5269","X4","D41",0,0.683274873050331,3,133,126,7,3,0
"5270","X5","D41",0,0.739976909027013,2,134,127,7,2,0
"5271","X6","D41",0.1,0.470552989828395,10,126,120,6,9,1
"5272","Livrar_costas","D41",0.0581395348837209,0.846048003443795,86,14,13,1,81,5
"5273","Livrar_perna","D41",0.0714285714285714,0.846048003443795,14,86,81,5,13,1
"5274","Livrar_perda_sens","D41",NA,NA,0,100,94,6,0,0
"5275","D1","D41",0,0.815135138754741,1,135,128,7,1,0
"5276","D15","D41",0.428571428571429,3.54616436732681e-06,7,129,125,4,4,3
"5277","D16","D41",0.2,0.00113356584548728,20,116,113,3,16,4
"5278","D17","D41",0.4,0.000325896542562272,5,131,126,5,3,2
"5279","D18","D41",0.125,0.156458987223275,16,120,115,5,14,2
"5280","D19","D41",0,0.526853490497434,7,129,122,7,7,0
"5281","D2","D41",0,0.497044882450256,8,128,121,7,8,0
"5282","D20","D41",0,0.497044882450256,8,128,121,7,8,0
"5283","D21","D41",0,0.526853490497434,7,129,122,7,7,0
"5284","D22","D41",0,0.739976909027013,2,134,127,7,2,0
"5285","D23","D41",0,0.739976909027013,2,134,127,7,2,0
"5286","D24","D41",0,0.186591501022522,26,110,103,7,26,0
"5287","D25","D41",0,0.63628659530033,4,132,125,7,4,0
"5288","D26","D41",0,0.739976909027013,2,134,127,7,2,0
"5289","D27","D41",0,0.595606456103754,5,131,124,7,5,0
"5290","D28","D41",0,0.55947835087211,6,130,123,7,6,0
"5291","D29","D41",0.142857142857143,0.00126372517647517,42,94,93,1,36,6
"5292","D3","D41",0,0.739976909027013,2,134,127,7,2,0
"5293","Lombalgia","D41",0.0645161290322581,0.528537006380904,62,74,71,3,58,4
"5294","D31","D41",0.0588235294117647,0.883383097185362,17,119,113,6,16,1
"5295","D32","D41",0.108108108108108,0.0676280434071588,37,99,96,3,33,4
"5296","D33","D41",0,0.398060116685702,12,124,117,7,12,0
"5297","D34","D41",0,0.683274873050331,3,133,126,7,3,0
"5298","D35","D41",0,0.739976909027013,2,134,127,7,2,0
"5299","D36","D41",0.5,3.25328093603584e-09,8,128,125,3,4,4
"5300","D37","D41",0.318181818181818,6.25243149640233e-10,22,114,114,0,15,7
"5301","D38","D41",0.333333333333333,0.0254648673683159,3,133,127,6,2,1
"5302","D39","D41",0.266666666666667,6.36097386871211e-05,15,121,118,3,11,4
"5303","D4","D41",0,0.63628659530033,4,132,125,7,4,0
"5304","D40","D41",0.6,1.54890242167862e-08,5,131,127,4,2,3
"5305","D41","D41",1,1.99530445797665e-31,7,129,129,0,0,7
"5306","D42","D41",0,0.683274873050331,3,133,126,7,3,0
"5307","D43","D41",0,0.683274873050331,3,133,126,7,3,0
"5308","D44","D41",0.105263157894737,0.0770722845689075,38,98,95,3,34,4
"5309","D45","D41",0.0833333333333333,0.600868844205315,12,124,118,6,11,1
"5310","D46","D41",0.131578947368421,0.00846793392216993,38,98,96,2,33,5
"5311","D47","D41",0.0833333333333333,0.600868844205315,12,124,118,6,11,1
"5312","D48","D41",0.153846153846154,0.00861550241929527,26,110,107,3,22,4
"5313","D49","D41",0,0.377146151318951,13,123,116,7,13,0
"5314","D5","D41",0,0.683274873050331,3,133,126,7,3,0
"5315","D50","D41",0,0.739976909027013,2,134,127,7,2,0
"5316","D51","D41",0,0.815135138754741,1,135,128,7,1,0
"5317","D52","D41",0,0.739976909027013,2,134,127,7,2,0
"5318","D53","D41",0,0.739976909027013,2,134,127,7,2,0
"5319","D9","D41",0,0.815135138754741,1,135,128,7,1,0
"5320","RMDQ1_v1","D41",0.0697674418604651,0.917577367895651,43,73,69,4,40,3
"5321","RMDQ2_v1","D41",0.0425531914893617,0.775367547407954,47,69,64,5,45,2
"5322","RMDQ3_v1","D41",0.0277777777777778,0.336492389359646,36,82,76,6,35,1
"5323","RMDQ4_v1","D41",0.0384615384615385,0.610084612119384,26,92,86,6,25,1
"5324","RMDQ5_v1","D41",0.0606060606060606,0.970652158540852,33,85,80,5,31,2
"5325","RMDQ6_v1","D41",0.0344827586206897,0.514393596899754,29,89,83,6,28,1
"5326","RMDQ7_v1","D41",0.05,0.838703911858419,20,97,91,6,19,1
"5327","RMDQ8_v1","D41",0,0.607687652229803,4,113,106,7,4,0
"5328","RMDQ9_v1","D41",0.0555555555555556,0.933766669511119,18,99,93,6,17,1
"5329","RMDQ10_v1","D41",0.0454545454545455,0.752394853272729,22,95,89,6,21,1
"5330","RMDQ11_v1","D41",0.0434782608695652,0.712225217901405,23,94,88,6,22,1
"5331","RMDQ12_v1","D41",0.0454545454545455,0.752394853272729,22,95,89,6,21,1
"5332","RMDQ13_v1","D41",0.0454545454545455,0.752394853272729,22,95,89,6,21,1
"5333","RMDQ14_v1","D41",0,0.154910205584856,25,92,85,7,25,0
"5334","RMDQ15_v1","D41",0,0.295383708358243,15,102,95,7,15,0
"5335","RMDQ16_v1","D41",0,0.229572755395786,19,98,91,7,19,0
"5336","RMDQ17_v1","D41",0,0.189151958767347,22,95,88,7,22,0
"5337","RMDQ18_v1","D41",0,0.215341871421237,20,97,90,7,20,0
"5338","RMDQ19_v1","D41",0.0625,0.961330653334592,16,101,95,6,15,1
"5339","RMDQ20_v1","D41",0.0476190476190476,0.794517050138976,21,96,90,6,20,1
"5340","RMDQ21_v1","D41",0.0833333333333333,0.586057318067706,24,93,88,5,22,2
"5341","RMDQ22_v1","D41",0.05,0.838703911858419,20,97,91,6,19,1
"5342","RMDQ23_v1","D41",0.0526315789473684,0.88507678924591,19,98,92,6,18,1
"5343","RMDQ24_v1","D41",0.0526315789473684,0.88507678924591,19,98,92,6,18,1
"5344","DN4 - Queimação","D41",0.0566037735849057,0.910132327374677,53,65,61,4,50,3
"5345","DN4 - Sensação de frio dolorosa","D41",0,0.168084755737741,24,94,87,7,24,0
"5346","DN4 - Choque elétrico","D41",0.0555555555555556,0.920517219168758,36,83,78,5,34,2
"5347","DN4 - Formigamento","D41",0.0645161290322581,0.875525765708914,31,88,83,5,29,2
"5348","DN4 - Alfinetada e agulhada","D41",0.138888888888889,0.014498692935062,36,83,81,2,31,5
"5349","DN4 - Adormecimento","D41",0.0909090909090909,0.36544265238027,33,85,81,4,30,3
"5350","DN4 - Coceira","D41",0.166666666666667,0.249278728612911,6,113,107,6,5,1
"5351","DH4 - Hipoestesia ao toque","D41",0,0.567901636238271,5,114,107,7,5,0
"5352","DN4 - Hipoestesia a picada de agulha","D41",0,0.567901636238271,5,114,107,7,5,0
"5353","DN4 - Escovação","D41",0,0.61101767849463,4,115,108,7,4,0
"5354","Fuma","D42",0.0217391304347826,0.924214003182506,46,82,80,2,45,1
"5355","Cirurgia na coluna","D42",0,0.182624551928033,55,63,61,2,55,0
"5356","Aposentado","D42",0.032258064516129,0.683966586356629,31,101,99,2,30,1
"5357","Desempregado","D42",0.04,0.530621679607463,25,105,103,2,24,1
"5358","Licenca_Medica","D42",0.0555555555555556,0.314594493319487,18,114,112,2,17,1
"5359","Aposentado_Invalidez","D42",0,0.654967047400161,8,123,120,3,8,0
"5360","Analgésicos","D42",0.0113636363636364,0.589754290789669,88,42,41,1,87,1
"5361","OutraDoenca","D42",0,0.165934803789697,50,80,77,3,50,0
"5362","Dor nas costas","D42",0.032967032967033,0.263733054433354,91,37,37,0,88,3
"5363","Dor nas pernas","D42",0,0.125515491370081,55,72,69,3,55,0
"5364","Retornar_trabalho","D42",0.05,0.438127087910104,20,99,97,2,19,1
"5365","Masc","D42",0.0340909090909091,0.195820569825375,88,48,48,0,85,3
"5366","Fem","D42",0,0.195820569825375,48,88,85,3,48,0
"5367","Casado/Amasiaado","D42",0.0363636363636364,0.349309716311897,55,81,80,1,53,2
"5368","Solteiro","D42",0.0169491525423729,0.722487220523156,59,77,75,2,58,1
"5369","Separado_Divorciado","D42",0,0.683274873050331,7,129,126,3,7,0
"5370","X4","D42",0,0.792511685634946,3,133,130,3,3,0
"5371","X5","D42",0,0.830565083280277,2,134,131,3,2,0
"5372","X6","D42",0,0.621714056090023,10,126,123,3,10,0
"5373","Livrar_costas","D42",0.0232558139534884,0.564351319818157,86,14,14,0,84,2
"5374","Livrar_perna","D42",0,0.564351319818157,14,86,84,2,14,0
"5375","Livrar_perda_sens","D42",NA,NA,0,100,98,2,0,0
"5376","D1","D42",0,0.880178390709511,1,135,132,3,1,0
"5377","D15","D42",0,0.683274873050331,7,129,126,3,7,0
"5378","D16","D42",0,0.467066119740186,20,116,113,3,20,0
"5379","D17","D42",0,0.732216032264721,5,131,128,3,5,0
"5380","D18","D42",0.125,0.00283985885956862,16,120,119,1,14,2
"5381","D19","D42",0.285714285714286,1.07956281323173e-06,7,129,128,1,5,2
"5382","D2","D42",0,0.66148119738657,8,128,125,3,8,0
"5383","D20","D42",0.25,6.04963738671134e-06,8,128,127,1,6,2
"5384","D21","D42",0.142857142857143,0.0254648673683159,7,129,127,2,6,1
"5385","D22","D42",1,2.39360797585802e-21,2,134,133,1,0,2
"5386","D23","D42",0,0.830565083280277,2,134,131,3,2,0
"5387","D24","D42",0,0.394480841695529,26,110,107,3,26,0
"5388","D25","D42",0,0.760447734150187,4,132,129,3,4,0
"5389","D26","D42",0.5,3.54931258649229e-06,2,134,132,2,1,1
"5390","D27","D42",0,0.732216032264721,5,131,128,3,5,0
"5391","D28","D42",0,0.706710630318467,6,130,127,3,6,0
"5392","D29","D42",0,0.241698399730683,42,94,91,3,42,0
"5393","D3","D42",0,0.830565083280277,2,134,131,3,2,0
"5394","Lombalgia","D42",0.0161290322580645,0.666494321244379,62,74,72,2,61,1
"5395","D31","D42",0,0.507973906584138,17,119,116,3,17,0
"5396","D32","D42",0.027027027027027,0.809431421074835,37,99,97,2,36,1
"5397","D33","D42",0,0.585850572100077,12,124,121,3,12,0
"5398","D34","D42",0,0.792511685634946,3,133,130,3,3,0
"5399","D35","D42",0,0.830565083280277,2,134,131,3,2,0
"5400","D36","D42",0,0.66148119738657,8,128,125,3,8,0
"5401","D37","D42",0,0.441644329784114,22,114,111,3,22,0
"5402","D38","D42",0,0.792511685634946,3,133,130,3,3,0
"5403","D39","D42",0,0.537448305795192,15,121,118,3,15,0
"5404","D4","D42",0,0.760447734150187,4,132,129,3,4,0
"5405","D40","D42",0,0.732216032264721,5,131,128,3,5,0
"5406","D41","D42",0,0.683274873050331,7,129,126,3,7,0
"5407","D42","D42",1,1.99530445797668e-31,3,133,133,0,0,3
"5408","D43","D42",0.333333333333333,0.000205681391078371,3,133,131,2,2,1
"5409","D44","D42",0.0263157894736842,0.833296835878753,38,98,96,2,37,1
"5410","D45","D42",0,0.585850572100077,12,124,121,3,12,0
"5411","D46","D42",0,0.275429552882231,38,98,95,3,38,0
"5412","D47","D42",0,0.585850572100077,12,124,121,3,12,0
"5413","D48","D42",0,0.394480841695529,26,110,107,3,26,0
"5414","D49","D42",0,0.569079451848605,13,123,120,3,13,0
"5415","D5","D42",0,0.792511685634946,3,133,130,3,3,0
"5416","D50","D42",0,0.830565083280277,2,134,131,3,2,0
"5417","D51","D42",0,0.880178390709511,1,135,132,3,1,0
"5418","D52","D42",0.5,3.54931258649229e-06,2,134,132,2,1,1
"5419","D53","D42",0,0.830565083280277,2,134,131,3,2,0
"5420","D9","D42",0,0.880178390709511,1,135,132,3,1,0
"5421","RMDQ1_v1","D42",0.0232558139534884,0.920972823893012,43,73,72,1,42,1
"5422","RMDQ2_v1","D42",0.0425531914893617,0.21975024120729,47,69,69,0,45,2
"5423","RMDQ3_v1","D42",0.0277777777777778,0.545973330618042,36,82,81,1,35,1
"5424","RMDQ4_v1","D42",0.0384615384615385,0.335843434078945,26,92,91,1,25,1
"5425","RMDQ5_v1","D42",0.0303030303030303,0.483790516345729,33,85,84,1,32,1
"5426","RMDQ6_v1","D42",0.0344827586206897,0.399633662575936,29,89,88,1,28,1
"5427","RMDQ7_v1","D42",0.05,0.212447592946906,20,97,96,1,19,1
"5428","RMDQ8_v1","D42",0,0.788407006817525,4,113,111,2,4,0
"5429","RMDQ9_v1","D42",0,0.543025813812971,18,99,97,2,18,0
"5430","RMDQ10_v1","D42",0.0454545454545455,0.254752373169046,22,95,94,1,21,1
"5431","RMDQ11_v1","D42",0.0434782608695652,0.276118902707155,23,94,93,1,22,1
"5432","RMDQ12_v1","D42",0.0909090909090909,0.00303457735757642,22,95,95,0,20,2
"5433","RMDQ13_v1","D42",0,0.492429745624424,22,95,93,2,22,0
"5434","RMDQ14_v1","D42",0.08,0.00621115026571818,25,92,92,0,23,2
"5435","RMDQ15_v1","D42",0,0.584363826258582,15,102,100,2,15,0
"5436","RMDQ16_v1","D42",0,0.529944138338696,19,98,96,2,19,0
"5437","RMDQ17_v1","D42",0.0454545454545455,0.254752373169046,22,95,94,1,21,1
"5438","RMDQ18_v1","D42",0.05,0.212447592946906,20,97,96,1,19,1
"5439","RMDQ19_v1","D42",0,0.570203696419443,16,101,99,2,16,0
"5440","RMDQ20_v1","D42",0.0476190476190476,0.233510138206751,21,96,95,1,20,1
"5441","RMDQ21_v1","D42",0.0416666666666667,0.297563754888929,24,93,92,1,23,1
"5442","RMDQ22_v1","D42",0.05,0.212447592946906,20,97,96,1,19,1
"5443","RMDQ23_v1","D42",0.0526315789473684,0.191631215221544,19,98,97,1,18,1
"5444","RMDQ24_v1","D42",0.0526315789473684,0.191631215221544,19,98,97,1,18,1
"5445","DN4 - Queimação","D42",0,0.364492892588794,53,65,64,1,53,0
"5446","DN4 - Sensação de frio dolorosa","D42",0,0.611841971208142,24,94,93,1,24,0
"5447","DN4 - Choque elétrico","D42",0,0.508374874653824,36,83,82,1,36,0
"5448","DN4 - Formigamento","D42",0,0.55115163907239,31,88,87,1,31,0
"5449","DN4 - Alfinetada e agulhada","D42",0,0.508374874653824,36,83,82,1,36,0
"5450","DN4 - Adormecimento","D42",0,0.531483921254055,33,85,84,1,33,0
"5451","DN4 - Coceira","D42",0,0.817001778007153,6,113,112,1,6,0
"5452","DH4 - Hipoestesia ao toque","D42",0,0.833423792098798,5,114,113,1,5,0
"5453","DN4 - Hipoestesia a picada de agulha","D42",0,0.833423792098798,5,114,113,1,5,0
"5454","DN4 - Escovação","D42",0,0.851433613762243,4,115,114,1,4,0
"5455","Fuma","D43",0.0434782608695652,0.261650822951307,46,82,81,1,44,2
"5456","Cirurgia na coluna","D43",0.0181818181818182,0.922786031527084,55,63,62,1,54,1
"5457","Aposentado","D43",0.032258064516129,0.683966586356629,31,101,99,2,30,1
"5458","Desempregado","D43",0.04,0.530621679607463,25,105,103,2,24,1
"5459","Licenca_Medica","D43",0.0555555555555556,0.314594493319487,18,114,112,2,17,1
"5460","Aposentado_Invalidez","D43",0,0.654967047400161,8,123,120,3,8,0
"5461","Analgésicos","D43",0.0340909090909091,0.226034761081789,88,42,42,0,85,3
"5462","OutraDoenca","D43",0,0.165934803789697,50,80,77,3,50,0
"5463","Dor nas costas","D43",0.021978021978022,0.8640934850506,91,37,36,1,89,2
"5464","Dor nas pernas","D43",0,0.125515491370081,55,72,69,3,55,0
"5465","Retornar_trabalho","D43",0.05,0.438127087910104,20,99,97,2,19,1
"5466","Masc","D43",0.0113636363636364,0.250216747845471,88,48,46,2,87,1
"5467","Fem","D43",0.0416666666666667,0.250216747845471,48,88,87,1,46,2
"5468","Casado/Amasiaado","D43",0.0545454545454545,0.0335431532333285,55,81,81,0,52,3
"5469","Solteiro","D43",0,0.125238677070296,59,77,74,3,59,0
"5470","Separado_Divorciado","D43",0,0.683274873050331,7,129,126,3,7,0
"5471","X4","D43",0,0.792511685634946,3,133,130,3,3,0
"5472","X5","D43",0,0.830565083280277,2,134,131,3,2,0
"5473","X6","D43",0,0.621714056090023,10,126,123,3,10,0
"5474","Livrar_costas","D43",0.0232558139534884,0.564351319818157,86,14,14,0,84,2
"5475","Livrar_perna","D43",0,0.564351319818157,14,86,84,2,14,0
"5476","Livrar_perda_sens","D43",NA,NA,0,100,98,2,0,0
"5477","D1","D43",0,0.880178390709511,1,135,132,3,1,0
"5478","D15","D43",0,0.683274873050331,7,129,126,3,7,0
"5479","D16","D43",0,0.467066119740186,20,116,113,3,20,0
"5480","D17","D43",0,0.732216032264721,5,131,128,3,5,0
"5481","D18","D43",0.125,0.00283985885956862,16,120,119,1,14,2
"5482","D19","D43",0.142857142857143,0.0254648673683159,7,129,127,2,6,1
"5483","D2","D43",0.125,0.0410139457284451,8,128,126,2,7,1
"5484","D20","D43",0.25,6.04963738671134e-06,8,128,127,1,6,2
"5485","D21","D43",0.285714285714286,1.07956281323173e-06,7,129,128,1,5,2
"5486","D22","D43",0.5,3.54931258649229e-06,2,134,132,2,1,1
"5487","D23","D43",0,0.830565083280277,2,134,131,3,2,0
"5488","D24","D43",0,0.394480841695529,26,110,107,3,26,0
"5489","D25","D43",0,0.760447734150187,4,132,129,3,4,0
"5490","D26","D43",0.5,3.54931258649229e-06,2,134,132,2,1,1
"5491","D27","D43",0,0.732216032264721,5,131,128,3,5,0
"5492","D28","D43",0.166666666666667,0.0136361570561041,6,130,128,2,5,1
"5493","D29","D43",0,0.241698399730683,42,94,91,3,42,0
"5494","D3","D43",0,0.830565083280277,2,134,131,3,2,0
"5495","Lombalgia","D43",0.0161290322580645,0.666494321244379,62,74,72,2,61,1
"5496","D31","D43",0,0.507973906584138,17,119,116,3,17,0
"5497","D32","D43",0,0.284282472208915,37,99,96,3,37,0
"5498","D33","D43",0,0.585850572100077,12,124,121,3,12,0
"5499","D34","D43",0.333333333333333,0.000205681391078371,3,133,131,2,2,1
"5500","D35","D43",0,0.830565083280277,2,134,131,3,2,0
"5501","D36","D43",0,0.66148119738657,8,128,125,3,8,0
"5502","D37","D43",0,0.441644329784114,22,114,111,3,22,0
"5503","D38","D43",0,0.792511685634946,3,133,130,3,3,0
"5504","D39","D43",0,0.537448305795192,15,121,118,3,15,0
"5505","D4","D43",0,0.760447734150187,4,132,129,3,4,0
"5506","D40","D43",0,0.732216032264721,5,131,128,3,5,0
"5507","D41","D43",0,0.683274873050331,7,129,126,3,7,0
"5508","D42","D43",0.333333333333333,0.000205681391078371,3,133,131,2,2,1
"5509","D43","D43",1,1.99530445797668e-31,3,133,133,0,0,3
"5510","D44","D43",0,0.275429552882231,38,98,95,3,38,0
"5511","D45","D43",0,0.585850572100077,12,124,121,3,12,0
"5512","D46","D43",0,0.275429552882231,38,98,95,3,38,0
"5513","D47","D43",0,0.585850572100077,12,124,121,3,12,0
"5514","D48","D43",0,0.394480841695529,26,110,107,3,26,0
"5515","D49","D43",0,0.569079451848605,13,123,120,3,13,0
"5516","D5","D43",0,0.792511685634946,3,133,130,3,3,0
"5517","D50","D43",0.5,3.54931258649229e-06,2,134,132,2,1,1
"5518","D51","D43",0,0.880178390709511,1,135,132,3,1,0
"5519","D52","D43",0.5,3.54931258649229e-06,2,134,132,2,1,1
"5520","D53","D43",1,2.39360797585802e-21,2,134,133,1,0,2
"5521","D9","D43",0,0.880178390709511,1,135,132,3,1,0
"5522","RMDQ1_v1","D43",0.0232558139534884,0.920972823893012,43,73,72,1,42,1
"5523","RMDQ2_v1","D43",0.0425531914893617,0.21975024120729,47,69,69,0,45,2
"5524","RMDQ3_v1","D43",0.0277777777777778,0.545973330618042,36,82,81,1,35,1
"5525","RMDQ4_v1","D43",0.0769230769230769,0.00729466964254349,26,92,92,0,24,2
"5526","RMDQ5_v1","D43",0.0303030303030303,0.483790516345729,33,85,84,1,32,1
"5527","RMDQ6_v1","D43",0.0689655172413793,0.0124631786329641,29,89,89,0,27,2
"5528","RMDQ7_v1","D43",0.05,0.212447592946906,20,97,96,1,19,1
"5529","RMDQ8_v1","D43",0,0.788407006817525,4,113,111,2,4,0
"5530","RMDQ9_v1","D43",0.0555555555555556,0.17114046257831,18,99,98,1,17,1
"5531","RMDQ10_v1","D43",0.0909090909090909,0.00303457735757642,22,95,95,0,20,2
"5532","RMDQ11_v1","D43",0.0869565217391304,0.00392958907169176,23,94,94,0,21,2
"5533","RMDQ12_v1","D43",0.0909090909090909,0.00303457735757642,22,95,95,0,20,2
"5534","RMDQ13_v1","D43",0.0454545454545455,0.254752373169046,22,95,94,1,21,1
"5535","RMDQ14_v1","D43",0.08,0.00621115026571818,25,92,92,0,23,2
"5536","RMDQ15_v1","D43",0,0.584363826258582,15,102,100,2,15,0
"5537","RMDQ16_v1","D43",0.0526315789473684,0.191631215221544,19,98,97,1,18,1
"5538","RMDQ17_v1","D43",0.0454545454545455,0.254752373169046,22,95,94,1,21,1
"5539","RMDQ18_v1","D43",0.05,0.212447592946906,20,97,96,1,19,1
"5540","RMDQ19_v1","D43",0,0.570203696419443,16,101,99,2,16,0
"5541","RMDQ20_v1","D43",0.0952380952380952,0.00228920903819295,21,96,96,0,19,2
"5542","RMDQ21_v1","D43",0.0833333333333333,0.00498524702997903,24,93,93,0,22,2
"5543","RMDQ22_v1","D43",0.05,0.212447592946906,20,97,96,1,19,1
"5544","RMDQ23_v1","D43",0.0526315789473684,0.191631215221544,19,98,97,1,18,1
"5545","RMDQ24_v1","D43",0.105263157894737,0.00119685414489978,19,98,98,0,17,2
"5546","DN4 - Queimação","D43",0.0188679245283019,0.266069863620088,53,65,65,0,52,1
"5547","DN4 - Sensação de frio dolorosa","D43",0.0416666666666667,0.0468674002441255,24,94,94,0,23,1
"5548","DN4 - Choque elétrico","D43",0.0277777777777778,0.127302516839353,36,83,83,0,35,1
"5549","DN4 - Formigamento","D43",0.032258064516129,0.0906514651303281,31,88,88,0,30,1
"5550","DN4 - Alfinetada e agulhada","D43",0.0277777777777778,0.127302516839353,36,83,83,0,35,1
"5551","DN4 - Adormecimento","D43",0.0303030303030303,0.107014020238433,33,85,85,0,32,1
"5552","DN4 - Coceira","D43",0,0.817001778007153,6,113,112,1,6,0
"5553","DH4 - Hipoestesia ao toque","D43",0.2,1.6257371427835e-06,5,114,114,0,4,1
"5554","DN4 - Hipoestesia a picada de agulha","D43",0.2,1.6257371427835e-06,5,114,114,0,4,1
"5555","DN4 - Escovação","D43",0.25,7.26161658379463e-08,4,115,115,0,3,1
"5556","Fuma","D44",0.239130434782609,0.350638862110726,46,82,56,26,35,11
"5557","Cirurgia na coluna","D44",0.327272727272727,0.495650914043256,55,63,46,17,37,18
"5558","Aposentado","D44",0.387096774193548,0.163072476144281,31,101,75,26,19,12
"5559","Desempregado","D44",0.12,0.0350567197360951,25,105,70,35,22,3
"5560","Licenca_Medica","D44",0.333333333333333,0.646724446099857,18,114,82,32,12,6
"5561","Aposentado_Invalidez","D44",0.5,0.158358492930817,8,123,90,33,4,4
"5562","Analgésicos","D44",0.375,0.00269429836471756,88,42,37,5,55,33
"5563","OutraDoenca","D44",0.28,0.926540879075171,50,80,57,23,36,14
"5564","Dor nas costas","D44",0.362637362637363,0.00398091877647235,91,37,33,4,58,33
"5565","Dor nas pernas","D44",0.563636363636364,3.57837444266334e-09,55,72,66,6,24,31
"5566","Retornar_trabalho","D44",0.35,0.485350084205755,20,99,72,27,13,7
"5567","Masc","D44",0.329545454545455,0.0776941451478986,88,48,39,9,59,29
"5568","Fem","D44",0.1875,0.0776941451478986,48,88,59,29,39,9
"5569","Casado/Amasiaado","D44",0.345454545454545,0.157248824101103,55,81,62,19,36,19
"5570","Solteiro","D44",0.203389830508475,0.0837178531898346,59,77,51,26,47,12
"5571","Separado_Divorciado","D44",0.285714285714286,0.969562661066158,7,129,93,36,5,2
"5572","X4","D44",0,0.275429552882231,3,133,95,38,3,0
"5573","X5","D44",0,0.374983020515037,2,134,96,38,2,0
"5574","X6","D44",0.5,0.106288088348678,10,126,93,33,5,5
"5575","Livrar_costas","D44",0.325581395348837,0.075534716456855,86,14,6,8,58,28
"5576","Livrar_perna","D44",0.571428571428571,0.075534716456855,14,86,58,28,6,8
"5577","Livrar_perda_sens","D44",NA,NA,0,100,64,36,0,0
"5578","D1","D44",0,0.531969817884708,1,135,97,38,1,0
"5579","D15","D44",0.285714285714286,0.969562661066158,7,129,93,36,5,2
"5580","D16","D44",0.8,1.93149500093739e-08,20,116,94,22,4,16
"5581","D17","D44",0,0.155979827588615,5,131,93,38,5,0
"5582","D18","D44",0,0.00800975216309347,16,120,82,38,16,0
"5583","D19","D44",0,0.0907187714181211,7,129,91,38,7,0
"5584","D2","D44",0.125,0.315723814596718,8,128,91,37,7,1
"5585","D20","D44",0,0.0694522599947637,8,128,90,38,8,0
"5586","D21","D44",0,0.0907187714181211,7,129,91,38,7,0
"5587","D22","D44",0,0.374983020515037,2,134,96,38,2,0
"5588","D23","D44",0.5,0.483675186223837,2,134,97,37,1,1
"5589","D24","D44",0.115384615384615,0.0382121431588958,26,110,75,35,23,3
"5590","D25","D44",0,0.206183885714472,4,132,94,38,4,0
"5591","D26","D44",0,0.374983020515037,2,134,96,38,2,0
"5592","D27","D44",0.4,0.54034529486454,5,131,95,36,3,2
"5593","D28","D44",0,0.118736483429802,6,130,92,38,6,0
"5594","D29","D44",0.738095238095238,1.60593740326931e-15,42,94,87,7,11,31
"5595","D3","D44",0,0.374983020515037,2,134,96,38,2,0
"5596","Lombalgia","D44",0.532258064516129,1.79817778216813e-09,62,74,69,5,29,33
"5597","D31","D44",0.235294117647059,0.66474018967914,17,119,85,34,13,4
"5598","D32","D44",0.864864864864865,1.37757029319158e-20,37,99,93,6,5,32
"5599","D33","D44",0.25,0.812039387153345,12,124,89,35,9,3
"5600","D34","D44",0,0.275429552882231,3,133,95,38,3,0
"5601","D35","D44",0,0.374983020515037,2,134,96,38,2,0
"5602","D36","D44",0.375,0.534546578737972,8,128,93,35,5,3
"5603","D37","D44",0.727272727272727,3.16492530850497e-07,22,114,92,22,6,16
"5604","D38","D44",0.333333333333333,0.833296835878753,3,133,96,37,2,1
"5605","D39","D44",0.866666666666667,7.70857802857795e-08,15,121,96,25,2,13
"5606","D4","D44",0,0.206183885714472,4,132,94,38,4,0
"5607","D40","D44",0.2,0.686789350124843,5,131,94,37,4,1
"5608","D41","D44",0.571428571428571,0.0770722845689075,7,129,95,34,3,4
"5609","D42","D44",0.333333333333333,0.833296835878753,3,133,96,37,2,1
"5610","D43","D44",0,0.275429552882231,3,133,95,38,3,0
"5611","D44","D44",1,1.99530445797665e-31,38,98,98,0,0,38
"5612","D45","D44",0.583333333333333,0.0140015175242032,12,124,93,31,5,7
"5613","D46","D44",0.894736842105263,2.31904918882307e-23,38,98,94,4,4,34
"5614","D47","D44",0.5,0.0745099309307417,12,124,92,32,6,6
"5615","D48","D44",0.846153846153846,8.00362801694675e-13,26,110,94,16,4,22
"5616","D49","D44",0.461538461538462,0.123840946903724,13,123,91,32,7,6
"5617","D5","D44",0.333333333333333,0.833296835878753,3,133,96,37,2,1
"5618","D50","D44",0,0.374983020515037,2,134,96,38,2,0
"5619","D51","D44",0,0.531969817884708,1,135,97,38,1,0
"5620","D52","D44",0.5,0.483675186223837,2,134,97,37,1,1
"5621","D53","D44",0,0.374983020515037,2,134,96,38,2,0
"5622","D9","D44",0,0.531969817884708,1,135,97,38,1,0
"5623","RMDQ1_v1","D44",0.348837209302326,0.687819627425963,43,73,51,22,28,15
"5624","RMDQ2_v1","D44",0.319148936170213,0.791955812338478,47,69,47,22,32,15
"5625","RMDQ3_v1","D44",0.388888888888889,0.242539283464844,36,82,59,23,22,14
"5626","RMDQ4_v1","D44",0.269230769230769,0.581107798957517,26,92,62,30,19,7
"5627","RMDQ5_v1","D44",0.424242424242424,0.106362286393871,33,85,62,23,19,14
"5628","RMDQ6_v1","D44",0.379310344827586,0.379514006202056,29,89,63,26,18,11
"5629","RMDQ7_v1","D44",0.4,0.376311582115925,20,97,68,29,12,8
"5630","RMDQ8_v1","D44",0.25,0.771897165960905,4,113,77,36,3,1
"5631","RMDQ9_v1","D44",0.333333333333333,0.865364682224068,18,99,68,31,12,6
"5632","RMDQ10_v1","D44",0.272727272727273,0.626208269250909,22,95,64,31,16,6
"5633","RMDQ11_v1","D44",0.304347826086957,0.891168187956784,23,94,64,30,16,7
"5634","RMDQ12_v1","D44",0.363636363636364,0.595724348514155,22,95,66,29,14,8
"5635","RMDQ13_v1","D44",0.363636363636364,0.595724348514155,22,95,66,29,14,8
"5636","RMDQ14_v1","D44",0.32,0.963628148596021,25,92,63,29,17,8
"5637","RMDQ15_v1","D44",0.4,0.454961709824423,15,102,71,31,9,6
"5638","RMDQ16_v1","D44",0.368421052631579,0.593023300735864,19,98,68,30,12,7
"5639","RMDQ17_v1","D44",0.272727272727273,0.626208269250909,22,95,64,31,16,6
"5640","RMDQ18_v1","D44",0.3,0.863810235831744,20,97,66,31,14,6
"5641","RMDQ19_v1","D44",0.4375,0.261577523539599,16,101,71,30,9,7
"5642","RMDQ20_v1","D44",0.285714285714286,0.739817099451421,21,96,65,31,15,6
"5643","RMDQ21_v1","D44",0.333333333333333,0.839920415549318,24,93,64,29,16,8
"5644","RMDQ22_v1","D44",0.35,0.721396218577618,20,97,67,30,13,7
"5645","RMDQ23_v1","D44",0.315789473684211,0.99632382851565,19,98,67,31,13,6
"5646","RMDQ24_v1","D44",0.315789473684211,0.99632382851565,19,98,67,31,13,6
"5647","DN4 - Queimação","D44",0.415094339622642,0.0318150511689424,53,65,50,15,31,22
"5648","DN4 - Sensação de frio dolorosa","D44",0.333333333333333,0.815026697223694,24,94,65,29,16,8
"5649","DN4 - Choque elétrico","D44",0.388888888888889,0.283752899184301,36,83,59,24,22,14
"5650","DN4 - Formigamento","D44",0.451612903225806,0.0661926275618911,31,88,64,24,17,14
"5651","DN4 - Alfinetada e agulhada","D44",0.305555555555556,0.831929847069928,36,83,56,27,25,11
"5652","DN4 - Adormecimento","D44",0.393939393939394,0.240928467432434,33,85,61,24,20,13
"5653","DN4 - Coceira","D44",0.166666666666667,0.410453044653206,6,113,76,37,5,1
"5654","DH4 - Hipoestesia ao toque","D44",0,0.117632762345584,5,114,76,38,5,0
"5655","DN4 - Hipoestesia a picada de agulha","D44",0,0.117632762345584,5,114,76,38,5,0
"5656","DN4 - Escovação","D44",0,0.163471677972797,4,115,77,38,4,0
"5657","Fuma","D45",0.130434782608696,0.178516355944478,46,82,77,5,40,6
"5658","Cirurgia na coluna","D45",0.127272727272727,0.12118016092976,55,63,60,3,48,7
"5659","Aposentado","D45",0.0645161290322581,0.664754482552757,31,101,92,9,29,2
"5660","Desempregado","D45",0.04,0.372458603077569,25,105,95,10,24,1
"5661","Licenca_Medica","D45",0.0555555555555556,0.64635519553949,18,114,104,10,17,1
"5662","Aposentado_Invalidez","D45",0.125,0.592682390026818,8,123,114,9,7,1
"5663","Analgésicos","D45",0.102272727272727,0.569918988554808,88,42,39,3,79,9
"5664","OutraDoenca","D45",0.1,0.810686022760786,50,80,73,7,45,5
"5665","Dor nas costas","D45",0.0989010989010989,0.753858312966399,91,37,34,3,82,9
"5666","Dor nas pernas","D45",0.218181818181818,3.11176432970382e-05,55,72,72,0,43,12
"5667","Retornar_trabalho","D45",0.1,0.777812963766478,20,99,91,8,18,2
"5668","Masc","D45",0.0909090909090909,0.881670055755965,88,48,44,4,80,8
"5669","Fem","D45",0.0833333333333333,0.881670055755965,48,88,80,8,44,4
"5670","Casado/Amasiaado","D45",0.0363636363636364,0.0788460431367428,55,81,71,10,53,2
"5671","Solteiro","D45",0.152542372881356,0.0206434834553231,59,77,74,3,50,9
"5672","Separado_Divorciado","D45",0,0.398060116685702,7,129,117,12,7,0
"5673","X4","D45",0,0.585850572100077,3,133,121,12,3,0
"5674","X5","D45",0,0.657612161666932,2,134,122,12,2,0
"5675","X6","D45",0.1,0.891607233250317,10,126,115,11,9,1
"5676","Livrar_costas","D45",0.0930232558139535,0.0396368172231428,86,14,10,4,78,8
"5677","Livrar_perna","D45",0.285714285714286,0.0396368172231428,14,86,78,8,10,4
"5678","Livrar_perda_sens","D45",NA,NA,0,100,88,12,0,0
"5679","D1","D45",0,0.75486151575449,1,135,123,12,1,0
"5680","D15","D45",0.285714285714286,0.0585717946693723,7,129,119,10,5,2
"5681","D16","D45",0.1,0.840815091812043,20,116,106,10,18,2
"5682","D17","D45",0,0.478474042466117,5,131,119,12,5,0
"5683","D18","D45",0,0.185269593670831,16,120,108,12,16,0
"5684","D19","D45",0,0.398060116685702,7,129,117,12,7,0
"5685","D2","D45",0.125,0.705504165117011,8,128,117,11,7,1
"5686","D20","D45",0,0.364426724716409,8,128,116,12,8,0
"5687","D21","D45",0,0.398060116685702,7,129,117,12,7,0
"5688","D22","D45",0,0.657612161666932,2,134,122,12,2,0
"5689","D23","D45",0.5,0.0386095472359837,2,134,123,11,1,1
"5690","D24","D45",0.0384615384615385,0.319764612861751,26,110,99,11,25,1
"5691","D25","D45",0,0.527695676048595,4,132,120,12,4,0
"5692","D26","D45",0,0.657612161666932,2,134,122,12,2,0
"5693","D27","D45",0,0.478474042466117,5,131,119,12,5,0
"5694","D28","D45",0,0.435751751824147,6,130,118,12,6,0
"5695","D29","D45",0.0714285714285714,0.644150984248652,42,94,85,9,39,3
"5696","D3","D45",0,0.657612161666932,2,134,122,12,2,0
"5697","Lombalgia","D45",0.161290322580645,0.00597055526165822,62,74,72,2,52,10
"5698","D31","D45",0.411764705882353,4.96329069364611e-07,17,119,114,5,10,7
"5699","D32","D45",0.0810810810810811,0.857289318892686,37,99,90,9,34,3
"5700","D33","D45",0.666666666666667,1.37822593414904e-13,12,124,120,4,4,8
"5701","D34","D45",0,0.585850572100077,3,133,121,12,3,0
"5702","D35","D45",0,0.657612161666932,2,134,122,12,2,0
"5703","D36","D45",0.25,0.096359635700202,8,128,118,10,6,2
"5704","D37","D45",0.0454545454545455,0.43969649223599,22,114,103,11,21,1
"5705","D38","D45",0.666666666666667,0.000354464736547489,3,133,123,10,1,2
"5706","D39","D45",0.0666666666666667,0.75486151575449,15,121,110,11,14,1
"5707","D4","D45",0,0.527695676048595,4,132,120,12,4,0
"5708","D40","D45",0.4,0.0122700258445425,5,131,121,10,3,2
"5709","D41","D45",0.142857142857143,0.600868844205315,7,129,118,11,6,1
"5710","D42","D45",0,0.585850572100077,3,133,121,12,3,0
"5711","D43","D45",0,0.585850572100077,3,133,121,12,3,0
"5712","D44","D45",0.184210526315789,0.0140015175242032,38,98,93,5,31,7
"5713","D45","D45",1,1.99530445797665e-31,12,124,124,0,0,12
"5714","D46","D45",0.184210526315789,0.0140015175242032,38,98,93,5,31,7
"5715","D47","D45",0.833333333333333,1.57044126338805e-21,12,124,122,2,2,10
"5716","D48","D45",0.115384615384615,0.587339486314621,26,110,101,9,23,3
"5717","D49","D45",0.615384615384615,1.83769174287296e-12,13,123,119,4,5,8
"5718","D5","D45",0.333333333333333,0.130153483589304,3,133,122,11,2,1
"5719","D50","D45",0,0.657612161666932,2,134,122,12,2,0
"5720","D51","D45",0,0.75486151575449,1,135,123,12,1,0
"5721","D52","D45",0,0.657612161666932,2,134,122,12,2,0
"5722","D53","D45",0,0.657612161666932,2,134,122,12,2,0
"5723","D9","D45",0,0.75486151575449,1,135,123,12,1,0
"5724","RMDQ1_v1","D45",0.13953488372093,0.582170908878456,43,73,67,6,37,6
"5725","RMDQ2_v1","D45",0.127659574468085,0.734006438560595,47,69,63,6,41,6
"5726","RMDQ3_v1","D45",0.0555555555555556,0.27188104022459,36,82,72,10,34,2
"5727","RMDQ4_v1","D45",0,0.0520168860438896,26,92,80,12,26,0
"5728","RMDQ5_v1","D45",0.0606060606060606,0.357502828284442,33,85,75,10,31,2
"5729","RMDQ6_v1","D45",0.0344827586206897,0.16792704685569,29,89,78,11,28,1
"5730","RMDQ7_v1","D45",0.1,0.966888916247175,20,97,87,10,18,2
"5731","RMDQ8_v1","D45",0.25,0.322672901837808,4,113,102,11,3,1
"5732","RMDQ9_v1","D45",0.0555555555555556,0.474829810654609,18,99,88,11,17,1
"5733","RMDQ10_v1","D45",0.0454545454545455,0.327168795969465,22,95,84,11,21,1
"5734","RMDQ11_v1","D45",0.0434782608695652,0.297401424086814,23,94,83,11,22,1
"5735","RMDQ12_v1","D45",0.0454545454545455,0.327168795969465,22,95,84,11,21,1
"5736","RMDQ13_v1","D45",0.0454545454545455,0.327168795969465,22,95,84,11,21,1
"5737","RMDQ14_v1","D45",0.04,0.244921732627562,25,92,81,11,24,1
"5738","RMDQ15_v1","D45",0.0666666666666667,0.623569558117348,15,102,91,11,14,1
"5739","RMDQ16_v1","D45",0.0526315789473684,0.433119831393324,19,98,87,11,18,1
"5740","RMDQ17_v1","D45",0.0454545454545455,0.327168795969465,22,95,84,11,21,1
"5741","RMDQ18_v1","D45",0.05,0.394788570407184,20,97,86,11,19,1
"5742","RMDQ19_v1","D45",0.0625,0.569679711109244,16,101,90,11,15,1
"5743","RMDQ20_v1","D45",0.0476190476190476,0.359555505535032,21,96,85,11,20,1
"5744","RMDQ21_v1","D45",0.0416666666666667,0.27004794320233,24,93,82,11,23,1
"5745","RMDQ22_v1","D45",0.05,0.394788570407184,20,97,86,11,19,1
"5746","RMDQ23_v1","D45",0.0526315789473684,0.433119831393324,19,98,87,11,18,1
"5747","RMDQ24_v1","D45",0.0526315789473684,0.433119831393324,19,98,87,11,18,1
"5748","DN4 - Queimação","D45",0.188679245283019,0.00475853921802751,53,65,63,2,43,10
"5749","DN4 - Sensação de frio dolorosa","D45",0.0416666666666667,0.275657507779326,24,94,83,11,23,1
"5750","DN4 - Choque elétrico","D45",0.194444444444444,0.0255298524370368,36,83,78,5,29,7
"5751","DN4 - Formigamento","D45",0.258064516129032,0.000723216206233774,31,88,84,4,23,8
"5752","DN4 - Alfinetada e agulhada","D45",0.222222222222222,0.00377908564860014,36,83,79,4,28,8
"5753","DN4 - Adormecimento","D45",0.151515151515152,0.264566727705962,33,85,78,7,28,5
"5754","DN4 - Coceira","D45",0,0.399900240836412,6,113,101,12,6,0
"5755","DH4 - Hipoestesia ao toque","D45",0,0.444226067014997,5,114,102,12,5,0
"5756","DN4 - Hipoestesia a picada de agulha","D45",0,0.444226067014997,5,114,102,12,5,0
"5757","DN4 - Escovação","D45",0,0.495666894505734,4,115,103,12,4,0
"5758","Fuma","D46",0.239130434782609,0.350638862110726,46,82,56,26,35,11
"5759","Cirurgia na coluna","D46",0.309090909090909,0.638624518771858,55,63,46,17,38,17
"5760","Aposentado","D46",0.354838709677419,0.34653758378734,31,101,74,27,20,11
"5761","Desempregado","D46",0.16,0.105573295117912,25,105,71,34,21,4
"5762","Licenca_Medica","D46",0.222222222222222,0.507962262298833,18,114,80,34,14,4
"5763","Aposentado_Invalidez","D46",0.625,0.0312144132833846,8,123,90,33,3,5
"5764","Analgésicos","D46",0.375,0.00269429836471756,88,42,37,5,55,33
"5765","OutraDoenca","D46",0.34,0.268564802443693,50,80,60,20,33,17
"5766","Dor nas costas","D46",0.340659340659341,0.0434389068415285,91,37,31,6,60,31
"5767","Dor nas pernas","D46",0.581818181818182,3.04014927402761e-10,55,72,67,5,23,32
"5768","Retornar_trabalho","D46",0.45,0.0934608995444157,20,99,73,26,11,9
"5769","Masc","D46",0.318181818181818,0.172462527341592,88,48,38,10,60,28
"5770","Fem","D46",0.208333333333333,0.172462527341592,48,88,60,28,38,10
"5771","Casado/Amasiaado","D46",0.345454545454545,0.157248824101103,55,81,62,19,36,19
"5772","Solteiro","D46",0.186440677966102,0.0344209389193105,59,77,50,27,48,11
"5773","Separado_Divorciado","D46",0.285714285714286,0.969562661066158,7,129,93,36,5,2
"5774","X4","D46",0,0.275429552882231,3,133,95,38,3,0
"5775","X5","D46",0,0.374983020515037,2,134,96,38,2,0
"5776","X6","D46",0.6,0.0189107805148973,10,126,94,32,4,6
"5777","Livrar_costas","D46",0.313953488372093,0.017425222464693,86,14,5,9,59,27
"5778","Livrar_perna","D46",0.642857142857143,0.017425222464693,14,86,59,27,5,9
"5779","Livrar_perda_sens","D46",NA,NA,0,100,64,36,0,0
"5780","D1","D46",0,0.531969817884708,1,135,97,38,1,0
"5781","D15","D46",0.285714285714286,0.969562661066158,7,129,93,36,5,2
"5782","D16","D46",0.8,1.93149500093739e-08,20,116,94,22,4,16
"5783","D17","D46",0.2,0.686789350124843,5,131,94,37,4,1
"5784","D18","D46",0.125,0.142814491244088,16,120,84,36,14,2
"5785","D19","D46",0.285714285714286,0.969562661066158,7,129,93,36,5,2
"5786","D2","D46",0.25,0.84844589248364,8,128,92,36,6,2
"5787","D20","D46",0,0.0694522599947637,8,128,90,38,8,0
"5788","D21","D46",0.142857142857143,0.408389684189003,7,129,92,37,6,1
"5789","D22","D46",0,0.374983020515037,2,134,96,38,2,0
"5790","D23","D46",0.5,0.483675186223837,2,134,97,37,1,1
"5791","D24","D46",0.192307692307692,0.271067685431734,26,110,77,33,21,5
"5792","D25","D46",0,0.206183885714472,4,132,94,38,4,0
"5793","D26","D46",0,0.374983020515037,2,134,96,38,2,0
"5794","D27","D46",0.2,0.686789350124843,5,131,94,37,4,1
"5795","D28","D46",0,0.118736483429802,6,130,92,38,6,0
"5796","D29","D46",0.714285714285714,4.19242449205523e-14,42,94,86,8,12,30
"5797","D3","D46",0.5,0.483675186223837,2,134,97,37,1,1
"5798","Lombalgia","D46",0.532258064516129,1.79817778216813e-09,62,74,69,5,29,33
"5799","D31","D46",0.235294117647059,0.66474018967914,17,119,85,34,13,4
"5800","D32","D46",0.810810810810811,3.08741234119152e-17,37,99,91,8,7,30
"5801","D33","D46",0.25,0.812039387153345,12,124,89,35,9,3
"5802","D34","D46",0,0.275429552882231,3,133,95,38,3,0
"5803","D35","D46",0,0.374983020515037,2,134,96,38,2,0
"5804","D36","D46",0.375,0.534546578737972,8,128,93,35,5,3
"5805","D37","D46",0.772727272727273,1.77802875412139e-08,22,114,93,21,5,17
"5806","D38","D46",0.333333333333333,0.833296835878753,3,133,96,37,2,1
"5807","D39","D46",1,4.28364159950422e-11,15,121,98,23,0,15
"5808","D4","D46",0.25,0.89414105384095,4,132,95,37,3,1
"5809","D40","D46",0.2,0.686789350124843,5,131,94,37,4,1
"5810","D41","D46",0.714285714285714,0.00846793392216993,7,129,96,33,2,5
"5811","D42","D46",0,0.275429552882231,3,133,95,38,3,0
"5812","D43","D46",0,0.275429552882231,3,133,95,38,3,0
"5813","D44","D46",0.894736842105263,2.31904918882307e-23,38,98,94,4,4,34
"5814","D45","D46",0.583333333333333,0.0140015175242032,12,124,93,31,5,7
"5815","D46","D46",1,1.99530445797665e-31,38,98,98,0,0,38
"5816","D47","D46",0.666666666666667,0.00174224293504855,12,124,94,30,4,8
"5817","D48","D46",0.923076923076923,4.1859488586009e-16,26,110,96,14,2,24
"5818","D49","D46",0.538461538461538,0.0286114588554617,13,123,92,31,6,7
"5819","D5","D46",0.333333333333333,0.833296835878753,3,133,96,37,2,1
"5820","D50","D46",0,0.374983020515037,2,134,96,38,2,0
"5821","D51","D46",0,0.531969817884708,1,135,97,38,1,0
"5822","D52","D46",0,0.374983020515037,2,134,96,38,2,0
"5823","D53","D46",0,0.374983020515037,2,134,96,38,2,0
"5824","D9","D46",0,0.531969817884708,1,135,97,38,1,0
"5825","RMDQ1_v1","D46",0.348837209302326,0.687819627425963,43,73,51,22,28,15
"5826","RMDQ2_v1","D46",0.340425531914894,0.728049452399165,47,69,48,21,31,16
"5827","RMDQ3_v1","D46",0.416666666666667,0.109685573722337,36,82,60,22,21,15
"5828","RMDQ4_v1","D46",0.269230769230769,0.581107798957517,26,92,62,30,19,7
"5829","RMDQ5_v1","D46",0.484848484848485,0.0124562963042038,33,85,64,21,17,16
"5830","RMDQ6_v1","D46",0.413793103448276,0.180352737383203,29,89,64,25,17,12
"5831","RMDQ7_v1","D46",0.45,0.157705102959809,20,97,69,28,11,9
"5832","RMDQ8_v1","D46",0.25,0.771897165960905,4,113,77,36,3,1
"5833","RMDQ9_v1","D46",0.388888888888889,0.471165458428779,18,99,69,30,11,7
"5834","RMDQ10_v1","D46",0.318181818181818,0.982651985520405,22,95,65,30,15,7
"5835","RMDQ11_v1","D46",0.347826086956522,0.716272830409109,23,94,65,29,15,8
"5836","RMDQ12_v1","D46",0.363636363636364,0.595724348514155,22,95,66,29,14,8
"5837","RMDQ13_v1","D46",0.409090909090909,0.298630848415371,22,95,67,28,13,9
"5838","RMDQ14_v1","D46",0.28,0.660350491579065,25,92,62,30,18,7
"5839","RMDQ15_v1","D46",0.4,0.454961709824423,15,102,71,31,9,6
"5840","RMDQ16_v1","D46",0.368421052631579,0.593023300735864,19,98,68,30,12,7
"5841","RMDQ17_v1","D46",0.272727272727273,0.626208269250909,22,95,64,31,16,6
"5842","RMDQ18_v1","D46",0.3,0.863810235831744,20,97,66,31,14,6
"5843","RMDQ19_v1","D46",0.5,0.0888837729206359,16,101,72,29,8,8
"5844","RMDQ20_v1","D46",0.333333333333333,0.852465530180661,21,96,66,30,14,7
"5845","RMDQ21_v1","D46",0.375,0.487457244032155,24,93,65,28,15,9
"5846","RMDQ22_v1","D46",0.4,0.376311582115925,20,97,68,29,12,8
"5847","RMDQ23_v1","D46",0.368421052631579,0.593023300735864,19,98,68,30,12,7
"5848","RMDQ24_v1","D46",0.368421052631579,0.593023300735864,19,98,68,30,12,7
"5849","DN4 - Queimação","D46",0.433962264150943,0.0109075767241013,53,65,51,14,30,23
"5850","DN4 - Sensação de frio dolorosa","D46",0.333333333333333,0.815026697223694,24,94,65,29,16,8
"5851","DN4 - Choque elétrico","D46",0.416666666666667,0.133620063834212,36,83,60,23,21,15
"5852","DN4 - Formigamento","D46",0.451612903225806,0.0661926275618911,31,88,64,24,17,14
"5853","DN4 - Alfinetada e agulhada","D46",0.361111111111111,0.51965616320544,36,83,58,25,23,13
"5854","DN4 - Adormecimento","D46",0.424242424242424,0.106362286393871,33,85,62,23,19,14
"5855","DN4 - Coceira","D46",0.333333333333333,0.939806194659872,6,113,77,36,4,2
"5856","DH4 - Hipoestesia ao toque","D46",0.2,0.558725007131444,5,114,77,37,4,1
"5857","DN4 - Hipoestesia a picada de agulha","D46",0.2,0.558725007131444,5,114,77,37,4,1
"5858","DN4 - Escovação","D46",0.25,0.762245014770329,4,115,78,37,3,1
"5859","Fuma","D47",0.152173913043478,0.0894190257337713,46,82,77,5,39,7
"5860","Cirurgia na coluna","D47",0.109090909090909,0.209488455027041,55,63,60,3,49,6
"5861","Aposentado","D47",0.032258064516129,0.239491685490066,31,101,91,10,30,1
"5862","Desempregado","D47",0.08,0.926488935095709,25,105,96,9,23,2
"5863","Licenca_Medica","D47",0.0555555555555556,0.64635519553949,18,114,104,10,17,1
"5864","Aposentado_Invalidez","D47",0.25,0.0805623632313889,8,123,114,9,6,2
"5865","Analgésicos","D47",0.0909090909090909,0.936441443032889,88,42,38,4,80,8
"5866","OutraDoenca","D47",0.1,0.810686022760786,50,80,73,7,45,5
"5867","Dor nas costas","D47",0.0879120879120879,0.722317348868749,91,37,33,4,83,8
"5868","Dor nas pernas","D47",0.218181818181818,3.11176432970382e-05,55,72,72,0,43,12
"5869","Retornar_trabalho","D47",0.15,0.329840199948571,20,99,91,8,17,3
"5870","Masc","D47",0.0909090909090909,0.881670055755965,88,48,44,4,80,8
"5871","Fem","D47",0.0833333333333333,0.881670055755965,48,88,80,8,44,4
"5872","Casado/Amasiaado","D47",0.0363636363636364,0.0788460431367428,55,81,71,10,53,2
"5873","Solteiro","D47",0.135593220338983,0.0883000160710157,59,77,73,4,51,8
"5874","Separado_Divorciado","D47",0,0.398060116685702,7,129,117,12,7,0
"5875","X4","D47",0.333333333333333,0.130153483589304,3,133,122,11,2,1
"5876","X5","D47",0,0.657612161666932,2,134,122,12,2,0
"5877","X6","D47",0.1,0.891607233250317,10,126,115,11,9,1
"5878","Livrar_costas","D47",0.0813953488372093,0.00323609342187556,86,14,9,5,79,7
"5879","Livrar_perna","D47",0.357142857142857,0.00323609342187556,14,86,79,7,9,5
"5880","Livrar_perda_sens","D47",NA,NA,0,100,88,12,0,0
"5881","D1","D47",0,0.75486151575449,1,135,123,12,1,0
"5882","D15","D47",0.428571428571429,0.00111555229397474,7,129,120,9,4,3
"5883","D16","D47",0.05,0.513907330318457,20,116,105,11,19,1
"5884","D17","D47",0,0.478474042466117,5,131,119,12,5,0
"5885","D18","D47",0.0625,0.699221345182709,16,120,109,11,15,1
"5886","D19","D47",0.142857142857143,0.600868844205315,7,129,118,11,6,1
"5887","D2","D47",0.25,0.096359635700202,8,128,118,10,6,2
"5888","D20","D47",0,0.364426724716409,8,128,116,12,8,0
"5889","D21","D47",0,0.398060116685702,7,129,117,12,7,0
"5890","D22","D47",0,0.657612161666932,2,134,122,12,2,0
"5891","D23","D47",0.5,0.0386095472359837,2,134,123,11,1,1
"5892","D24","D47",0.0769230769230769,0.821105665434699,26,110,100,10,24,2
"5893","D25","D47",0,0.527695676048595,4,132,120,12,4,0
"5894","D26","D47",0,0.657612161666932,2,134,122,12,2,0
"5895","D27","D47",0,0.478474042466117,5,131,119,12,5,0
"5896","D28","D47",0,0.435751751824147,6,130,118,12,6,0
"5897","D29","D47",0.0714285714285714,0.644150984248652,42,94,85,9,39,3
"5898","D3","D47",0.5,0.0386095472359837,2,134,123,11,1,1
"5899","Lombalgia","D47",0.145161290322581,0.0321625129820207,62,74,71,3,53,9
"5900","D31","D47",0.470588235294118,2.81808467319097e-09,17,119,115,4,9,8
"5901","D32","D47",0.0540540540540541,0.390247963076714,37,99,89,10,35,2
"5902","D33","D47",0.583333333333333,2.41159060124652e-10,12,124,119,5,5,7
"5903","D34","D47",0,0.585850572100077,3,133,121,12,3,0
"5904","D35","D47",0,0.657612161666932,2,134,122,12,2,0
"5905","D36","D47",0.375,0.00320222636878169,8,128,119,9,5,3
"5906","D37","D47",0.0454545454545455,0.43969649223599,22,114,103,11,21,1
"5907","D38","D47",1,1.79991868350688e-08,3,133,124,9,0,3
"5908","D39","D47",0.0666666666666667,0.75486151575449,15,121,110,11,14,1
"5909","D4","D47",0.25,0.246945495557469,4,132,121,11,3,1
"5910","D40","D47",0.6,3.94286828513817e-05,5,131,122,9,2,3
"5911","D41","D47",0.142857142857143,0.600868844205315,7,129,118,11,6,1
"5912","D42","D47",0,0.585850572100077,3,133,121,12,3,0
"5913","D43","D47",0,0.585850572100077,3,133,121,12,3,0
"5914","D44","D47",0.157894736842105,0.0745099309307417,38,98,92,6,32,6
"5915","D45","D47",0.833333333333333,1.57044126338805e-21,12,124,122,2,2,10
"5916","D46","D47",0.210526315789474,0.00174224293504855,38,98,94,4,30,8
"5917","D47","D47",1,1.99530445797665e-31,12,124,124,0,0,12
"5918","D48","D47",0.115384615384615,0.587339486314621,26,110,101,9,23,3
"5919","D49","D47",0.692307692307692,6.77601989263865e-16,13,123,120,3,4,9
"5920","D5","D47",0.333333333333333,0.130153483589304,3,133,122,11,2,1
"5921","D50","D47",0,0.657612161666932,2,134,122,12,2,0
"5922","D51","D47",0,0.75486151575449,1,135,123,12,1,0
"5923","D52","D47",0,0.657612161666932,2,134,122,12,2,0
"5924","D53","D47",0,0.657612161666932,2,134,122,12,2,0
"5925","D9","D47",0,0.75486151575449,1,135,123,12,1,0
"5926","RMDQ1_v1","D47",0.13953488372093,0.582170908878456,43,73,67,6,37,6
"5927","RMDQ2_v1","D47",0.148936170212766,0.388387670078627,47,69,64,5,40,7
"5928","RMDQ3_v1","D47",0.0833333333333333,0.66192709096947,36,82,73,9,33,3
"5929","RMDQ4_v1","D47",0,0.0520168860438896,26,92,80,12,26,0
"5930","RMDQ5_v1","D47",0.0909090909090909,0.809140392447248,33,85,76,9,30,3
"5931","RMDQ6_v1","D47",0.0689655172413793,0.501926231189993,29,89,79,10,27,2
"5932","RMDQ7_v1","D47",0.15,0.442520223632859,20,97,88,9,17,3
"5933","RMDQ8_v1","D47",0.25,0.322672901837808,4,113,102,11,3,1
"5934","RMDQ9_v1","D47",0.111111111111111,0.896617814475036,18,99,89,10,16,2
"5935","RMDQ10_v1","D47",0.0909090909090909,0.8415073123212,22,95,85,10,20,2
"5936","RMDQ11_v1","D47",0.0869565217391304,0.783123310607865,23,94,84,10,21,2
"5937","RMDQ12_v1","D47",0.0909090909090909,0.8415073123212,22,95,85,10,20,2
"5938","RMDQ13_v1","D47",0.0909090909090909,0.8415073123212,22,95,85,10,20,2
"5939","RMDQ14_v1","D47",0.08,0.67495257839607,25,92,82,10,23,2
"5940","RMDQ15_v1","D47",0.133333333333333,0.673986052700643,15,102,92,10,13,2
"5941","RMDQ16_v1","D47",0.105263157894737,0.966202918505237,19,98,88,10,17,2
"5942","RMDQ17_v1","D47",0.0909090909090909,0.8415073123212,22,95,85,10,20,2
"5943","RMDQ18_v1","D47",0.1,0.966888916247175,20,97,87,10,18,2
"5944","RMDQ19_v1","D47",0.125,0.750201993823347,16,101,91,10,14,2
"5945","RMDQ20_v1","D47",0.0952380952380952,0.902770995656725,21,96,86,10,19,2
"5946","RMDQ21_v1","D47",0.0833333333333333,0.727614382819134,24,93,83,10,22,2
"5947","RMDQ22_v1","D47",0.1,0.966888916247175,20,97,87,10,18,2
"5948","RMDQ23_v1","D47",0.105263157894737,0.966202918505237,19,98,88,10,17,2
"5949","RMDQ24_v1","D47",0.105263157894737,0.966202918505237,19,98,88,10,17,2
"5950","DN4 - Queimação","D47",0.188679245283019,0.00475853921802751,53,65,63,2,43,10
"5951","DN4 - Sensação de frio dolorosa","D47",0.0416666666666667,0.275657507779326,24,94,83,11,23,1
"5952","DN4 - Choque elétrico","D47",0.25,0.000372576926849565,36,83,80,3,27,9
"5953","DN4 - Formigamento","D47",0.258064516129032,0.000723216206233774,31,88,84,4,23,8
"5954","DN4 - Alfinetada e agulhada","D47",0.25,0.000372576926849565,36,83,80,3,27,9
"5955","DN4 - Adormecimento","D47",0.151515151515152,0.264566727705962,33,85,78,7,28,5
"5956","DN4 - Coceira","D47",0,0.399900240836412,6,113,101,12,6,0
"5957","DH4 - Hipoestesia ao toque","D47",0.2,0.451855575848102,5,114,103,11,4,1
"5958","DN4 - Hipoestesia a picada de agulha","D47",0.2,0.451855575848102,5,114,103,11,4,1
"5959","DN4 - Escovação","D47",0.25,0.313554889768837,4,115,104,11,3,1
"5960","Fuma","D48",0.108695652173913,0.064111757722669,46,82,62,20,41,5
"5961","Cirurgia na coluna","D48",0.163636363636364,0.316152130871299,55,63,48,15,46,9
"5962","Aposentado","D48",0.32258064516129,0.0443954950387607,31,101,85,16,21,10
"5963","Desempregado","D48",0.12,0.265838463903265,25,105,82,23,22,3
"5964","Licenca_Medica","D48",0.166666666666667,0.727953336727627,18,114,91,23,15,3
"5965","Aposentado_Invalidez","D48",0.25,0.706103161103857,8,123,99,24,6,2
"5966","Analgésicos","D48",0.25,0.0391130108691627,88,42,38,4,66,22
"5967","OutraDoenca","D48",0.28,0.0714234577298519,50,80,68,12,36,14
"5968","Dor nas costas","D48",0.230769230769231,0.112539183962999,91,37,33,4,70,21
"5969","Dor nas pernas","D48",0.418181818181818,4.18907422610402e-08,55,72,70,2,32,23
"5970","Retornar_trabalho","D48",0.45,0.0014339061016768,20,99,85,14,11,9
"5971","Masc","D48",0.215909090909091,0.320635359680323,88,48,41,7,69,19
"5972","Fem","D48",0.145833333333333,0.320635359680323,48,88,69,19,41,7
"5973","Casado/Amasiaado","D48",0.218181818181818,0.509283068985424,55,81,67,14,43,12
"5974","Solteiro","D48",0.135593220338983,0.149035824612735,59,77,59,18,51,8
"5975","Separado_Divorciado","D48",0.142857142857143,0.738522327104601,7,129,104,25,6,1
"5976","X4","D48",0,0.394480841695529,3,133,107,26,3,0
"5977","X5","D48",0,0.488520668794022,2,134,108,26,2,0
"5978","X6","D48",0.5,0.00987480625918281,10,126,105,21,5,5
"5979","Livrar_costas","D48",0.209302325581395,0.0748358668411259,86,14,8,6,68,18
"5980","Livrar_perna","D48",0.428571428571429,0.0748358668411259,14,86,68,18,8,6
"5981","Livrar_perda_sens","D48",NA,NA,0,100,76,24,0,0
"5982","D1","D48",0,0.625571266952418,1,135,109,26,1,0
"5983","D15","D48",0.142857142857143,0.738522327104601,7,129,104,25,6,1
"5984","D16","D48",0.75,5.92063449651354e-12,20,116,105,11,5,15
"5985","D17","D48",0,0.268005741392268,5,131,105,26,5,0
"5986","D18","D48",0,0.0384261013671868,16,120,94,26,16,0
"5987","D19","D48",0,0.186591501022522,7,129,103,26,7,0
"5988","D2","D48",0.125,0.623676291683334,8,128,103,25,7,1
"5989","D20","D48",0,0.156358988235655,8,128,102,26,8,0
"5990","D21","D48",0,0.186591501022522,7,129,103,26,7,0
"5991","D22","D48",0,0.488520668794022,2,134,108,26,2,0
"5992","D23","D48",0.5,0.263175050261802,2,134,109,25,1,1
"5993","D24","D48",0.0769230769230769,0.0994869787322383,26,110,86,24,24,2
"5994","D25","D48",0,0.323658611852603,4,132,106,26,4,0
"5995","D26","D48",0,0.488520668794022,2,134,108,26,2,0
"5996","D27","D48",0.2,0.959227442302328,5,131,106,25,4,1
"5997","D28","D48",0,0.2232064450424,6,130,104,26,6,0
"5998","D29","D48",0.476190476190476,1.60401477515038e-08,42,94,88,6,22,20
"5999","D3","D48",0,0.488520668794022,2,134,108,26,2,0
"6000","Lombalgia","D48",0.370967741935484,1.05759235370063e-06,62,74,71,3,39,23
"6001","D31","D48",0.0588235294117647,0.137921328212535,17,119,94,25,16,1
"6002","D32","D48",0.567567567567568,8.84533478750784e-12,37,99,94,5,16,21
"6003","D33","D48",0.0833333333333333,0.319764612861751,12,124,99,25,11,1
"6004","D34","D48",0,0.394480841695529,3,133,107,26,3,0
"6005","D35","D48",0,0.488520668794022,2,134,108,26,2,0
"6006","D36","D48",0.125,0.623676291683334,8,128,103,25,7,1
"6007","D37","D48",0.681818181818182,1.63541453360409e-10,22,114,103,11,7,15
"6008","D38","D48",0,0.394480841695529,3,133,107,26,3,0
"6009","D39","D48",0.8,2.05389186833106e-10,15,121,107,14,3,12
"6010","D4","D48",0,0.323658611852603,4,132,106,26,4,0
"6011","D40","D48",0,0.268005741392268,5,131,105,26,5,0
"6012","D41","D48",0.571428571428571,0.00861550241929527,7,129,107,22,3,4
"6013","D42","D48",0,0.394480841695529,3,133,107,26,3,0
"6014","D43","D48",0,0.394480841695529,3,133,107,26,3,0
"6015","D44","D48",0.578947368421053,8.00362801694675e-13,38,98,94,4,16,22
"6016","D45","D48",0.25,0.587339486314621,12,124,101,23,9,3
"6017","D46","D48",0.631578947368421,4.1859488586009e-16,38,98,96,2,14,24
"6018","D47","D48",0.25,0.587339486314621,12,124,101,23,9,3
"6019","D48","D48",1,1.99530445797663e-31,26,110,110,0,0,26
"6020","D49","D48",0.230769230769231,0.702659067598973,13,123,100,23,10,3
"6021","D5","D48",0.333333333333333,0.526615348065255,3,133,108,25,2,1
"6022","D50","D48",0,0.488520668794022,2,134,108,26,2,0
"6023","D51","D48",0,0.625571266952418,1,135,109,26,1,0
"6024","D52","D48",0,0.488520668794022,2,134,108,26,2,0
"6025","D53","D48",0,0.488520668794022,2,134,108,26,2,0
"6026","D9","D48",0,0.625571266952418,1,135,109,26,1,0
"6027","RMDQ1_v1","D48",0.232558139534884,0.853761731914164,43,73,57,16,33,10
"6028","RMDQ2_v1","D48",0.212765957446809,0.840592113922925,47,69,53,16,37,10
"6029","RMDQ3_v1","D48",0.305555555555556,0.138919545778521,36,82,67,15,25,11
"6030","RMDQ4_v1","D48",0.307692307692308,0.22357858074098,26,92,74,18,18,8
"6031","RMDQ5_v1","D48",0.363636363636364,0.0192803113455495,33,85,71,14,21,12
"6032","RMDQ6_v1","D48",0.310344827586207,0.178130556434573,29,89,72,17,20,9
"6033","RMDQ7_v1","D48",0.25,0.742783600553943,20,97,76,21,15,5
"6034","RMDQ8_v1","D48",0.5,0.17390842717539,4,113,89,24,2,2
"6035","RMDQ9_v1","D48",0.222222222222222,1,18,99,77,22,14,4
"6036","RMDQ10_v1","D48",0.181818181818182,0.612942326761131,22,95,73,22,18,4
"6037","RMDQ11_v1","D48",0.217391304347826,0.950425149881039,23,94,73,21,18,5
"6038","RMDQ12_v1","D48",0.227272727272727,0.949579577806421,22,95,74,21,17,5
"6039","RMDQ13_v1","D48",0.272727272727273,0.527159865660169,22,95,75,20,16,6
"6040","RMDQ14_v1","D48",0.12,0.165620625440185,25,92,69,23,22,3
"6041","RMDQ15_v1","D48",0.2,0.824532025810749,15,102,79,23,12,3
"6042","RMDQ16_v1","D48",0.210526315789474,0.893411291142895,19,98,76,22,15,4
"6043","RMDQ17_v1","D48",0.136363636363636,0.282378909506142,22,95,72,23,19,3
"6044","RMDQ18_v1","D48",0.15,0.393526014899011,20,97,74,23,17,3
"6045","RMDQ19_v1","D48",0.3125,0.349854895890217,16,101,80,21,11,5
"6046","RMDQ20_v1","D48",0.19047619047619,0.699267787550123,21,96,74,22,17,4
"6047","RMDQ21_v1","D48",0.25,0.71351373126343,24,93,73,20,18,6
"6048","RMDQ22_v1","D48",0.25,0.742783600553943,20,97,76,21,15,5
"6049","RMDQ23_v1","D48",0.210526315789474,0.893411291142895,19,98,76,22,15,4
"6050","RMDQ24_v1","D48",0.210526315789474,0.893411291142895,19,98,76,22,15,4
"6051","DN4 - Queimação","D48",0.245283018867925,0.307307465859831,53,65,54,11,40,13
"6052","DN4 - Sensação de frio dolorosa","D48",0.208333333333333,0.946254614399026,24,94,75,19,19,5
"6053","DN4 - Choque elétrico","D48",0.305555555555556,0.0922337776047711,36,83,69,14,25,11
"6054","DN4 - Formigamento","D48",0.387096774193548,0.00490215543486522,31,88,75,13,19,12
"6055","DN4 - Alfinetada e agulhada","D48",0.25,0.48146032827094,36,83,67,16,27,9
"6056","DN4 - Adormecimento","D48",0.272727272727273,0.24364675372679,33,85,70,15,24,9
"6057","DN4 - Coceira","D48",0.333333333333333,0.44694723501294,6,113,90,23,4,2
"6058","DH4 - Hipoestesia ao toque","D48",0,0.238724325823377,5,114,89,25,5,0
"6059","DN4 - Hipoestesia a picada de agulha","D48",0,0.238724325823377,5,114,89,25,5,0
"6060","DN4 - Escovação","D48",0,0.294083464247611,4,115,90,25,4,0
"6061","Fuma","D49",0.0869565217391304,0.68200455078705,46,82,73,9,42,4
"6062","Cirurgia na coluna","D49",0.0909090909090909,0.935692524034151,55,63,57,6,50,5
"6063","Aposentado","D49",0.032258064516129,0.194081208290354,31,101,90,11,30,1
"6064","Desempregado","D49",0.04,0.314720508202041,25,105,94,11,24,1
"6065","Licenca_Medica","D49",0.0555555555555556,0.574503810234665,18,114,103,11,17,1
"6066","Aposentado_Invalidez","D49",0,0.353964775299636,8,123,111,12,8,0
"6067","Analgésicos","D49",0.0909090909090909,0.61699041838055,88,42,37,5,80,8
"6068","OutraDoenca","D49",0.08,0.54788979951689,50,80,71,9,46,4
"6069","Dor nas costas","D49",0.10989010989011,0.624741479704726,91,37,34,3,81,10
"6070","Dor nas pernas","D49",0.181818181818182,0.00982855903596777,55,72,69,3,45,10
"6071","Retornar_trabalho","D49",0.1,0.989082709194739,20,99,89,10,18,2
"6072","Masc","D49",0.0909090909090909,0.801591655827893,88,48,43,5,80,8
"6073","Fem","D49",0.104166666666667,0.801591655827893,48,88,80,8,43,5
"6074","Casado/Amasiaado","D49",0.0909090909090909,0.878454387341184,55,81,73,8,50,5
"6075","Solteiro","D49",0.101694915254237,0.83209405778434,59,77,70,7,53,6
"6076","Separado_Divorciado","D49",0,0.377146151318951,7,129,116,13,7,0
"6077","X4","D49",0.333333333333333,0.156711306704719,3,133,121,12,2,1
"6078","X5","D49",0,0.643234299777126,2,134,121,13,2,0
"6079","X6","D49",0.1,0.960683450676548,10,126,114,12,9,1
"6080","Livrar_costas","D49",0.104651162790698,0.0617410439153952,86,14,10,4,77,9
"6081","Livrar_perna","D49",0.285714285714286,0.0617410439153952,14,86,77,9,10,4
"6082","Livrar_perda_sens","D49",NA,NA,0,100,87,13,0,0
"6083","D1","D49",0,0.744194764154502,1,135,122,13,1,0
"6084","D15","D49",0.285714285714286,0.0789811536453963,7,129,118,11,5,2
"6085","D16","D49",0,0.115428930418204,20,116,103,13,20,0
"6086","D17","D49",0,0.458879926672685,5,131,118,13,5,0
"6087","D18","D49",0,0.166239567407229,16,120,107,13,16,0
"6088","D19","D49",0,0.377146151318951,7,129,116,13,7,0
"6089","D2","D49",0.125,0.770562847497233,8,128,116,12,7,1
"6090","D20","D49",0,0.343218080309131,8,128,115,13,8,0
"6091","D21","D49",0.285714285714286,0.0789811536453963,7,129,118,11,5,2
"6092","D22","D49",0,0.643234299777126,2,134,121,13,2,0
"6093","D23","D49",0.5,0.0500409359430017,2,134,122,12,1,1
"6094","D24","D49",0.115384615384615,0.702659067598973,26,110,100,10,23,3
"6095","D25","D49",0,0.509265854764088,4,132,119,13,4,0
"6096","D26","D49",0,0.643234299777126,2,134,121,13,2,0
"6097","D27","D49",0,0.458879926672685,5,131,118,13,5,0
"6098","D28","D49",0,0.41535703107105,6,130,117,13,6,0
"6099","D29","D49",0.0952380952380952,0.992593373067213,42,94,85,9,38,4
"6100","D3","D49",0,0.643234299777126,2,134,121,13,2,0
"6101","Lombalgia","D49",0.17741935483871,0.00296964331889492,62,74,72,2,51,11
"6102","D31","D49",0.411764705882353,2.13875802145062e-06,17,119,113,6,10,7
"6103","D32","D49",0.108108108108108,0.76145100328292,37,99,90,9,33,4
"6104","D33","D49",0.75,6.77601989263865e-16,12,124,120,4,3,9
"6105","D34","D49",0,0.569079451848605,3,133,120,13,3,0
"6106","D35","D49",0,0.643234299777126,2,134,121,13,2,0
"6107","D36","D49",0.25,0.125743835469762,8,128,117,11,6,2
"6108","D37","D49",0,0.0958108631307896,22,114,101,13,22,0
"6109","D38","D49",0.666666666666667,0.000669322543672837,3,133,122,11,1,2
"6110","D39","D49",0,0.181916336185615,15,121,108,13,15,0
"6111","D4","D49",0,0.509265854764088,4,132,119,13,4,0
"6112","D40","D49",0.4,0.018333114640816,5,131,120,11,3,2
"6113","D41","D49",0,0.377146151318951,7,129,116,13,7,0
"6114","D42","D49",0,0.569079451848605,3,133,120,13,3,0
"6115","D43","D49",0,0.569079451848605,3,133,120,13,3,0
"6116","D44","D49",0.157894736842105,0.123840946903724,38,98,91,7,32,6
"6117","D45","D49",0.666666666666667,1.83769174287296e-12,12,124,119,5,4,8
"6118","D46","D49",0.184210526315789,0.0286114588554617,38,98,92,6,31,7
"6119","D47","D49",0.75,6.77601989263865e-16,12,124,120,4,3,9
"6120","D48","D49",0.115384615384615,0.702659067598973,26,110,100,10,23,3
"6121","D49","D49",1,1.99530445797665e-31,13,123,123,0,0,13
"6122","D5","D49",0.333333333333333,0.156711306704719,3,133,121,12,2,1
"6123","D50","D49",0,0.643234299777126,2,134,121,13,2,0
"6124","D51","D49",0,0.744194764154502,1,135,122,13,1,0
"6125","D52","D49",0,0.643234299777126,2,134,121,13,2,0
"6126","D53","D49",0,0.643234299777126,2,134,121,13,2,0
"6127","D9","D49",0,0.744194764154502,1,135,122,13,1,0
"6128","RMDQ1_v1","D49",0.116279069767442,0.933167918034082,43,73,65,8,38,5
"6129","RMDQ2_v1","D49",0.127659574468085,0.851915214910633,47,69,62,7,41,6
"6130","RMDQ3_v1","D49",0.0555555555555556,0.209310135673498,36,82,71,11,34,2
"6131","RMDQ4_v1","D49",0,0.0421597727084564,26,92,79,13,26,0
"6132","RMDQ5_v1","D49",0.0606060606060606,0.283974187424066,33,85,74,11,31,2
"6133","RMDQ6_v1","D49",0.0344827586206897,0.133892609362277,29,89,77,12,28,1
"6134","RMDQ7_v1","D49",0.1,0.862139817963145,20,97,86,11,18,2
"6135","RMDQ8_v1","D49",0.25,0.368444225205557,4,113,101,12,3,1
"6136","RMDQ9_v1","D49",0.0555555555555556,0.41488003047373,18,99,87,12,17,1
"6137","RMDQ10_v1","D49",0.0909090909090909,0.737921701280218,22,95,84,11,20,2
"6138","RMDQ11_v1","D49",0.0434782608695652,0.249543835306561,23,94,82,12,22,1
"6139","RMDQ12_v1","D49",0.0454545454545455,0.27682819675887,22,95,83,12,21,1
"6140","RMDQ13_v1","D49",0.0454545454545455,0.27682819675887,22,95,83,12,21,1
"6141","RMDQ14_v1","D49",0.04,0.202003995111537,25,92,80,12,24,1
"6142","RMDQ15_v1","D49",0.0666666666666667,0.557462026301778,15,102,90,12,14,1
"6143","RMDQ16_v1","D49",0.0526315789473684,0.375480790918795,19,98,86,12,18,1
"6144","RMDQ17_v1","D49",0.0454545454545455,0.27682819675887,22,95,83,12,21,1
"6145","RMDQ18_v1","D49",0.05,0.339537234605017,20,97,85,12,19,1
"6146","RMDQ19_v1","D49",0.0625,0.505459059896831,16,101,89,12,15,1
"6147","RMDQ20_v1","D49",0.0476190476190476,0.306744119256604,21,96,84,12,20,1
"6148","RMDQ21_v1","D49",0.0416666666666667,0.224669361614885,24,93,81,12,23,1
"6149","RMDQ22_v1","D49",0.05,0.339537234605017,20,97,85,12,19,1
"6150","RMDQ23_v1","D49",0.105263157894737,0.92937963895314,19,98,87,11,17,2
"6151","RMDQ24_v1","D49",0.0526315789473684,0.375480790918795,19,98,86,12,18,1
"6152","DN4 - Queimação","D49",0.150943396226415,0.201467983968176,53,65,60,5,45,8
"6153","DN4 - Sensação de frio dolorosa","D49",0.0833333333333333,0.638029486706138,24,94,83,11,22,2
"6154","DN4 - Choque elétrico","D49",0.222222222222222,0.00926872850286714,36,83,78,5,28,8
"6155","DN4 - Formigamento","D49",0.32258064516129,9.51387328061662e-06,31,88,85,3,21,10
"6156","DN4 - Alfinetada e agulhada","D49",0.222222222222222,0.00926872850286714,36,83,78,5,28,8
"6157","DN4 - Adormecimento","D49",0.181818181818182,0.121415134494979,33,85,78,7,27,6
"6158","DN4 - Coceira","D49",0.166666666666667,0.643565378174902,6,113,101,12,5,1
"6159","DH4 - Hipoestesia ao toque","D49",0,0.423673641225769,5,114,101,13,5,0
"6160","DN4 - Hipoestesia a picada de agulha","D49",0,0.423673641225769,5,114,101,13,5,0
"6161","DN4 - Escovação","D49",0,0.476166960329298,4,115,102,13,4,0
"6162","Fuma","D5",0.0652173913043478,0.0192774091404522,46,82,82,0,43,3
"6163","Cirurgia na coluna","D5",0.0363636363636364,0.126868659625014,55,63,63,0,53,2
"6164","Aposentado","D5",0.0645161290322581,0.0742960957152981,31,101,100,1,29,2
"6165","Desempregado","D5",0.08,0.0349279503975996,25,105,104,1,23,2
"6166","Licenca_Medica","D5",0.111111111111111,0.0067800176274091,18,114,113,1,16,2
"6167","Aposentado_Invalidez","D5",0,0.654967047400161,8,123,120,3,8,0
"6168","Analgésicos","D5",0.0227272727272727,0.969342526948564,88,42,41,1,86,2
"6169","OutraDoenca","D5",0.04,0.309653706055374,50,80,79,1,48,2
"6170","Dor nas costas","D5",0.032967032967033,0.263733054433354,91,37,37,0,88,3
"6171","Dor nas pernas","D5",0.0363636363636364,0.408596111613207,55,72,71,1,53,2
"6172","Retornar_trabalho","D5",0.05,0.438127087910104,20,99,97,2,19,1
"6173","Masc","D5",0.0227272727272727,0.942710185623704,88,48,47,1,86,2
"6174","Fem","D5",0.0208333333333333,0.942710185623704,48,88,86,2,47,1
"6175","Casado/Amasiaado","D5",0,0.148948627194368,55,81,78,3,55,0
"6176","Solteiro","D5",0.0338983050847458,0.410577598948078,59,77,76,1,57,2
"6177","Separado_Divorciado","D5",0,0.683274873050331,7,129,126,3,7,0
"6178","X4","D5",0,0.792511685634946,3,133,130,3,3,0
"6179","X5","D5",0,0.830565083280277,2,134,131,3,2,0
"6180","X6","D5",0.1,0.0812591734655008,10,126,124,2,9,1
"6181","Livrar_costas","D5",0.0348837209302326,0.477976598685774,86,14,14,0,83,3
"6182","Livrar_perna","D5",0,0.477976598685774,14,86,83,3,14,0
"6183","Livrar_perda_sens","D5",NA,NA,0,100,97,3,0,0
"6184","D1","D5",0,0.880178390709511,1,135,132,3,1,0
"6185","D15","D5",0.142857142857143,0.0254648673683159,7,129,127,2,6,1
"6186","D16","D5",0.05,0.356947483268678,20,116,114,2,19,1
"6187","D17","D5",0,0.732216032264721,5,131,128,3,5,0
"6188","D18","D5",0,0.522466034450895,16,120,117,3,16,0
"6189","D19","D5",0,0.683274873050331,7,129,126,3,7,0
"6190","D2","D5",0.375,2.45394149904231e-12,8,128,128,0,5,3
"6191","D20","D5",0,0.66148119738657,8,128,125,3,8,0
"6192","D21","D5",0,0.683274873050331,7,129,126,3,7,0
"6193","D22","D5",0,0.830565083280277,2,134,131,3,2,0
"6194","D23","D5",0,0.830565083280277,2,134,131,3,2,0
"6195","D24","D5",0.0769230769230769,0.0341850787437454,26,110,109,1,24,2
"6196","D25","D5",0,0.760447734150187,4,132,129,3,4,0
"6197","D26","D5",0,0.830565083280277,2,134,131,3,2,0
"6198","D27","D5",0,0.732216032264721,5,131,128,3,5,0
"6199","D28","D5",0,0.706710630318467,6,130,127,3,6,0
"6200","D29","D5",0.0238095238095238,0.925969626755765,42,94,92,2,41,1
"6201","D3","D5",0,0.830565083280277,2,134,131,3,2,0
"6202","Lombalgia","D5",0.0161290322580645,0.666494321244379,62,74,72,2,61,1
"6203","D31","D5",0.0588235294117647,0.269885467194664,17,119,117,2,16,1
"6204","D32","D5",0,0.284282472208915,37,99,96,3,37,0
"6205","D33","D5",0,0.585850572100077,12,124,121,3,12,0
"6206","D34","D5",0.666666666666667,1.50720442587269e-14,3,133,132,1,1,2
"6207","D35","D5",0.5,3.54931258649229e-06,2,134,132,2,1,1
"6208","D36","D5",0,0.66148119738657,8,128,125,3,8,0
"6209","D37","D5",0.0454545454545455,0.414470989930587,22,114,112,2,21,1
"6210","D38","D5",0,0.792511685634946,3,133,130,3,3,0
"6211","D39","D5",0,0.537448305795192,15,121,118,3,15,0
"6212","D4","D5",0.25,0.00162957881054941,4,132,130,2,3,1
"6213","D40","D5",0,0.732216032264721,5,131,128,3,5,0
"6214","D41","D5",0,0.683274873050331,7,129,126,3,7,0
"6215","D42","D5",0,0.792511685634946,3,133,130,3,3,0
"6216","D43","D5",0,0.792511685634946,3,133,130,3,3,0
"6217","D44","D5",0.0263157894736842,0.833296835878753,38,98,96,2,37,1
"6218","D45","D5",0.0833333333333333,0.130153483589304,12,124,122,2,11,1
"6219","D46","D5",0.0263157894736842,0.833296835878753,38,98,96,2,37,1
"6220","D47","D5",0.0833333333333333,0.130153483589304,12,124,122,2,11,1
"6221","D48","D5",0.0384615384615385,0.526615348065255,26,110,108,2,25,1
"6222","D49","D5",0.0769230769230769,0.156711306704719,13,123,121,2,12,1
"6223","D5","D5",1,1.99530445797668e-31,3,133,133,0,0,3
"6224","D50","D5",0.5,3.54931258649229e-06,2,134,132,2,1,1
"6225","D51","D5",1,2.34190534565149e-11,1,135,133,2,0,1
"6226","D52","D5",0,0.830565083280277,2,134,131,3,2,0
"6227","D53","D5",0,0.830565083280277,2,134,131,3,2,0
"6228","D9","D5",1,2.34190534565149e-11,1,135,133,2,0,1
"6229","RMDQ1_v1","D5",0.0232558139534884,0.977692589616264,43,73,71,2,42,1
"6230","RMDQ2_v1","D5",0.0425531914893617,0.635197336145884,47,69,68,1,45,2
"6231","RMDQ3_v1","D5",0.0555555555555556,0.168267917974578,36,82,81,1,34,2
"6232","RMDQ4_v1","D5",0,0.350971009055765,26,92,89,3,26,0
"6233","RMDQ5_v1","D5",0.0606060606060606,0.130326862481361,33,85,84,1,31,2
"6234","RMDQ6_v1","D5",0.0344827586206897,0.721195830689568,29,89,87,2,28,1
"6235","RMDQ7_v1","D5",0.1,0.0208539320778979,20,97,96,1,18,2
"6236","RMDQ8_v1","D5",0.25,0.00386858247612339,4,113,111,2,3,1
"6237","RMDQ9_v1","D5",0.0555555555555556,0.382715303047254,18,99,97,2,17,1
"6238","RMDQ10_v1","D5",0.0454545454545455,0.514082165897887,22,95,93,2,21,1
"6239","RMDQ11_v1","D5",0.0434782608695652,0.545976469961421,23,94,92,2,22,1
"6240","RMDQ12_v1","D5",0.0454545454545455,0.514082165897887,22,95,93,2,21,1
"6241","RMDQ13_v1","D5",0.0454545454545455,0.514082165897887,22,95,93,2,21,1
"6242","RMDQ14_v1","D5",0.04,0.608489851420513,25,92,90,2,24,1
"6243","RMDQ15_v1","D5",0.0666666666666667,0.281645394833599,15,102,100,2,14,1
"6244","RMDQ16_v1","D5",0.0526315789473684,0.416056255685071,19,98,96,2,18,1
"6245","RMDQ17_v1","D5",0.0454545454545455,0.514082165897887,22,95,93,2,21,1
"6246","RMDQ18_v1","D5",0.05,0.449093732608259,20,97,95,2,19,1
"6247","RMDQ19_v1","D5",0.0625,0.315406941789669,16,101,99,2,15,1
"6248","RMDQ20_v1","D5",0.0476190476190476,0.481780260520299,21,96,94,2,20,1
"6249","RMDQ21_v1","D5",0.0416666666666667,0.577448469865294,24,93,91,2,23,1
"6250","RMDQ22_v1","D5",0.05,0.449093732608259,20,97,95,2,19,1
"6251","RMDQ23_v1","D5",0.0526315789473684,0.416056255685071,19,98,96,2,18,1
"6252","RMDQ24_v1","D5",0.0526315789473684,0.416056255685071,19,98,96,2,18,1
"6253","DN4 - Queimação","D5",0.0377358490566038,0.442942687132334,53,65,64,1,51,2
"6254","DN4 - Sensação de frio dolorosa","D5",0,0.375330930984671,24,94,91,3,24,0
"6255","DN4 - Choque elétrico","D5",0.0555555555555556,0.164313056647265,36,83,82,1,34,2
"6256","DN4 - Formigamento","D5",0.0645161290322581,0.104500621656448,31,88,87,1,29,2
"6257","DN4 - Alfinetada e agulhada","D5",0.0555555555555556,0.164313056647265,36,83,82,1,34,2
"6258","DN4 - Adormecimento","D5",0.0303030303030303,0.833818818348444,33,85,83,2,32,1
"6259","DN4 - Coceira","D5",0.166666666666667,0.0233141434108428,6,113,111,2,5,1
"6260","DH4 - Hipoestesia ao toque","D5",0.2,0.0108560655197623,5,114,112,2,4,1
"6261","DN4 - Hipoestesia a picada de agulha","D5",0.2,0.0108560655197623,5,114,112,2,4,1
"6262","DN4 - Escovação","D5",0.25,0.0035301799116423,4,115,113,2,3,1
"6263","Fuma","D50",0.0434782608695652,0.0570268627122226,46,82,82,0,44,2
"6264","Cirurgia na coluna","D50",0.0181818181818182,0.282453923933158,55,63,63,0,54,1
"6265","Aposentado","D50",0,0.429821621542201,31,101,99,2,31,0
"6266","Desempregado","D50",0.04,0.265838463903265,25,105,104,1,24,1
"6267","Licenca_Medica","D50",0.0555555555555556,0.131038190578192,18,114,113,1,17,1
"6268","Aposentado_Invalidez","D50",0,0.71626653488051,8,123,121,2,8,0
"6269","Analgésicos","D50",0.0113636363636364,0.589754290789669,88,42,41,1,87,1
"6270","OutraDoenca","D50",0.02,0.73534779052376,50,80,79,1,49,1
"6271","Dor nas costas","D50",0.010989010989011,0.507170788539898,91,37,36,1,90,1
"6272","Dor nas pernas","D50",0,0.212807680324934,55,72,70,2,55,0
"6273","Retornar_trabalho","D50",0,0.52148919720768,20,99,97,2,20,0
"6274","Masc","D50",0,0.0537195355854463,88,48,46,2,88,0
"6275","Fem","D50",0.0416666666666667,0.0537195355854463,48,88,88,0,46,2
"6276","Casado/Amasiaado","D50",0.0181818181818182,0.781401816104309,55,81,80,1,54,1
"6277","Solteiro","D50",0.0169491525423729,0.849120602315612,59,77,76,1,58,1
"6278","Separado_Divorciado","D50",0,0.739976909027013,7,129,127,2,7,0
"6279","X4","D50",0,0.830565083280277,3,133,131,2,3,0
"6280","X5","D50",0,0.861819671758601,2,134,132,2,2,0
"6281","X6","D50",0,0.688146459888278,10,126,124,2,10,0
"6282","Livrar_costas","D50",0.0116279069767442,0.685105670480977,86,14,14,0,85,1
"6283","Livrar_perna","D50",0,0.685105670480977,14,86,85,1,14,0
"6284","Livrar_perda_sens","D50",NA,NA,0,100,99,1,0,0
"6285","D1","D50",0,0.902407153906854,1,135,133,2,1,0
"6286","D15","D50",0,0.739976909027013,7,129,127,2,7,0
"6287","D16","D50",0,0.554127697484356,20,116,114,2,20,0
"6288","D17","D50",0,0.780748527710185,5,131,129,2,5,0
"6289","D18","D50",0,0.602898245770971,16,120,118,2,16,0
"6290","D19","D50",0,0.739976909027013,7,129,127,2,7,0
"6291","D2","D50",0.125,0.00755433235506732,8,128,127,1,7,1
"6292","D20","D50",0,0.721704213787294,8,128,126,2,8,0
"6293","D21","D50",0,0.739976909027013,7,129,127,2,7,0
"6294","D22","D50",0,0.861819671758601,2,134,132,2,2,0
"6295","D23","D50",0,0.861819671758601,2,134,132,2,2,0
"6296","D24","D50",0.0384615384615385,0.263175050261802,26,110,109,1,25,1
"6297","D25","D50",0,0.804124066880639,4,132,130,2,4,0
"6298","D26","D50",0,0.861819671758601,2,134,132,2,2,0
"6299","D27","D50",0,0.780748527710185,5,131,129,2,5,0
"6300","D28","D50",0,0.759543172318368,6,130,128,2,6,0
"6301","D29","D50",0.0238095238095238,0.555495854264715,42,94,93,1,41,1
"6302","D3","D50",0,0.861819671758601,2,134,132,2,2,0
"6303","Lombalgia","D50",0,0.192198319028589,62,74,72,2,62,0
"6304","D31","D50",0.0588235294117647,0.106204613306305,17,119,118,1,16,1
"6305","D32","D50",0,0.383757260247278,37,99,97,2,37,0
"6306","D33","D50",0,0.657612161666932,12,124,122,2,12,0
"6307","D34","D50",0.666666666666667,2.39360797585802e-21,3,133,133,0,1,2
"6308","D35","D50",0,0.861819671758601,2,134,132,2,2,0
"6309","D36","D50",0,0.721704213787294,8,128,126,2,8,0
"6310","D37","D50",0,0.531393754170243,22,114,112,2,22,0
"6311","D38","D50",0,0.830565083280277,3,133,131,2,3,0
"6312","D39","D50",0,0.615926597177117,15,121,119,2,15,0
"6313","D4","D50",0,0.804124066880639,4,132,130,2,4,0
"6314","D40","D50",0,0.780748527710185,5,131,129,2,5,0
"6315","D41","D50",0,0.739976909027013,7,129,127,2,7,0
"6316","D42","D50",0,0.830565083280277,3,133,131,2,3,0
"6317","D43","D50",0.333333333333333,3.54931258649229e-06,3,133,132,1,2,1
"6318","D44","D50",0,0.374983020515037,38,98,96,2,38,0
"6319","D45","D50",0,0.657612161666932,12,124,122,2,12,0
"6320","D46","D50",0,0.374983020515037,38,98,96,2,38,0
"6321","D47","D50",0,0.657612161666932,12,124,122,2,12,0
"6322","D48","D50",0,0.488520668794022,26,110,108,2,26,0
"6323","D49","D50",0,0.643234299777126,13,123,121,2,13,0
"6324","D5","D50",0.333333333333333,3.54931258649229e-06,3,133,132,1,2,1
"6325","D50","D50",1,1.99530445797663e-31,2,134,134,0,0,2
"6326","D51","D50",0,0.902407153906854,1,135,133,2,1,0
"6327","D52","D50",0.5,9.25079971216983e-09,2,134,133,1,1,1
"6328","D53","D50",0.5,9.25079971216983e-09,2,134,133,1,1,1
"6329","D9","D50",0,0.902407153906854,1,135,133,2,1,0
"6330","RMDQ1_v1","D50",0,0.737884567605411,43,73,72,1,43,0
"6331","RMDQ2_v1","D50",0,0.704107252091958,47,69,68,1,47,0
"6332","RMDQ3_v1","D50",0,0.505785279295151,36,82,81,1,36,0
"6333","RMDQ4_v1","D50",0,0.593426957598424,26,92,91,1,26,0
"6334","RMDQ5_v1","D50",0,0.531483921254055,33,85,84,1,33,0
"6335","RMDQ6_v1","D50",0,0.566468281116867,29,89,88,1,29,0
"6336","RMDQ7_v1","D50",0,0.648368667298824,20,97,96,1,20,0
"6337","RMDQ8_v1","D50",0,0.850129340451501,4,113,112,1,4,0
"6338","RMDQ9_v1","D50",0,0.668479726871623,18,99,98,1,18,0
"6339","RMDQ10_v1","D50",0,0.628885363875848,22,95,94,1,22,0
"6340","RMDQ11_v1","D50",0,0.61934434211196,23,94,93,1,23,0
"6341","RMDQ12_v1","D50",0,0.628885363875848,22,95,94,1,22,0
"6342","RMDQ13_v1","D50",0,0.628885363875848,22,95,94,1,22,0
"6343","RMDQ14_v1","D50",0,0.600606776606717,25,92,91,1,25,0
"6344","RMDQ15_v1","D50",0,0.700139702762516,15,102,101,1,15,0
"6345","RMDQ16_v1","D50",0,0.658337884368623,19,98,97,1,19,0
"6346","RMDQ17_v1","D50",0,0.628885363875848,22,95,94,1,22,0
"6347","RMDQ18_v1","D50",0,0.648368667298824,20,97,96,1,20,0
"6348","RMDQ19_v1","D50",0,0.689357768311308,16,101,100,1,16,0
"6349","RMDQ20_v1","D50",0,0.638555915507599,21,96,95,1,21,0
"6350","RMDQ21_v1","D50",0,0.609921533119359,24,93,92,1,24,0
"6351","RMDQ22_v1","D50",0,0.648368667298824,20,97,96,1,20,0
"6352","RMDQ23_v1","D50",0,0.658337884368623,19,98,97,1,19,0
"6353","RMDQ24_v1","D50",0,0.658337884368623,19,98,97,1,19,0
"6354","DN4 - Queimação","D50",0.0188679245283019,0.884072353041481,53,65,64,1,52,1
"6355","DN4 - Sensação de frio dolorosa","D50",0.0416666666666667,0.293233262263206,24,94,93,1,23,1
"6356","DN4 - Choque elétrico","D50",0.0277777777777778,0.539771205928562,36,83,82,1,35,1
"6357","DN4 - Formigamento","D50",0.032258064516129,0.436422601135095,31,88,87,1,30,1
"6358","DN4 - Alfinetada e agulhada","D50",0.0277777777777778,0.539771205928562,36,83,82,1,35,1
"6359","DN4 - Adormecimento","D50",0.0303030303030303,0.483790516345729,33,85,84,1,32,1
"6360","DN4 - Coceira","D50",0,0.742421215085394,6,113,111,2,6,0
"6361","DH4 - Hipoestesia ao toque","D50",0.2,0.00113082615896294,5,114,113,1,4,1
"6362","DN4 - Hipoestesia a picada de agulha","D50",0.2,0.00113082615896294,5,114,113,1,4,1
"6363","DN4 - Escovação","D50",0.25,0.000223631269562627,4,115,114,1,3,1
"6364","Fuma","D51",0.0217391304347826,0.180118629660033,46,82,82,0,45,1
"6365","Cirurgia na coluna","D51",0.0181818181818182,0.282453923933158,55,63,63,0,54,1
"6366","Aposentado","D51",0.032258064516129,0.0700036270740707,31,101,101,0,30,1
"6367","Desempregado","D51",0.04,0.0396556286496397,25,105,105,0,24,1
"6368","Licenca_Medica","D51",0.0555555555555556,0.0115304277292318,18,114,114,0,17,1
"6369","Aposentado_Invalidez","D51",0,0.797943352456733,8,123,122,1,8,0
"6370","Analgésicos","D51",0.0113636363636364,0.487982136848066,88,42,42,0,87,1
"6371","OutraDoenca","D51",0,0.427412188827125,50,80,79,1,50,0
"6372","Dor nas costas","D51",0.010989010989011,0.522073609395411,91,37,37,0,90,1
"6373","Dor nas pernas","D51",0.0181818181818182,0.250685302469518,55,72,72,0,54,1
"6374","Retornar_trabalho","D51",0,0.651725008243142,20,99,98,1,20,0
"6375","Masc","D51",0.0113636363636364,0.458524130935477,88,48,48,0,87,1
"6376","Fem","D51",0,0.458524130935477,48,88,87,1,48,0
"6377","Casado/Amasiaado","D51",0,0.408198318237489,55,81,80,1,55,0
"6378","Solteiro","D51",0.0169491525423729,0.25153607167746,59,77,77,0,58,1
"6379","Separado_Divorciado","D51",0,0.815135138754741,7,129,128,1,7,0
"6380","X4","D51",0,0.880178390709511,3,133,132,1,3,0
"6381","X5","D51",0,0.902407153906854,2,134,133,1,2,0
"6382","X6","D51",0,0.777361156052393,10,126,125,1,10,0
"6383","Livrar_costas","D51",0.0116279069767442,0.685105670480977,86,14,14,0,85,1
"6384","Livrar_perna","D51",0,0.685105670480977,14,86,85,1,14,0
"6385","Livrar_perda_sens","D51",NA,NA,0,100,99,1,0,0
"6386","D1","D51",0,0.931160789923657,1,135,134,1,1,0
"6387","D15","D51",0.142857142857143,1.64201114746102e-05,7,129,129,0,6,1
"6388","D16","D51",0.05,0.0156394686045021,20,116,116,0,19,1
"6389","D17","D51",0,0.844540967905734,5,131,130,1,5,0
"6390","D18","D51",0,0.713993297445649,16,120,119,1,16,0
"6391","D19","D51",0,0.815135138754741,7,129,128,1,7,0
"6392","D2","D51",0.125,5.94993819266424e-05,8,128,128,0,7,1
"6393","D20","D51",0,0.801872700366009,8,128,127,1,8,0
"6394","D21","D51",0,0.815135138754741,7,129,128,1,7,0
"6395","D22","D51",0,0.902407153906854,2,134,133,1,2,0
"6396","D23","D51",0,0.902407153906854,2,134,133,1,2,0
"6397","D24","D51",0,0.625571266952418,26,110,109,1,26,0
"6398","D25","D51",0,0.861298710023066,4,132,131,1,4,0
"6399","D26","D51",0,0.902407153906854,2,134,133,1,2,0
"6400","D27","D51",0,0.844540967905734,5,131,130,1,5,0
"6401","D28","D51",0,0.829277200319907,6,130,129,1,6,0
"6402","D29","D51",0,0.502278826842558,42,94,93,1,42,0
"6403","D3","D51",0,0.902407153906854,2,134,133,1,2,0
"6404","Lombalgia","D51",0,0.358242727739549,62,74,73,1,62,0
"6405","D31","D51",0,0.704419244092944,17,119,118,1,17,0
"6406","D32","D51",0,0.539479231806348,37,99,98,1,37,0
"6407","D33","D51",0,0.75486151575449,12,124,123,1,12,0
"6408","D34","D51",0.333333333333333,2.34190534565149e-11,3,133,133,0,2,1
"6409","D35","D51",0.5,2.11083244888566e-16,2,134,134,0,1,1
"6410","D36","D51",0,0.801872700366009,8,128,127,1,8,0
"6411","D37","D51",0.0454545454545455,0.022325957274565,22,114,114,0,21,1
"6412","D38","D51",0,0.880178390709511,3,133,132,1,3,0
"6413","D39","D51",0,0.723795314149376,15,121,120,1,15,0
"6414","D4","D51",0.25,8.1271609988953e-09,4,132,132,0,3,1
"6415","D40","D51",0,0.844540967905734,5,131,130,1,5,0
"6416","D41","D51",0,0.815135138754741,7,129,128,1,7,0
"6417","D42","D51",0,0.880178390709511,3,133,132,1,3,0
"6418","D43","D51",0,0.880178390709511,3,133,132,1,3,0
"6419","D44","D51",0,0.531969817884708,38,98,97,1,38,0
"6420","D45","D51",0,0.75486151575449,12,124,123,1,12,0
"6421","D46","D51",0,0.531969817884708,38,98,97,1,38,0
"6422","D47","D51",0,0.75486151575449,12,124,123,1,12,0
"6423","D48","D51",0,0.625571266952418,26,110,109,1,26,0
"6424","D49","D51",0,0.744194764154502,13,123,122,1,13,0
"6425","D5","D51",0.333333333333333,2.34190534565149e-11,3,133,133,0,2,1
"6426","D50","D51",0,0.902407153906854,2,134,133,1,2,0
"6427","D51","D51",1,1.99530445797665e-31,1,135,135,0,0,1
"6428","D52","D51",0,0.902407153906854,2,134,133,1,2,0
"6429","D53","D51",0,0.902407153906854,2,134,133,1,2,0
"6430","D9","D51",1,1.99530445797665e-31,1,135,135,0,0,1
"6431","RMDQ1_v1","D51",0.0232558139534884,0.419839443150142,43,73,73,0,42,1
"6432","RMDQ2_v1","D51",0.0212765957446809,0.471846992882068,47,69,69,0,46,1
"6433","RMDQ3_v1","D51",0.0277777777777778,0.1296036170137,36,82,82,0,35,1
"6434","RMDQ4_v1","D51",0,0.593426957598424,26,92,91,1,26,0
"6435","RMDQ5_v1","D51",0.0303030303030303,0.107014020238433,33,85,85,0,32,1
"6436","RMDQ6_v1","D51",0.0344827586206897,0.0785236958912466,29,89,89,0,28,1
"6437","RMDQ7_v1","D51",0.05,0.0269843768229582,20,97,97,0,19,1
"6438","RMDQ8_v1","D51",0,0.850129340451501,4,113,112,1,4,0
"6439","RMDQ9_v1","D51",0.0555555555555556,0.0185080139064539,18,99,99,0,17,1
"6440","RMDQ10_v1","D51",0.0454545454545455,0.0368916317321308,22,95,95,0,21,1
"6441","RMDQ11_v1","D51",0.0434782608695652,0.0423242826421271,23,94,94,0,22,1
"6442","RMDQ12_v1","D51",0.0454545454545455,0.0368916317321308,22,95,95,0,21,1
"6443","RMDQ13_v1","D51",0.0454545454545455,0.0368916317321308,22,95,95,0,21,1
"6444","RMDQ14_v1","D51",0.04,0.0540315515408075,25,92,92,0,24,1
"6445","RMDQ15_v1","D51",0.0666666666666667,0.00882146183803565,15,102,102,0,14,1
"6446","RMDQ16_v1","D51",0.0526315789473684,0.0225562523721356,19,98,98,0,18,1
"6447","RMDQ17_v1","D51",0.0454545454545455,0.0368916317321308,22,95,95,0,21,1
"6448","RMDQ18_v1","D51",0.05,0.0269843768229582,20,97,97,0,19,1
"6449","RMDQ19_v1","D51",0.0625,0.0116267347685025,16,101,101,0,15,1
"6450","RMDQ20_v1","D51",0.0476190476190476,0.0317705146451596,21,96,96,0,20,1
"6451","RMDQ21_v1","D51",0.0416666666666667,0.0480451702617448,24,93,93,0,23,1
"6452","RMDQ22_v1","D51",0.05,0.0269843768229582,20,97,97,0,19,1
"6453","RMDQ23_v1","D51",0.0526315789473684,0.0225562523721356,19,98,98,0,18,1
"6454","RMDQ24_v1","D51",0.0526315789473684,0.0225562523721356,19,98,98,0,18,1
"6455","DN4 - Queimação","D51",0.0188679245283019,0.266069863620088,53,65,65,0,52,1
"6456","DN4 - Sensação de frio dolorosa","D51",0,0.611841971208142,24,94,93,1,24,0
"6457","DN4 - Choque elétrico","D51",0.0277777777777778,0.127302516839353,36,83,83,0,35,1
"6458","DN4 - Formigamento","D51",0.032258064516129,0.0906514651303281,31,88,88,0,30,1
"6459","DN4 - Alfinetada e agulhada","D51",0.0277777777777778,0.127302516839353,36,83,83,0,35,1
"6460","DN4 - Adormecimento","D51",0.0303030303030303,0.107014020238433,33,85,85,0,32,1
"6461","DN4 - Coceira","D51",0.166666666666667,1.31203161243512e-05,6,113,113,0,5,1
"6462","DH4 - Hipoestesia ao toque","D51",0.2,1.6257371427835e-06,5,114,114,0,4,1
"6463","DN4 - Hipoestesia a picada de agulha","D51",0.2,1.6257371427835e-06,5,114,114,0,4,1
"6464","DN4 - Escovação","D51",0.25,7.26161658379463e-08,4,115,115,0,3,1
"6465","Fuma","D52",0.0217391304347826,0.676126454476383,46,82,81,1,45,1
"6466","Cirurgia na coluna","D52",0.0181818181818182,0.922786031527084,55,63,62,1,54,1
"6467","Aposentado","D52",0,0.429821621542201,31,101,99,2,31,0
"6468","Desempregado","D52",0,0.486782231372189,25,105,103,2,25,0
"6469","Licenca_Medica","D52",0,0.571218616780325,18,114,112,2,18,0
"6470","Aposentado_Invalidez","D52",0,0.71626653488051,8,123,121,2,8,0
"6471","Analgésicos","D52",0.0113636363636364,0.589754290789669,88,42,41,1,87,1
"6472","OutraDoenca","D52",0,0.259854635493349,50,80,78,2,50,0
"6473","Dor nas costas","D52",0.010989010989011,0.507170788539898,91,37,36,1,90,1
"6474","Dor nas pernas","D52",0,0.212807680324934,55,72,70,2,55,0
"6475","Retornar_trabalho","D52",0,0.52148919720768,20,99,97,2,20,0
"6476","Masc","D52",0.0113636363636364,0.661074727453963,88,48,47,1,87,1
"6477","Fem","D52",0.0208333333333333,0.661074727453963,48,88,87,1,47,1
"6478","Casado/Amasiaado","D52",0.0181818181818182,0.781401816104309,55,81,80,1,54,1
"6479","Solteiro","D52",0.0169491525423729,0.849120602315612,59,77,76,1,58,1
"6480","Separado_Divorciado","D52",0,0.739976909027013,7,129,127,2,7,0
"6481","X4","D52",0,0.830565083280277,3,133,131,2,3,0
"6482","X5","D52",0,0.861819671758601,2,134,132,2,2,0
"6483","X6","D52",0,0.688146459888278,10,126,124,2,10,0
"6484","Livrar_costas","D52",0.0116279069767442,0.685105670480977,86,14,14,0,85,1
"6485","Livrar_perna","D52",0,0.685105670480977,14,86,85,1,14,0
"6486","Livrar_perda_sens","D52",NA,NA,0,100,99,1,0,0
"6487","D1","D52",0,0.902407153906854,1,135,133,2,1,0
"6488","D15","D52",0,0.739976909027013,7,129,127,2,7,0
"6489","D16","D52",0,0.554127697484356,20,116,114,2,20,0
"6490","D17","D52",0,0.780748527710185,5,131,129,2,5,0
"6491","D18","D52",0,0.602898245770971,16,120,118,2,16,0
"6492","D19","D52",0,0.739976909027013,7,129,127,2,7,0
"6493","D2","D52",0,0.721704213787294,8,128,126,2,8,0
"6494","D20","D52",0,0.721704213787294,8,128,126,2,8,0
"6495","D21","D52",0,0.739976909027013,7,129,127,2,7,0
"6496","D22","D52",0,0.861819671758601,2,134,132,2,2,0
"6497","D23","D52",0,0.861819671758601,2,134,132,2,2,0
"6498","D24","D52",0,0.488520668794022,26,110,108,2,26,0
"6499","D25","D52",0,0.804124066880639,4,132,130,2,4,0
"6500","D26","D52",0,0.861819671758601,2,134,132,2,2,0
"6501","D27","D52",0,0.780748527710185,5,131,129,2,5,0
"6502","D28","D52",0,0.759543172318368,6,130,128,2,6,0
"6503","D29","D52",0,0.340923749246409,42,94,92,2,42,0
"6504","D3","D52",0,0.861819671758601,2,134,132,2,2,0
"6505","Lombalgia","D52",0,0.192198319028589,62,74,72,2,62,0
"6506","D31","D52",0,0.590234194210651,17,119,117,2,17,0
"6507","D32","D52",0.027027027027027,0.465541796275196,37,99,98,1,36,1
"6508","D33","D52",0,0.657612161666932,12,124,122,2,12,0
"6509","D34","D52",0.333333333333333,3.54931258649229e-06,3,133,132,1,2,1
"6510","D35","D52",0,0.861819671758601,2,134,132,2,2,0
"6511","D36","D52",0,0.721704213787294,8,128,126,2,8,0
"6512","D37","D52",0,0.531393754170243,22,114,112,2,22,0
"6513","D38","D52",0,0.830565083280277,3,133,131,2,3,0
"6514","D39","D52",0,0.615926597177117,15,121,119,2,15,0
"6515","D4","D52",0,0.804124066880639,4,132,130,2,4,0
"6516","D40","D52",0,0.780748527710185,5,131,129,2,5,0
"6517","D41","D52",0,0.739976909027013,7,129,127,2,7,0
"6518","D42","D52",0.333333333333333,3.54931258649229e-06,3,133,132,1,2,1
"6519","D43","D52",0.333333333333333,3.54931258649229e-06,3,133,132,1,2,1
"6520","D44","D52",0.0263157894736842,0.483675186223837,38,98,97,1,37,1
"6521","D45","D52",0,0.657612161666932,12,124,122,2,12,0
"6522","D46","D52",0,0.374983020515037,38,98,96,2,38,0
"6523","D47","D52",0,0.657612161666932,12,124,122,2,12,0
"6524","D48","D52",0,0.488520668794022,26,110,108,2,26,0
"6525","D49","D52",0,0.643234299777126,13,123,121,2,13,0
"6526","D5","D52",0,0.830565083280277,3,133,131,2,3,0
"6527","D50","D52",0.5,9.25079971216983e-09,2,134,133,1,1,1
"6528","D51","D52",0,0.902407153906854,1,135,133,2,1,0
"6529","D52","D52",1,1.99530445797663e-31,2,134,134,0,0,2
"6530","D53","D52",0.5,9.25079971216983e-09,2,134,133,1,1,1
"6531","D9","D52",0,0.902407153906854,1,135,133,2,1,0
"6532","RMDQ1_v1","D52",0.0232558139534884,0.419839443150142,43,73,73,0,42,1
"6533","RMDQ2_v1","D52",0.0212765957446809,0.471846992882068,47,69,69,0,46,1
"6534","RMDQ3_v1","D52",0,0.505785279295151,36,82,81,1,36,0
"6535","RMDQ4_v1","D52",0,0.593426957598424,26,92,91,1,26,0
"6536","RMDQ5_v1","D52",0,0.531483921254055,33,85,84,1,33,0
"6537","RMDQ6_v1","D52",0,0.566468281116867,29,89,88,1,29,0
"6538","RMDQ7_v1","D52",0.05,0.0269843768229582,20,97,97,0,19,1
"6539","RMDQ8_v1","D52",0,0.850129340451501,4,113,112,1,4,0
"6540","RMDQ9_v1","D52",0,0.668479726871623,18,99,98,1,18,0
"6541","RMDQ10_v1","D52",0,0.628885363875848,22,95,94,1,22,0
"6542","RMDQ11_v1","D52",0,0.61934434211196,23,94,93,1,23,0
"6543","RMDQ12_v1","D52",0.0454545454545455,0.0368916317321308,22,95,95,0,21,1
"6544","RMDQ13_v1","D52",0,0.628885363875848,22,95,94,1,22,0
"6545","RMDQ14_v1","D52",0.04,0.0540315515408075,25,92,92,0,24,1
"6546","RMDQ15_v1","D52",0,0.700139702762516,15,102,101,1,15,0
"6547","RMDQ16_v1","D52",0,0.658337884368623,19,98,97,1,19,0
"6548","RMDQ17_v1","D52",0,0.628885363875848,22,95,94,1,22,0
"6549","RMDQ18_v1","D52",0,0.648368667298824,20,97,96,1,20,0
"6550","RMDQ19_v1","D52",0,0.689357768311308,16,101,100,1,16,0
"6551","RMDQ20_v1","D52",0,0.638555915507599,21,96,95,1,21,0
"6552","RMDQ21_v1","D52",0,0.609921533119359,24,93,92,1,24,0
"6553","RMDQ22_v1","D52",0,0.648368667298824,20,97,96,1,20,0
"6554","RMDQ23_v1","D52",0,0.658337884368623,19,98,97,1,19,0
"6555","RMDQ24_v1","D52",0,0.658337884368623,19,98,97,1,19,0
"6556","DN4 - Queimação","D52",0.0188679245283019,0.884072353041481,53,65,64,1,52,1
"6557","DN4 - Sensação de frio dolorosa","D52",0.0416666666666667,0.293233262263206,24,94,93,1,23,1
"6558","DN4 - Choque elétrico","D52",0.0277777777777778,0.539771205928562,36,83,82,1,35,1
"6559","DN4 - Formigamento","D52",0.032258064516129,0.436422601135095,31,88,87,1,30,1
"6560","DN4 - Alfinetada e agulhada","D52",0.0277777777777778,0.539771205928562,36,83,82,1,35,1
"6561","DN4 - Adormecimento","D52",0.0303030303030303,0.483790516345729,33,85,84,1,32,1
"6562","DN4 - Coceira","D52",0,0.742421215085394,6,113,111,2,6,0
"6563","DH4 - Hipoestesia ao toque","D52",0.2,0.00113082615896294,5,114,113,1,4,1
"6564","DN4 - Hipoestesia a picada de agulha","D52",0.2,0.00113082615896294,5,114,113,1,4,1
"6565","DN4 - Escovação","D52",0.25,0.000223631269562627,4,115,114,1,3,1
"6566","Fuma","D53",0.0434782608695652,0.0570268627122226,46,82,82,0,44,2
"6567","Cirurgia na coluna","D53",0.0181818181818182,0.922786031527084,55,63,62,1,54,1
"6568","Aposentado","D53",0,0.429821621542201,31,101,99,2,31,0
"6569","Desempregado","D53",0,0.486782231372189,25,105,103,2,25,0
"6570","Licenca_Medica","D53",0,0.571218616780325,18,114,112,2,18,0
"6571","Aposentado_Invalidez","D53",0,0.71626653488051,8,123,121,2,8,0
"6572","Analgésicos","D53",0.0227272727272727,0.324814833547299,88,42,42,0,86,2
"6573","OutraDoenca","D53",0,0.259854635493349,50,80,78,2,50,0
"6574","Dor nas costas","D53",0.010989010989011,0.507170788539898,91,37,36,1,90,1
"6575","Dor nas pernas","D53",0,0.212807680324934,55,72,70,2,55,0
"6576","Retornar_trabalho","D53",0,0.52148919720768,20,99,97,2,20,0
"6577","Masc","D53",0,0.0537195355854463,88,48,46,2,88,0
"6578","Fem","D53",0.0416666666666667,0.0537195355854463,48,88,88,0,46,2
"6579","Casado/Amasiaado","D53",0.0363636363636364,0.0838103603534032,55,81,81,0,53,2
"6580","Solteiro","D53",0,0.212348813642373,59,77,75,2,59,0
"6581","Separado_Divorciado","D53",0,0.739976909027013,7,129,127,2,7,0
"6582","X4","D53",0,0.830565083280277,3,133,131,2,3,0
"6583","X5","D53",0,0.861819671758601,2,134,132,2,2,0
"6584","X6","D53",0,0.688146459888278,10,126,124,2,10,0
"6585","Livrar_costas","D53",0.0116279069767442,0.685105670480977,86,14,14,0,85,1
"6586","Livrar_perna","D53",0,0.685105670480977,14,86,85,1,14,0
"6587","Livrar_perda_sens","D53",NA,NA,0,100,99,1,0,0
"6588","D1","D53",0,0.902407153906854,1,135,133,2,1,0
"6589","D15","D53",0,0.739976909027013,7,129,127,2,7,0
"6590","D16","D53",0,0.554127697484356,20,116,114,2,20,0
"6591","D17","D53",0,0.780748527710185,5,131,129,2,5,0
"6592","D18","D53",0.0625,0.0908805539668756,16,120,119,1,15,1
"6593","D19","D53",0,0.739976909027013,7,129,127,2,7,0
"6594","D2","D53",0.125,0.00755433235506732,8,128,127,1,7,1
"6595","D20","D53",0.125,0.00755433235506732,8,128,127,1,7,1
"6596","D21","D53",0.142857142857143,0.00382637942754141,7,129,128,1,6,1
"6597","D22","D53",0,0.861819671758601,2,134,132,2,2,0
"6598","D23","D53",0,0.861819671758601,2,134,132,2,2,0
"6599","D24","D53",0,0.488520668794022,26,110,108,2,26,0
"6600","D25","D53",0,0.804124066880639,4,132,130,2,4,0
"6601","D26","D53",0,0.861819671758601,2,134,132,2,2,0
"6602","D27","D53",0,0.780748527710185,5,131,129,2,5,0
"6603","D28","D53",0.166666666666667,0.00156241229615405,6,130,129,1,5,1
"6604","D29","D53",0,0.340923749246409,42,94,92,2,42,0
"6605","D3","D53",0,0.861819671758601,2,134,132,2,2,0
"6606","Lombalgia","D53",0,0.192198319028589,62,74,72,2,62,0
"6607","D31","D53",0,0.590234194210651,17,119,117,2,17,0
"6608","D32","D53",0,0.383757260247278,37,99,97,2,37,0
"6609","D33","D53",0,0.657612161666932,12,124,122,2,12,0
"6610","D34","D53",0.333333333333333,3.54931258649229e-06,3,133,132,1,2,1
"6611","D35","D53",0,0.861819671758601,2,134,132,2,2,0
"6612","D36","D53",0,0.721704213787294,8,128,126,2,8,0
"6613","D37","D53",0,0.531393754170243,22,114,112,2,22,0
"6614","D38","D53",0,0.830565083280277,3,133,131,2,3,0
"6615","D39","D53",0,0.615926597177117,15,121,119,2,15,0
"6616","D4","D53",0,0.804124066880639,4,132,130,2,4,0
"6617","D40","D53",0,0.780748527710185,5,131,129,2,5,0
"6618","D41","D53",0,0.739976909027013,7,129,127,2,7,0
"6619","D42","D53",0,0.830565083280277,3,133,131,2,3,0
"6620","D43","D53",0.666666666666667,2.39360797585802e-21,3,133,133,0,1,2
"6621","D44","D53",0,0.374983020515037,38,98,96,2,38,0
"6622","D45","D53",0,0.657612161666932,12,124,122,2,12,0
"6623","D46","D53",0,0.374983020515037,38,98,96,2,38,0
"6624","D47","D53",0,0.657612161666932,12,124,122,2,12,0
"6625","D48","D53",0,0.488520668794022,26,110,108,2,26,0
"6626","D49","D53",0,0.643234299777126,13,123,121,2,13,0
"6627","D5","D53",0,0.830565083280277,3,133,131,2,3,0
"6628","D50","D53",0.5,9.25079971216983e-09,2,134,133,1,1,1
"6629","D51","D53",0,0.902407153906854,1,135,133,2,1,0
"6630","D52","D53",0.5,9.25079971216983e-09,2,134,133,1,1,1
"6631","D53","D53",1,1.99530445797663e-31,2,134,134,0,0,2
"6632","D9","D53",0,0.902407153906854,1,135,133,2,1,0
"6633","RMDQ1_v1","D53",0.0232558139534884,0.419839443150142,43,73,73,0,42,1
"6634","RMDQ2_v1","D53",0.0212765957446809,0.471846992882068,47,69,69,0,46,1
"6635","RMDQ3_v1","D53",0,0.505785279295151,36,82,81,1,36,0
"6636","RMDQ4_v1","D53",0.0384615384615385,0.0588782180805536,26,92,92,0,25,1
"6637","RMDQ5_v1","D53",0,0.531483921254055,33,85,84,1,33,0
"6638","RMDQ6_v1","D53",0.0344827586206897,0.0785236958912466,29,89,89,0,28,1
"6639","RMDQ7_v1","D53",0.05,0.0269843768229582,20,97,97,0,19,1
"6640","RMDQ8_v1","D53",0,0.850129340451501,4,113,112,1,4,0
"6641","RMDQ9_v1","D53",0.0555555555555556,0.0185080139064539,18,99,99,0,17,1
"6642","RMDQ10_v1","D53",0.0454545454545455,0.0368916317321308,22,95,95,0,21,1
"6643","RMDQ11_v1","D53",0.0434782608695652,0.0423242826421271,23,94,94,0,22,1
"6644","RMDQ12_v1","D53",0.0454545454545455,0.0368916317321308,22,95,95,0,21,1
"6645","RMDQ13_v1","D53",0.0454545454545455,0.0368916317321308,22,95,95,0,21,1
"6646","RMDQ14_v1","D53",0.04,0.0540315515408075,25,92,92,0,24,1
"6647","RMDQ15_v1","D53",0,0.700139702762516,15,102,101,1,15,0
"6648","RMDQ16_v1","D53",0.0526315789473684,0.0225562523721356,19,98,98,0,18,1
"6649","RMDQ17_v1","D53",0,0.628885363875848,22,95,94,1,22,0
"6650","RMDQ18_v1","D53",0,0.648368667298824,20,97,96,1,20,0
"6651","RMDQ19_v1","D53",0,0.689357768311308,16,101,100,1,16,0
"6652","RMDQ20_v1","D53",0.0476190476190476,0.0317705146451596,21,96,96,0,20,1
"6653","RMDQ21_v1","D53",0.0416666666666667,0.0480451702617448,24,93,93,0,23,1
"6654","RMDQ22_v1","D53",0,0.648368667298824,20,97,96,1,20,0
"6655","RMDQ23_v1","D53",0,0.658337884368623,19,98,97,1,19,0
"6656","RMDQ24_v1","D53",0.0526315789473684,0.0225562523721356,19,98,98,0,18,1
"6657","DN4 - Queimação","D53",0.0188679245283019,0.266069863620088,53,65,65,0,52,1
"6658","DN4 - Sensação de frio dolorosa","D53",0.0416666666666667,0.0468674002441255,24,94,94,0,23,1
"6659","DN4 - Choque elétrico","D53",0.0277777777777778,0.127302516839353,36,83,83,0,35,1
"6660","DN4 - Formigamento","D53",0.032258064516129,0.0906514651303281,31,88,88,0,30,1
"6661","DN4 - Alfinetada e agulhada","D53",0.0277777777777778,0.127302516839353,36,83,83,0,35,1
"6662","DN4 - Adormecimento","D53",0.0303030303030303,0.107014020238433,33,85,85,0,32,1
"6663","DN4 - Coceira","D53",0,0.817001778007153,6,113,112,1,6,0
"6664","DH4 - Hipoestesia ao toque","D53",0.2,1.6257371427835e-06,5,114,114,0,4,1
"6665","DN4 - Hipoestesia a picada de agulha","D53",0.2,1.6257371427835e-06,5,114,114,0,4,1
"6666","DN4 - Escovação","D53",0.25,7.26161658379463e-08,4,115,115,0,3,1
"6667","Fuma","D9",0.0217391304347826,0.180118629660033,46,82,82,0,45,1
"6668","Cirurgia na coluna","D9",0.0181818181818182,0.282453923933158,55,63,63,0,54,1
"6669","Aposentado","D9",0.032258064516129,0.0700036270740707,31,101,101,0,30,1
"6670","Desempregado","D9",0.04,0.0396556286496397,25,105,105,0,24,1
"6671","Licenca_Medica","D9",0.0555555555555556,0.0115304277292318,18,114,114,0,17,1
"6672","Aposentado_Invalidez","D9",0,0.797943352456733,8,123,122,1,8,0
"6673","Analgésicos","D9",0.0113636363636364,0.487982136848066,88,42,42,0,87,1
"6674","OutraDoenca","D9",0,0.427412188827125,50,80,79,1,50,0
"6675","Dor nas costas","D9",0.010989010989011,0.522073609395411,91,37,37,0,90,1
"6676","Dor nas pernas","D9",0.0181818181818182,0.250685302469518,55,72,72,0,54,1
"6677","Retornar_trabalho","D9",0,0.651725008243142,20,99,98,1,20,0
"6678","Masc","D9",0.0113636363636364,0.458524130935477,88,48,48,0,87,1
"6679","Fem","D9",0,0.458524130935477,48,88,87,1,48,0
"6680","Casado/Amasiaado","D9",0,0.408198318237489,55,81,80,1,55,0
"6681","Solteiro","D9",0.0169491525423729,0.25153607167746,59,77,77,0,58,1
"6682","Separado_Divorciado","D9",0,0.815135138754741,7,129,128,1,7,0
"6683","X4","D9",0,0.880178390709511,3,133,132,1,3,0
"6684","X5","D9",0,0.902407153906854,2,134,133,1,2,0
"6685","X6","D9",0,0.777361156052393,10,126,125,1,10,0
"6686","Livrar_costas","D9",0.0116279069767442,0.685105670480977,86,14,14,0,85,1
"6687","Livrar_perna","D9",0,0.685105670480977,14,86,85,1,14,0
"6688","Livrar_perda_sens","D9",NA,NA,0,100,99,1,0,0
"6689","D1","D9",0,0.931160789923657,1,135,134,1,1,0
"6690","D15","D9",0.142857142857143,1.64201114746102e-05,7,129,129,0,6,1
"6691","D16","D9",0.05,0.0156394686045021,20,116,116,0,19,1
"6692","D17","D9",0,0.844540967905734,5,131,130,1,5,0
"6693","D18","D9",0,0.713993297445649,16,120,119,1,16,0
"6694","D19","D9",0,0.815135138754741,7,129,128,1,7,0
"6695","D2","D9",0.125,5.94993819266424e-05,8,128,128,0,7,1
"6696","D20","D9",0,0.801872700366009,8,128,127,1,8,0
"6697","D21","D9",0,0.815135138754741,7,129,128,1,7,0
"6698","D22","D9",0,0.902407153906854,2,134,133,1,2,0
"6699","D23","D9",0,0.902407153906854,2,134,133,1,2,0
"6700","D24","D9",0,0.625571266952418,26,110,109,1,26,0
"6701","D25","D9",0,0.861298710023066,4,132,131,1,4,0
"6702","D26","D9",0,0.902407153906854,2,134,133,1,2,0
"6703","D27","D9",0,0.844540967905734,5,131,130,1,5,0
"6704","D28","D9",0,0.829277200319907,6,130,129,1,6,0
"6705","D29","D9",0,0.502278826842558,42,94,93,1,42,0
"6706","D3","D9",0,0.902407153906854,2,134,133,1,2,0
"6707","Lombalgia","D9",0,0.358242727739549,62,74,73,1,62,0
"6708","D31","D9",0,0.704419244092944,17,119,118,1,17,0
"6709","D32","D9",0,0.539479231806348,37,99,98,1,37,0
"6710","D33","D9",0,0.75486151575449,12,124,123,1,12,0
"6711","D34","D9",0.333333333333333,2.34190534565149e-11,3,133,133,0,2,1
"6712","D35","D9",0.5,2.11083244888566e-16,2,134,134,0,1,1
"6713","D36","D9",0,0.801872700366009,8,128,127,1,8,0
"6714","D37","D9",0.0454545454545455,0.022325957274565,22,114,114,0,21,1
"6715","D38","D9",0,0.880178390709511,3,133,132,1,3,0
"6716","D39","D9",0,0.723795314149376,15,121,120,1,15,0
"6717","D4","D9",0.25,8.1271609988953e-09,4,132,132,0,3,1
"6718","D40","D9",0,0.844540967905734,5,131,130,1,5,0
"6719","D41","D9",0,0.815135138754741,7,129,128,1,7,0
"6720","D42","D9",0,0.880178390709511,3,133,132,1,3,0
"6721","D43","D9",0,0.880178390709511,3,133,132,1,3,0
"6722","D44","D9",0,0.531969817884708,38,98,97,1,38,0
"6723","D45","D9",0,0.75486151575449,12,124,123,1,12,0
"6724","D46","D9",0,0.531969817884708,38,98,97,1,38,0
"6725","D47","D9",0,0.75486151575449,12,124,123,1,12,0
"6726","D48","D9",0,0.625571266952418,26,110,109,1,26,0
"6727","D49","D9",0,0.744194764154502,13,123,122,1,13,0
"6728","D5","D9",0.333333333333333,2.34190534565149e-11,3,133,133,0,2,1
"6729","D50","D9",0,0.902407153906854,2,134,133,1,2,0
"6730","D51","D9",1,1.99530445797665e-31,1,135,135,0,0,1
"6731","D52","D9",0,0.902407153906854,2,134,133,1,2,0
"6732","D53","D9",0,0.902407153906854,2,134,133,1,2,0
"6733","D9","D9",1,1.99530445797665e-31,1,135,135,0,0,1
"6734","RMDQ1_v1","D9",0.0232558139534884,0.419839443150142,43,73,73,0,42,1
"6735","RMDQ2_v1","D9",0.0212765957446809,0.471846992882068,47,69,69,0,46,1
"6736","RMDQ3_v1","D9",0.0277777777777778,0.1296036170137,36,82,82,0,35,1
"6737","RMDQ4_v1","D9",0,0.593426957598424,26,92,91,1,26,0
"6738","RMDQ5_v1","D9",0.0303030303030303,0.107014020238433,33,85,85,0,32,1
"6739","RMDQ6_v1","D9",0.0344827586206897,0.0785236958912466,29,89,89,0,28,1
"6740","RMDQ7_v1","D9",0.05,0.0269843768229582,20,97,97,0,19,1
"6741","RMDQ8_v1","D9",0,0.850129340451501,4,113,112,1,4,0
"6742","RMDQ9_v1","D9",0.0555555555555556,0.0185080139064539,18,99,99,0,17,1
"6743","RMDQ10_v1","D9",0.0454545454545455,0.0368916317321308,22,95,95,0,21,1
"6744","RMDQ11_v1","D9",0.0434782608695652,0.0423242826421271,23,94,94,0,22,1
"6745","RMDQ12_v1","D9",0.0454545454545455,0.0368916317321308,22,95,95,0,21,1
"6746","RMDQ13_v1","D9",0.0454545454545455,0.0368916317321308,22,95,95,0,21,1
"6747","RMDQ14_v1","D9",0.04,0.0540315515408075,25,92,92,0,24,1
"6748","RMDQ15_v1","D9",0.0666666666666667,0.00882146183803565,15,102,102,0,14,1
"6749","RMDQ16_v1","D9",0.0526315789473684,0.0225562523721356,19,98,98,0,18,1
"6750","RMDQ17_v1","D9",0.0454545454545455,0.0368916317321308,22,95,95,0,21,1
"6751","RMDQ18_v1","D9",0.05,0.0269843768229582,20,97,97,0,19,1
"6752","RMDQ19_v1","D9",0.0625,0.0116267347685025,16,101,101,0,15,1
"6753","RMDQ20_v1","D9",0.0476190476190476,0.0317705146451596,21,96,96,0,20,1
"6754","RMDQ21_v1","D9",0.0416666666666667,0.0480451702617448,24,93,93,0,23,1
"6755","RMDQ22_v1","D9",0.05,0.0269843768229582,20,97,97,0,19,1
"6756","RMDQ23_v1","D9",0.0526315789473684,0.0225562523721356,19,98,98,0,18,1
"6757","RMDQ24_v1","D9",0.0526315789473684,0.0225562523721356,19,98,98,0,18,1
"6758","DN4 - Queimação","D9",0.0188679245283019,0.266069863620088,53,65,65,0,52,1
"6759","DN4 - Sensação de frio dolorosa","D9",0,0.611841971208142,24,94,93,1,24,0
"6760","DN4 - Choque elétrico","D9",0.0277777777777778,0.127302516839353,36,83,83,0,35,1
"6761","DN4 - Formigamento","D9",0.032258064516129,0.0906514651303281,31,88,88,0,30,1
"6762","DN4 - Alfinetada e agulhada","D9",0.0277777777777778,0.127302516839353,36,83,83,0,35,1
"6763","DN4 - Adormecimento","D9",0.0303030303030303,0.107014020238433,33,85,85,0,32,1
"6764","DN4 - Coceira","D9",0.166666666666667,1.31203161243512e-05,6,113,113,0,5,1
"6765","DH4 - Hipoestesia ao toque","D9",0.2,1.6257371427835e-06,5,114,114,0,4,1
"6766","DN4 - Hipoestesia a picada de agulha","D9",0.2,1.6257371427835e-06,5,114,114,0,4,1
"6767","DN4 - Escovação","D9",0.25,7.26161658379463e-08,4,115,115,0,3,1
"6768","Fuma","RMDQ1_v1",0.333333333333333,0.535626496475847,36,146,84,62,24,12
"6769","Cirurgia na coluna","RMDQ1_v1",0.397058823529412,0.745790179650833,68,126,78,48,41,27
"6770","Aposentado","RMDQ1_v1",0.424242424242424,0.751508811349967,33,149,94,55,19,14
"6771","Desempregado","RMDQ1_v1",0.5,0.339318193116568,26,152,98,54,13,13
"6772","Licenca_Medica","RMDQ1_v1",0.263157894736842,0.491131753247267,19,161,97,64,14,5
"6773","Aposentado_Invalidez","RMDQ1_v1",0.75,0.0798744623061704,8,170,109,61,2,6
"6774","Analgésicos","RMDQ1_v1",0.411347517730496,0.173977862534876,140,57,41,16,82,58
"6775","OutraDoenca","RMDQ1_v1",0.44,0.408991699503199,75,113,72,41,42,33
"6776","Dor nas costas","RMDQ1_v1",0.414634146341463,0.45740839548198,122,67,44,23,71,51
"6777","Dor nas pernas","RMDQ1_v1",0.415384615384615,0.707240280554545,65,122,75,47,38,27
"6778","Retornar_trabalho","RMDQ1_v1",0.473684210526316,0.615063094370002,19,167,106,61,10,9
"6779","Masc","RMDQ1_v1",0.402684563758389,0.590410991765288,148,71,46,25,88,60
"6780","Fem","RMDQ1_v1",0.352112676056338,0.590410991765288,71,148,88,60,46,25
"6781","Casado/Amasiaado","RMDQ1_v1",0.469135802469136,0.0817742839999999,81,100,68,32,43,38
"6782","Solteiro","RMDQ1_v1",0.32,0.175015497837418,74,107,61,46,50,24
"6783","Separado_Divorciado","RMDQ1_v1",0.285714285714286,0.83726347455151,7,174,106,68,5,2
"6784","X4","RMDQ1_v1",0,0.376988805505011,3,178,108,70,3,0
"6785","X5","RMDQ1_v1",0.75,0.314948167557093,4,177,110,67,1,3
"6786","X6","RMDQ1_v1",0.25,0.580016960732293,12,169,102,67,9,3
"6787","Livrar_costas","RMDQ1_v1",0.420560747663551,0.864197877893339,106,16,10,6,61,45
"6788","Livrar_perna","RMDQ1_v1",0.357142857142857,0.830178510429733,14,108,62,46,9,5
"6789","Livrar_perda_sens","RMDQ1_v1",0.5,0.964027491461303,2,120,70,50,1,1
"6790","D1","RMDQ1_v1",1,0.419839443150142,1,115,73,42,0,1
"6791","D15","RMDQ1_v1",0.428571428571429,0.917577367895651,7,109,69,40,4,3
"6792","D16","RMDQ1_v1",0.5,0.376809666919781,20,96,63,33,10,10
"6793","D17","RMDQ1_v1",0.2,0.703633355024225,5,111,69,42,4,1
"6794","D18","RMDQ1_v1",0.384615384615385,0.016715307011663,12,104,66,38,7,5
"6795","D19","RMDQ1_v1",0.333333333333333,0.954717850747826,6,110,69,41,4,2
"6796","D2","RMDQ1_v1",0.375,0.963330714118888,8,108,68,40,5,3
"6797","D20","RMDQ1_v1",0.428571428571429,0.000296752146878429,6,110,70,40,3,3
"6798","D21","RMDQ1_v1",0.428571428571429,0.917577367895651,7,109,69,40,4,3
"6799","D22","RMDQ1_v1",0,0.737884567605411,1,115,72,43,1,0
"6800","D23","RMDQ1_v1",0.5,0.920972823893012,2,114,72,42,1,1
"6801","D24","RMDQ1_v1",0.333333333333333,0.801529589035238,24,92,57,35,16,8
"6802","D25","RMDQ1_v1",0.333333333333333,0.977692589616264,3,113,71,42,2,1
"6803","D26","RMDQ1_v1",0.5,0.920972823893012,2,114,72,42,1,1
"6804","D27","RMDQ1_v1",0.25,0.86220049438478,4,112,70,42,3,1
"6805","D28","RMDQ1_v1",0.6,0.539955041804364,5,111,71,40,2,3
"6806","D29","RMDQ1_v1",0.380952380952381,0.74279722869292,42,74,47,27,26,16
"6807","D3","RMDQ1_v1",0.5,0.920972823893012,2,114,72,42,1,1
"6808","Lombalgia","RMDQ1_v1",0.442622950819672,0.138764242058155,61,55,39,16,34,27
"6809","D31","RMDQ1_v1",0.470588235294118,0.597590232588871,17,99,64,35,9,8
"6810","D32","RMDQ1_v1",0.405405405405405,0.687819627425963,37,79,51,28,22,15
"6811","D33","RMDQ1_v1",0.5,0.582170908878456,12,104,67,37,6,6
"6812","D34","RMDQ1_v1",0.5,0.920972823893012,2,114,72,42,1,1
"6813","D35","RMDQ1_v1",1,0.419839443150142,1,115,73,42,0,1
"6814","D36","RMDQ1_v1",0.285714285714286,0.86215728196132,7,109,68,41,5,2
"6815","D37","RMDQ1_v1",0.380952380952381,0.890345772774969,21,95,60,35,13,8
"6816","D38","RMDQ1_v1",0.333333333333333,0.977692589616264,3,113,71,42,2,1
"6817","D39","RMDQ1_v1",0.428571428571429,0.832161643305553,14,102,65,37,8,6
"6818","D4","RMDQ1_v1",0.666666666666667,0.550808395345412,3,113,72,41,1,2
"6819","D40","RMDQ1_v1",0.2,0.703633355024225,5,111,69,42,4,1
"6820","D41","RMDQ1_v1",0.428571428571429,0.917577367895651,7,109,69,40,4,3
"6821","D42","RMDQ1_v1",0.5,0.920972823893012,2,114,72,42,1,1
"6822","D43","RMDQ1_v1",0.5,0.920972823893012,2,114,72,42,1,1
"6823","D44","RMDQ1_v1",0.405405405405405,0.687819627425963,37,79,51,28,22,15
"6824","D45","RMDQ1_v1",0.5,0.582170908878456,12,104,67,37,6,6
"6825","D46","RMDQ1_v1",0.405405405405405,0.687819627425963,37,79,51,28,22,15
"6826","D47","RMDQ1_v1",0.5,0.582170908878456,12,104,67,37,6,6
"6827","D48","RMDQ1_v1",0.384615384615385,0.853761731914164,26,90,57,33,16,10
"6828","D49","RMDQ1_v1",0.384615384615385,0.933167918034082,13,103,65,38,8,5
"6829","D5","RMDQ1_v1",0.333333333333333,0.977692589616264,3,113,71,42,2,1
"6830","D50","RMDQ1_v1",0,0.737884567605411,1,115,72,43,1,0
"6831","D51","RMDQ1_v1",1,0.419839443150142,1,115,73,42,0,1
"6832","D52","RMDQ1_v1",1,0.419839443150142,1,115,73,42,0,1
"6833","D53","RMDQ1_v1",1,0.419839443150142,1,115,73,42,0,1
"6834","D9","RMDQ1_v1",1,0.419839443150142,1,115,73,42,0,1
"6835","RMDQ1_v1","RMDQ1_v1",1,6.30385557955145e-94,85,134,134,0,0,85
"6836","RMDQ2_v1","RMDQ1_v1",0.922222222222222,3.17227670138496e-86,90,129,127,2,7,83
"6837","RMDQ3_v1","RMDQ1_v1",0.607594936708861,8.13536480635045e-07,78,141,104,37,30,48
"6838","RMDQ4_v1","RMDQ1_v1",0.5,0.0249803320986608,53,166,108,58,26,27
"6839","RMDQ5_v1","RMDQ1_v1",0.625,2.38752129181465e-06,72,147,107,40,27,45
"6840","RMDQ6_v1","RMDQ1_v1",0.535714285714286,0.0264557483071908,56,163,108,55,26,30
"6841","RMDQ7_v1","RMDQ1_v1",0.846153846153846,6.58361960131162e-10,39,180,128,52,6,33
"6842","RMDQ8_v1","RMDQ1_v1",0.5,0.787645961045798,8,211,130,81,4,4
"6843","RMDQ9_v1","RMDQ1_v1",0.911764705882353,6.78569757203779e-11,34,185,131,54,3,31
"6844","RMDQ10_v1","RMDQ1_v1",0.75,1.17754037412817e-06,40,179,124,55,10,30
"6845","RMDQ11_v1","RMDQ1_v1",0.714285714285714,7.5201692089832e-06,42,177,122,55,12,30
"6846","RMDQ12_v1","RMDQ1_v1",0.75,2.1372128783049e-07,44,175,123,52,11,33
"6847","RMDQ13_v1","RMDQ1_v1",0.717391304347826,1.41417293958435e-06,46,173,121,52,13,33
"6848","RMDQ14_v1","RMDQ1_v1",0.836734693877551,1.92360002097082e-12,49,170,126,44,8,41
"6849","RMDQ15_v1","RMDQ1_v1",0.935483870967742,1.08138535596357e-10,31,188,132,56,2,29
"6850","RMDQ16_v1","RMDQ1_v1",0.810810810810811,4.53186243686946e-08,37,182,127,55,7,30
"6851","RMDQ17_v1","RMDQ1_v1",0.714285714285714,5.99187808282579e-07,49,170,120,50,14,35
"6852","RMDQ18_v1","RMDQ1_v1",0.777777777777778,9.00574812795764e-07,36,183,126,57,8,28
"6853","RMDQ19_v1","RMDQ1_v1",0.875,6.44774590091149e-09,32,187,130,57,4,28
"6854","RMDQ20_v1","RMDQ1_v1",0.815789473684211,1.72875315140032e-08,38,181,127,54,7,31
"6855","RMDQ21_v1","RMDQ1_v1",0.854166666666667,4.90670233882204e-13,48,171,127,44,7,41
"6856","RMDQ22_v1","RMDQ1_v1",0.763157894736842,1.04766953979787e-06,38,181,125,56,9,29
"6857","RMDQ23_v1","RMDQ1_v1",0.783783783783784,3.6302012489557e-07,37,182,126,56,8,29
"6858","RMDQ24_v1","RMDQ1_v1",0.857142857142857,3.53874618470868e-09,35,184,129,55,5,30
"6859","DN4 - Queimação","RMDQ1_v1",0.4,0.531281437797716,99,109,68,41,59,40
"6860","DN4 - Sensação de frio dolorosa","RMDQ1_v1",0.234042553191489,0.0363607768486632,47,160,90,70,36,11
"6861","DN4 - Choque elétrico","RMDQ1_v1",0.4,0.255956111731342,59,152,95,57,35,24
"6862","DN4 - Formigamento","RMDQ1_v1",0.357142857142857,0.231449026336963,55,156,95,61,35,20
"6863","DN4 - Alfinetada e agulhada","RMDQ1_v1",0.387096774193548,0.291748256718926,61,150,93,57,37,24
"6864","DN4 - Adormecimento","RMDQ1_v1",0.525423728813559,0.00815208145448882,58,150,100,50,27,31
"6865","DN4 - Coceira","RMDQ1_v1",0.545454545454545,0.511309730893215,11,200,125,75,5,6
"6866","DH4 - Hipoestesia ao toque","RMDQ1_v1",0.714285714285714,0.183481095295291,7,204,128,76,2,5
"6867","DN4 - Hipoestesia a picada de agulha","RMDQ1_v1",0.571428571428571,0.572377583306212,7,204,127,77,3,4
"6868","DN4 - Escovação","RMDQ1_v1",0.666666666666667,0.345280605550868,6,205,128,77,2,4
"6869","Fuma","RMDQ2_v1",0.361111111111111,0.581690612423897,36,146,81,65,23,13
"6870","Cirurgia na coluna","RMDQ2_v1",0.397058823529412,0.759906498431339,68,126,75,51,41,27
"6871","Aposentado","RMDQ2_v1",0.454545454545455,0.73822898221603,33,149,90,59,18,15
"6872","Desempregado","RMDQ2_v1",0.576923076923077,0.139003452575216,26,152,95,57,11,15
"6873","Licenca_Medica","RMDQ2_v1",0.315789473684211,0.631572469358286,19,161,93,68,13,6
"6874","Aposentado_Invalidez","RMDQ2_v1",0.625,0.43725636344294,8,170,102,68,3,5
"6875","Analgésicos","RMDQ2_v1",0.446808510638298,0.0722802109307247,140,57,41,16,77,63
"6876","OutraDoenca","RMDQ2_v1",0.466666666666667,0.41300301959749,75,113,69,44,40,35
"6877","Dor nas costas","RMDQ2_v1",0.463414634146341,0.136458250890013,122,67,45,22,65,57
"6878","Dor nas pernas","RMDQ2_v1",0.446153846153846,0.683484612687491,65,122,72,50,36,29
"6879","Retornar_trabalho","RMDQ2_v1",0.578947368421053,0.263558784410674,19,167,102,65,8,11
"6880","Masc","RMDQ2_v1",0.429530201342282,0.509070526339633,148,71,45,26,84,64
"6881","Fem","RMDQ2_v1",0.366197183098592,0.509070526339633,71,148,84,64,45,26
"6882","Casado/Amasiaado","RMDQ2_v1",0.506172839506173,0.0522302309605921,81,100,66,34,40,41
"6883","Solteiro","RMDQ2_v1",0.346666666666667,0.175707311905322,74,107,58,49,48,26
"6884","Separado_Divorciado","RMDQ2_v1",0.285714285714286,0.763573484588478,7,174,101,73,5,2
"6885","X4","RMDQ2_v1",0,0.335043011304556,3,178,103,75,3,0
"6886","X5","RMDQ2_v1",0.75,0.380659457226035,4,177,105,72,1,3
"6887","X6","RMDQ2_v1",0.25,0.470216191509536,12,169,97,72,9,3
"6888","Livrar_costas","RMDQ2_v1",0.467289719626168,0.712528856219392,106,16,10,6,56,50
"6889","Livrar_perna","RMDQ2_v1",0.357142857142857,0.67194136948442,14,108,57,51,9,5
"6890","Livrar_perda_sens","RMDQ2_v1",0.5,0.98485147500424,2,120,65,55,1,1
"6891","D1","RMDQ2_v1",1,0.471846992882068,1,115,69,46,0,1
"6892","D15","RMDQ2_v1",0.428571428571429,0.960191476540528,7,109,65,44,4,3
"6893","D16","RMDQ2_v1",0.45,0.814305430061036,20,96,58,38,11,9
"6894","D17","RMDQ2_v1",0.4,0.977451832998824,5,111,66,45,3,2
"6895","D18","RMDQ2_v1",0.615384615384615,0.00297494399683545,12,104,65,39,4,8
"6896","D19","RMDQ2_v1",0.666666666666667,0.393698491458265,6,110,67,43,2,4
"6897","D2","RMDQ2_v1",0.5,0.819883619597099,8,108,65,43,4,4
"6898","D20","RMDQ2_v1",0.571428571428571,0.000165330320094573,6,110,67,43,2,4
"6899","D21","RMDQ2_v1",0.714285714285714,0.21854888010462,7,109,67,42,2,5
"6900","D22","RMDQ2_v1",1,0.471846992882068,1,115,69,46,0,1
"6901","D23","RMDQ2_v1",1,0.21975024120729,2,114,69,45,0,2
"6902","D24","RMDQ2_v1",0.458333333333333,0.734403154588601,24,92,56,36,13,11
"6903","D25","RMDQ2_v1",0.666666666666667,0.635197336145884,3,113,68,45,1,2
"6904","D26","RMDQ2_v1",1,0.21975024120729,2,114,69,45,0,2
"6905","D27","RMDQ2_v1",0.5,0.908662519064035,4,112,67,45,2,2
"6906","D28","RMDQ2_v1",0.8,0.177938334542549,5,111,68,43,1,4
"6907","D29","RMDQ2_v1",0.357142857142857,0.549534480400945,42,74,42,32,27,15
"6908","D3","RMDQ2_v1",0.5,0.954032179312802,2,114,68,46,1,1
"6909","Lombalgia","RMDQ2_v1",0.459016393442623,0.266469052617695,61,55,36,19,33,28
"6910","D31","RMDQ2_v1",0.470588235294118,0.76810092592651,17,99,60,39,9,8
"6911","D32","RMDQ2_v1",0.378378378378378,0.730128878109783,37,79,46,33,23,14
"6912","D33","RMDQ2_v1",0.416666666666667,0.940510844341231,12,104,62,42,7,5
"6913","D34","RMDQ2_v1",0.5,0.954032179312802,2,114,68,46,1,1
"6914","D35","RMDQ2_v1",1,0.471846992882068,1,115,69,46,0,1
"6915","D36","RMDQ2_v1",0.285714285714286,0.775367547407954,7,109,64,45,5,2
"6916","D37","RMDQ2_v1",0.380952380952381,0.867852209541283,21,95,56,39,13,8
"6917","D38","RMDQ2_v1",0.333333333333333,0.954544274139124,3,113,67,46,2,1
"6918","D39","RMDQ2_v1",0.428571428571429,0.916891043399829,14,102,61,41,8,6
"6919","D4","RMDQ2_v1",0.666666666666667,0.635197336145884,3,113,68,45,1,2
"6920","D40","RMDQ2_v1",0.2,0.617174336474835,5,111,65,46,4,1
"6921","D41","RMDQ2_v1",0.285714285714286,0.775367547407954,7,109,64,45,5,2
"6922","D42","RMDQ2_v1",1,0.21975024120729,2,114,69,45,0,2
"6923","D43","RMDQ2_v1",1,0.21975024120729,2,114,69,45,0,2
"6924","D44","RMDQ2_v1",0.405405405405405,0.791955812338478,37,79,47,32,22,15
"6925","D45","RMDQ2_v1",0.5,0.734006438560595,12,104,63,41,6,6
"6926","D46","RMDQ2_v1",0.432432432432432,0.728049452399165,37,79,48,31,21,16
"6927","D47","RMDQ2_v1",0.583333333333333,0.388387670078627,12,104,64,40,5,7
"6928","D48","RMDQ2_v1",0.384615384615385,0.840592113922925,26,90,53,37,16,10
"6929","D49","RMDQ2_v1",0.461538461538462,0.851915214910633,13,103,62,41,7,6
"6930","D5","RMDQ2_v1",0.666666666666667,0.635197336145884,3,113,68,45,1,2
"6931","D50","RMDQ2_v1",0,0.704107252091958,1,115,68,47,1,0
"6932","D51","RMDQ2_v1",1,0.471846992882068,1,115,69,46,0,1
"6933","D52","RMDQ2_v1",1,0.471846992882068,1,115,69,46,0,1
"6934","D53","RMDQ2_v1",1,0.471846992882068,1,115,69,46,0,1
"6935","D9","RMDQ2_v1",1,0.471846992882068,1,115,69,46,0,1
"6936","RMDQ1_v1","RMDQ2_v1",0.976470588235294,3.17227670138496e-86,85,134,127,7,2,83
"6937","RMDQ2_v1","RMDQ2_v1",1,6.30385557955145e-94,90,129,129,0,0,90
"6938","RMDQ3_v1","RMDQ2_v1",0.670886075949367,6.34975435763731e-09,78,141,104,37,25,53
"6939","RMDQ4_v1","RMDQ2_v1",0.574074074074074,0.00281644340627836,53,166,107,59,22,31
"6940","RMDQ5_v1","RMDQ2_v1",0.680555555555556,7.65572292102654e-08,72,147,106,41,23,49
"6941","RMDQ6_v1","RMDQ2_v1",0.553571428571429,0.0353763368153779,56,163,104,59,25,31
"6942","RMDQ7_v1","RMDQ2_v1",0.897435897435897,6.97704241388092e-11,39,180,125,55,4,35
"6943","RMDQ8_v1","RMDQ2_v1",0.625,0.445689195666228,8,211,126,85,3,5
"6944","RMDQ9_v1","RMDQ2_v1",0.882352941176471,8.07881001677841e-09,34,185,125,60,4,30
"6945","RMDQ10_v1","RMDQ2_v1",0.825,2.50673127666809e-08,40,179,122,57,7,33
"6946","RMDQ11_v1","RMDQ2_v1",0.785714285714286,2.39311742179001e-07,42,177,120,57,9,33
"6947","RMDQ12_v1","RMDQ2_v1",0.772727272727273,2.87693687167412e-07,44,175,119,56,10,34
"6948","RMDQ13_v1","RMDQ2_v1",0.695652173913043,4.94798601733118e-05,46,173,115,58,14,32
"6949","RMDQ14_v1","RMDQ2_v1",0.918367346938776,2.04855149266087e-15,49,170,125,45,4,45
"6950","RMDQ15_v1","RMDQ2_v1",0.935483870967742,1.04211040204672e-09,31,188,127,61,2,29
"6951","RMDQ16_v1","RMDQ2_v1",0.810810810810811,3.52642005073268e-07,37,182,122,60,7,30
"6952","RMDQ17_v1","RMDQ2_v1",0.755102040816326,1.61969694346102e-07,49,170,117,53,12,37
"6953","RMDQ18_v1","RMDQ2_v1",0.888888888888889,1.25170659308546e-09,36,183,125,58,4,32
"6954","RMDQ19_v1","RMDQ2_v1",0.84375,4.38773576836436e-07,32,187,124,63,5,27
"6955","RMDQ20_v1","RMDQ2_v1",0.842105263157895,1.82004320823127e-08,38,181,123,58,6,32
"6956","RMDQ21_v1","RMDQ2_v1",0.916666666666667,6.16870353498056e-15,48,171,125,46,4,44
"6957","RMDQ22_v1","RMDQ2_v1",0.789473684210526,1.05676818168364e-06,38,181,121,60,8,30
"6958","RMDQ23_v1","RMDQ2_v1",0.810810810810811,3.52642005073268e-07,37,182,122,60,7,30
"6959","RMDQ24_v1","RMDQ2_v1",0.885714285714286,3.1989979964361e-09,35,184,125,59,4,31
"6960","DN4 - Queimação","RMDQ2_v1",0.43,0.306127392917048,99,109,70,39,56,43
"6961","DN4 - Sensação de frio dolorosa","RMDQ2_v1",0.234042553191489,0.0302754368560354,47,160,89,71,36,11
"6962","DN4 - Choque elétrico","RMDQ2_v1",0.45,0.124024635121457,59,152,97,55,32,27
"6963","DN4 - Formigamento","RMDQ2_v1",0.375,0.244962253015484,55,156,95,61,34,21
"6964","DN4 - Alfinetada e agulhada","RMDQ2_v1",0.419354838709677,0.230151198924343,61,150,94,56,35,26
"6965","DN4 - Adormecimento","RMDQ2_v1",0.508474576271186,0.0222315492561776,58,150,98,52,28,30
"6966","DN4 - Coceira","RMDQ2_v1",0.454545454545455,0.874510431028916,11,200,123,77,6,5
"6967","DH4 - Hipoestesia ao toque","RMDQ2_v1",0.714285714285714,0.19389547816516,7,204,127,77,2,5
"6968","DN4 - Hipoestesia a picada de agulha","RMDQ2_v1",0.571428571428571,0.58940764301107,7,204,126,78,3,4
"6969","DN4 - Escovação","RMDQ2_v1",0.666666666666667,0.359177906869156,6,205,127,78,2,4
"6970","Fuma","RMDQ3_v1",0.361111111111111,0.906722143524252,36,148,93,55,23,13
"6971","Cirurgia na coluna","RMDQ3_v1",0.347826086956522,0.67605112151853,69,127,79,48,45,24
"6972","Aposentado","RMDQ3_v1",0.441176470588235,0.377357110657859,34,150,96,54,19,15
"6973","Desempregado","RMDQ3_v1",0.307692307692308,0.391089734556973,26,154,93,61,18,8
"6974","Licenca_Medica","RMDQ3_v1",0.210526315789474,0.109476106898028,19,163,98,65,15,4
"6975","Aposentado_Invalidez","RMDQ3_v1",0.375,0.960446555128132,8,172,106,66,5,3
"6976","Analgésicos","RMDQ3_v1",0.415492957746479,0.00635828553423594,142,57,45,12,83,59
"6977","OutraDoenca","RMDQ3_v1",0.407894736842105,0.357057998962371,76,114,75,39,45,31
"6978","Dor nas costas","RMDQ3_v1",0.395161290322581,0.361938081946207,124,67,45,22,75,49
"6979","Dor nas pernas","RMDQ3_v1",0.353846153846154,0.733409291050627,65,124,77,47,42,23
"6980","Retornar_trabalho","RMDQ3_v1",0.55,0.0821079303381303,20,168,109,59,9,11
"6981","Masc","RMDQ3_v1",0.373333333333333,0.610064253127636,150,71,47,24,94,56
"6982","Fem","RMDQ3_v1",0.338028169014085,0.610064253127636,71,150,94,56,47,24
"6983","Casado/Amasiaado","RMDQ3_v1",0.419753086419753,0.137910233949832,81,102,70,32,47,34
"6984","Solteiro","RMDQ3_v1",0.306666666666667,0.204988685641538,75,108,65,43,52,23
"6985","Separado_Divorciado","RMDQ3_v1",0.25,0.505080297248401,8,175,111,64,6,2
"6986","X4","RMDQ3_v1",0,0.189627047089212,3,180,114,66,3,0
"6987","X5","RMDQ3_v1",0.25,0.641213014187573,4,179,114,65,3,1
"6988","X6","RMDQ3_v1",0.5,0.298384341750286,12,171,111,60,6,6
"6989","Livrar_costas","RMDQ3_v1",0.407407407407407,0.0906252349756962,108,16,13,3,64,44
"6990","Livrar_perna","RMDQ3_v1",0.214285714285714,0.177326715684862,14,110,66,44,11,3
"6991","Livrar_perda_sens","RMDQ3_v1",0,0.26531847168,2,122,75,47,2,0
"6992","D1","RMDQ3_v1",1,0.1296036170137,1,117,82,35,0,1
"6993","D15","RMDQ3_v1",0.142857142857143,0.336492389359646,7,111,76,35,6,1
"6994","D16","RMDQ3_v1",0.6,0.00167144613575706,20,98,74,24,8,12
"6995","D17","RMDQ3_v1",0.4,0.637620812722162,5,113,79,34,3,2
"6996","D18","RMDQ3_v1",0.461538461538462,0.194027498199525,13,105,75,30,7,6
"6997","D19","RMDQ3_v1",0.666666666666667,0.0483347215020216,6,112,80,32,2,4
"6998","D2","RMDQ3_v1",0.375,0.656449010120284,8,110,77,33,5,3
"6999","D20","RMDQ3_v1",0.428571428571429,0.464413990014066,7,111,78,33,4,3
"7000","D21","RMDQ3_v1",0.428571428571429,0.464413990014066,7,111,78,33,4,3
"7001","D22","RMDQ3_v1",1,0.1296036170137,1,117,82,35,0,1
"7002","D23","RMDQ3_v1",0,0.344614970744897,2,116,80,36,2,0
"7003","D24","RMDQ3_v1",0.208333333333333,0.24876378904953,24,94,63,31,19,5
"7004","D25","RMDQ3_v1",0.333333333333333,0.914281346421744,3,115,80,35,2,1
"7005","D26","RMDQ3_v1",0.5,0.545973330618042,2,116,81,35,1,1
"7006","D27","RMDQ3_v1",0.5,0.389035941189481,4,114,80,34,2,2
"7007","D28","RMDQ3_v1",0.2,0.602021867512018,5,113,78,35,4,1
"7008","D29","RMDQ3_v1",0.380952380952381,0.183329022795282,42,76,56,20,26,16
"7009","D3","RMDQ3_v1",0.5,0.545973330618042,2,116,81,35,1,1
"7010","Lombalgia","RMDQ3_v1",0.387096774193548,0.0417661530807971,62,56,44,12,38,24
"7011","D31","RMDQ3_v1",0.176470588235294,0.213186511666148,17,101,68,33,14,3
"7012","D32","RMDQ3_v1",0.405405405405405,0.109685573722337,37,81,60,21,22,15
"7013","D33","RMDQ3_v1",0.0833333333333333,0.0783691601235595,12,106,71,35,11,1
"7014","D34","RMDQ3_v1",0.5,0.545973330618042,2,116,81,35,1,1
"7015","D35","RMDQ3_v1",1,0.1296036170137,1,117,82,35,0,1
"7016","D36","RMDQ3_v1",0.142857142857143,0.336492389359646,7,111,76,35,6,1
"7017","D37","RMDQ3_v1",0.571428571428571,0.0034590960277488,21,97,73,24,9,12
"7018","D38","RMDQ3_v1",0,0.245027998211865,3,115,79,36,3,0
"7019","D39","RMDQ3_v1",0.714285714285714,0.000397102052634863,14,104,78,26,4,10
"7020","D4","RMDQ3_v1",0.666666666666667,0.168267917974578,3,115,81,34,1,2
"7021","D40","RMDQ3_v1",0,0.130021212550665,5,113,77,36,5,0
"7022","D41","RMDQ3_v1",0.142857142857143,0.336492389359646,7,111,76,35,6,1
"7023","D42","RMDQ3_v1",0.5,0.545973330618042,2,116,81,35,1,1
"7024","D43","RMDQ3_v1",0.5,0.545973330618042,2,116,81,35,1,1
"7025","D44","RMDQ3_v1",0.378378378378378,0.242539283464844,37,81,59,22,23,14
"7026","D45","RMDQ3_v1",0.166666666666667,0.27188104022459,12,106,72,34,10,2
"7027","D46","RMDQ3_v1",0.405405405405405,0.109685573722337,37,81,60,21,22,15
"7028","D47","RMDQ3_v1",0.25,0.66192709096947,12,106,73,33,9,3
"7029","D48","RMDQ3_v1",0.423076923076923,0.138919545778521,26,92,67,25,15,11
"7030","D49","RMDQ3_v1",0.153846153846154,0.209310135673498,13,105,71,34,11,2
"7031","D5","RMDQ3_v1",0.666666666666667,0.168267917974578,3,115,81,34,1,2
"7032","D50","RMDQ3_v1",0,0.505785279295151,1,117,81,36,1,0
"7033","D51","RMDQ3_v1",1,0.1296036170137,1,117,82,35,0,1
"7034","D52","RMDQ3_v1",0,0.505785279295151,1,117,81,36,1,0
"7035","D53","RMDQ3_v1",0,0.505785279295151,1,117,81,36,1,0
"7036","D9","RMDQ3_v1",1,0.1296036170137,1,117,82,35,0,1
"7037","RMDQ1_v1","RMDQ3_v1",0.564705882352941,8.13536480635045e-07,85,134,104,30,37,48
"7038","RMDQ2_v1","RMDQ3_v1",0.588888888888889,6.34975435763731e-09,90,129,104,25,37,53
"7039","RMDQ3_v1","RMDQ3_v1",1,5.47343909811772e-50,80,141,141,0,0,80
"7040","RMDQ4_v1","RMDQ3_v1",0.945454545454545,2.78172854566654e-25,55,166,138,28,3,52
"7041","RMDQ5_v1","RMDQ3_v1",0.986301369863014,6.61042041026502e-42,73,148,140,8,1,72
"7042","RMDQ6_v1","RMDQ3_v1",0.929824561403509,3.95177001935911e-25,57,164,137,27,4,53
"7043","RMDQ7_v1","RMDQ3_v1",0.871794871794872,1.86429770521999e-13,39,181,136,45,5,34
"7044","RMDQ8_v1","RMDQ3_v1",1,0.000118444481158393,8,212,141,71,0,8
"7045","RMDQ9_v1","RMDQ3_v1",0.941176470588235,1.42042079788437e-14,34,186,139,47,2,32
"7046","RMDQ10_v1","RMDQ3_v1",0.825,1.11696010371198e-11,40,180,134,46,7,33
"7047","RMDQ11_v1","RMDQ3_v1",0.880952380952381,4.59390768870471e-15,42,178,136,42,5,37
"7048","RMDQ12_v1","RMDQ3_v1",0.840909090909091,9.44652915593103e-14,44,176,134,42,7,37
"7049","RMDQ13_v1","RMDQ3_v1",0.826086956521739,1.13775344270434e-13,46,174,133,41,8,38
"7050","RMDQ14_v1","RMDQ3_v1",0.755102040816326,5.59488249261901e-11,49,171,129,42,12,37
"7051","RMDQ15_v1","RMDQ3_v1",0.870967741935484,1.45966753489881e-10,31,189,137,52,4,27
"7052","RMDQ16_v1","RMDQ3_v1",0.864864864864865,2.04450175535716e-12,37,183,136,47,5,32
"7053","RMDQ17_v1","RMDQ3_v1",0.836734693877551,2.67418826934506e-15,49,171,133,38,8,41
"7054","RMDQ18_v1","RMDQ3_v1",0.916666666666667,2.43460663739859e-14,36,184,138,46,3,33
"7055","RMDQ19_v1","RMDQ3_v1",0.9375,1.60614407592184e-13,32,188,139,49,2,30
"7056","RMDQ20_v1","RMDQ3_v1",0.868421052631579,6.21912955863492e-13,38,182,136,46,5,33
"7057","RMDQ21_v1","RMDQ3_v1",0.854166666666667,6.16068599359073e-16,48,172,134,38,7,41
"7058","RMDQ22_v1","RMDQ3_v1",0.973684210526316,3.86479379489919e-18,38,182,140,42,1,37
"7059","RMDQ23_v1","RMDQ3_v1",0.891891891891892,1.29040585764663e-13,37,183,137,46,4,33
"7060","RMDQ24_v1","RMDQ3_v1",0.942857142857143,4.14338260931118e-15,35,185,139,46,2,33
"7061","DN4 - Queimação","RMDQ3_v1",0.42,0.0775207366184494,100,109,76,33,58,42
"7062","DN4 - Sensação de frio dolorosa","RMDQ3_v1",0.48936170212766,0.0149959134720355,47,161,113,48,24,23
"7063","DN4 - Choque elétrico","RMDQ3_v1",0.316666666666667,0.477741396481729,60,152,96,56,41,19
"7064","DN4 - Formigamento","RMDQ3_v1",0.357142857142857,0.950982935288064,56,156,101,55,36,20
"7065","DN4 - Alfinetada e agulhada","RMDQ3_v1",0.419354838709677,0.199164938710078,62,150,101,49,36,26
"7066","DN4 - Adormecimento","RMDQ3_v1",0.440677966101695,0.121932546565981,59,150,101,49,33,26
"7067","DN4 - Coceira","RMDQ3_v1",0.181818181818182,0.220584862106837,11,201,128,73,9,2
"7068","DH4 - Hipoestesia ao toque","RMDQ3_v1",0.714285714285714,0.0424950368778223,7,205,135,70,2,5
"7069","DN4 - Hipoestesia a picada de agulha","RMDQ3_v1",0.571428571428571,0.2206629042074,7,205,134,71,3,4
"7070","DN4 - Escovação","RMDQ3_v1",0.666666666666667,0.103925515433484,6,206,135,71,2,4
"7071","Fuma","RMDQ4_v1",0.222222222222222,0.667801806476608,36,148,110,38,28,8
"7072","Cirurgia na coluna","RMDQ4_v1",0.202898550724638,0.144652157982923,69,127,89,38,55,14
"7073","Aposentado","RMDQ4_v1",0.411764705882353,0.0420746840668553,34,150,114,36,20,14
"7074","Desempregado","RMDQ4_v1",0.230769230769231,0.562879972724213,26,154,110,44,20,6
"7075","Licenca_Medica","RMDQ4_v1",0.105263157894737,0.080360001397994,19,163,115,48,17,2
"7076","Aposentado_Invalidez","RMDQ4_v1",0,0.0688637980419037,8,172,121,51,8,0
"7077","Analgésicos","RMDQ4_v1",0.28169014084507,0.0668612567988796,142,57,48,9,102,40
"7078","OutraDoenca","RMDQ4_v1",0.315789473684211,0.178565363964427,76,114,88,26,52,24
"7079","Dor nas costas","RMDQ4_v1",0.266129032258065,0.969940903729132,124,67,49,18,91,33
"7080","Dor nas pernas","RMDQ4_v1",0.184615384615385,0.0559905895730544,65,124,85,39,53,12
"7081","Retornar_trabalho","RMDQ4_v1",0.45,0.0412784706079568,20,168,128,40,11,9
"7082","Masc","RMDQ4_v1",0.246666666666667,0.912365951801742,150,71,53,18,113,37
"7083","Fem","RMDQ4_v1",0.253521126760563,0.912365951801742,71,150,113,37,53,18
"7084","Casado/Amasiaado","RMDQ4_v1",0.308641975308642,0.15282122386249,81,102,80,22,56,25
"7085","Solteiro","RMDQ4_v1",0.213333333333333,0.261701932372275,75,108,77,31,59,16
"7086","Separado_Divorciado","RMDQ4_v1",0.25,0.963930908304965,8,175,130,45,6,2
"7087","X4","RMDQ4_v1",0,0.304577525311025,3,180,133,47,3,0
"7088","X5","RMDQ4_v1",0,0.234518697602857,4,179,132,47,4,0
"7089","X6","RMDQ4_v1",0.333333333333333,0.530318247394057,12,171,128,43,8,4
"7090","Livrar_costas","RMDQ4_v1",0.296296296296296,0.0482807554318782,108,16,15,1,76,32
"7091","Livrar_perna","RMDQ4_v1",0.0714285714285714,0.0800825319698658,14,110,78,32,13,1
"7092","Livrar_perda_sens","RMDQ4_v1",0,0.390570714659516,2,122,89,33,2,0
"7093","D1","RMDQ4_v1",1,0.0588782180805536,1,117,92,25,0,1
"7094","D15","RMDQ4_v1",0,0.14700890489015,7,111,85,26,7,0
"7095","D16","RMDQ4_v1",0.35,0.12474439143712,20,98,79,19,13,7
"7096","D17","RMDQ4_v1",0.2,0.910721228321822,5,113,88,25,4,1
"7097","D18","RMDQ4_v1",0.461538461538462,0.0261274221766047,13,105,85,20,7,6
"7098","D19","RMDQ4_v1",0.166666666666667,0.744741205960005,6,112,87,25,5,1
"7099","D2","RMDQ4_v1",0.125,0.500408304194632,8,110,85,25,7,1
"7100","D20","RMDQ4_v1",0.428571428571429,0.17053155106964,7,111,88,23,4,3
"7101","D21","RMDQ4_v1",0.285714285714286,0.666997373764384,7,111,87,24,5,2
"7102","D22","RMDQ4_v1",1,0.0588782180805536,1,117,92,25,0,1
"7103","D23","RMDQ4_v1",0.5,0.335843434078945,2,116,91,25,1,1
"7104","D24","RMDQ4_v1",0.0833333333333333,0.0696228781730831,24,94,70,24,22,2
"7105","D25","RMDQ4_v1",0.333333333333333,0.632428483419777,3,115,90,25,2,1
"7106","D26","RMDQ4_v1",0.5,0.335843434078945,2,116,91,25,1,1
"7107","D27","RMDQ4_v1",0.5,0.169770638744954,4,114,90,24,2,2
"7108","D28","RMDQ4_v1",0.6,0.0363427095107848,5,113,90,23,2,3
"7109","D29","RMDQ4_v1",0.238095238095238,0.729381301984325,42,76,60,16,32,10
"7110","D3","RMDQ4_v1",0,0.448293654715812,2,116,90,26,2,0
"7111","Lombalgia","RMDQ4_v1",0.241935483870968,0.551467259341997,62,56,45,11,47,15
"7112","D31","RMDQ4_v1",0.117647058823529,0.26951218312028,17,101,77,24,15,2
"7113","D32","RMDQ4_v1",0.216216216216216,0.94178381711529,37,81,63,18,29,8
"7114","D33","RMDQ4_v1",0,0.0520168860438896,12,106,80,26,12,0
"7115","D34","RMDQ4_v1",0,0.448293654715812,2,116,90,26,2,0
"7116","D35","RMDQ4_v1",0,0.593426957598424,1,117,91,26,1,0
"7117","D36","RMDQ4_v1",0.142857142857143,0.610084612119384,7,111,86,25,6,1
"7118","D37","RMDQ4_v1",0.333333333333333,0.168229038481836,21,97,78,19,14,7
"7119","D38","RMDQ4_v1",0,0.350971009055765,3,115,89,26,3,0
"7120","D39","RMDQ4_v1",0.5,0.00716253512090891,14,104,85,19,7,7
"7121","D4","RMDQ4_v1",0,0.350971009055765,3,115,89,26,3,0
"7122","D40","RMDQ4_v1",0,0.224469313782964,5,113,87,26,5,0
"7123","D41","RMDQ4_v1",0.142857142857143,0.610084612119384,7,111,86,25,6,1
"7124","D42","RMDQ4_v1",0.5,0.335843434078945,2,116,91,25,1,1
"7125","D43","RMDQ4_v1",1,0.00729466964254349,2,116,92,24,0,2
"7126","D44","RMDQ4_v1",0.189189189189189,0.581107798957517,37,81,62,19,30,7
"7127","D45","RMDQ4_v1",0,0.0520168860438896,12,106,80,26,12,0
"7128","D46","RMDQ4_v1",0.189189189189189,0.581107798957517,37,81,62,19,30,7
"7129","D47","RMDQ4_v1",0,0.0520168860438896,12,106,80,26,12,0
"7130","D48","RMDQ4_v1",0.307692307692308,0.22357858074098,26,92,74,18,18,8
"7131","D49","RMDQ4_v1",0,0.0421597727084564,13,105,79,26,13,0
"7132","D5","RMDQ4_v1",0,0.350971009055765,3,115,89,26,3,0
"7133","D50","RMDQ4_v1",0,0.593426957598424,1,117,91,26,1,0
"7134","D51","RMDQ4_v1",0,0.593426957598424,1,117,91,26,1,0
"7135","D52","RMDQ4_v1",0,0.593426957598424,1,117,91,26,1,0
"7136","D53","RMDQ4_v1",1,0.0588782180805536,1,117,92,25,0,1
"7137","D9","RMDQ4_v1",0,0.593426957598424,1,117,91,26,1,0
"7138","RMDQ1_v1","RMDQ4_v1",0.317647058823529,0.0249803320986608,85,134,108,26,58,27
"7139","RMDQ2_v1","RMDQ4_v1",0.344444444444444,0.00281644340627836,90,129,107,22,59,31
"7140","RMDQ3_v1","RMDQ4_v1",0.65,2.78172854566654e-25,80,141,138,3,28,52
"7141","RMDQ4_v1","RMDQ4_v1",1,5.47343909811772e-50,55,166,166,0,0,55
"7142","RMDQ5_v1","RMDQ4_v1",0.643835616438356,1.4601745853292e-21,73,148,140,8,26,47
"7143","RMDQ6_v1","RMDQ4_v1",0.56140350877193,2.36888292597745e-10,57,164,141,23,25,32
"7144","RMDQ7_v1","RMDQ4_v1",0.256410256410256,0.860864600166572,39,181,137,44,29,10
"7145","RMDQ8_v1","RMDQ4_v1",0.875,2.49889128986684e-05,8,212,165,47,1,7
"7146","RMDQ9_v1","RMDQ4_v1",0.323529411764706,0.249948124795998,34,186,143,43,23,11
"7147","RMDQ10_v1","RMDQ4_v1",0.35,0.0894013050729901,40,180,140,40,26,14
"7148","RMDQ11_v1","RMDQ4_v1",0.428571428571429,0.00217179157532563,42,178,142,36,24,18
"7149","RMDQ12_v1","RMDQ4_v1",0.363636363636364,0.0416910696342506,44,176,138,38,28,16
"7150","RMDQ13_v1","RMDQ4_v1",0.369565217391304,0.0278522648007559,46,174,137,37,29,17
"7151","RMDQ14_v1","RMDQ4_v1",0.36734693877551,0.0245223053717586,49,171,135,36,31,18
"7152","RMDQ15_v1","RMDQ4_v1",0.161290322580645,0.240078396774443,31,189,140,49,26,5
"7153","RMDQ16_v1","RMDQ4_v1",0.297297297297297,0.421727933842598,37,183,140,43,26,11
"7154","RMDQ17_v1","RMDQ4_v1",0.387755102040816,0.00865561410133531,49,171,136,35,30,19
"7155","RMDQ18_v1","RMDQ4_v1",0.361111111111111,0.0778707674352351,36,184,143,41,23,13
"7156","RMDQ19_v1","RMDQ4_v1",0.25,0.948465952717107,32,188,142,46,24,8
"7157","RMDQ20_v1","RMDQ4_v1",0.315789473684211,0.268004517929777,38,182,140,42,26,12
"7158","RMDQ21_v1","RMDQ4_v1",0.458333333333333,0.000106233965949975,48,172,140,32,26,22
"7159","RMDQ22_v1","RMDQ4_v1",0.394736842105263,0.0187244284221641,38,182,143,39,23,15
"7160","RMDQ23_v1","RMDQ4_v1",0.297297297297297,0.421727933842598,37,183,140,43,26,11
"7161","RMDQ24_v1","RMDQ4_v1",0.342857142857143,0.144244861954636,35,185,143,42,23,12
"7162","DN4 - Queimação","RMDQ4_v1",0.23,0.865167565415426,100,109,85,24,77,23
"7163","DN4 - Sensação de frio dolorosa","RMDQ4_v1",0.361702127659574,0.00286381027296812,47,161,135,26,30,17
"7164","DN4 - Choque elétrico","RMDQ4_v1",0.166666666666667,0.225539055270831,60,152,115,37,50,10
"7165","DN4 - Formigamento","RMDQ4_v1",0.232142857142857,0.826375541877911,56,156,122,34,43,13
"7166","DN4 - Alfinetada e agulhada","RMDQ4_v1",0.258064516129032,0.412485604347167,62,150,119,31,46,16
"7167","DN4 - Adormecimento","RMDQ4_v1",0.288135593220339,0.169537021809952,59,150,120,30,42,17
"7168","DN4 - Coceira","RMDQ4_v1",0,0.0690773633006216,11,201,154,47,11,0
"7169","DH4 - Hipoestesia ao toque","RMDQ4_v1",0.142857142857143,0.609584954759234,7,205,159,46,6,1
"7170","DN4 - Hipoestesia a picada de agulha","RMDQ4_v1",0,0.151009363170705,7,205,158,47,7,0
"7171","DN4 - Escovação","RMDQ4_v1",0,0.184765492222842,6,206,159,47,6,0
"7172","Fuma","RMDQ5_v1",0.388888888888889,0.462316666993236,36,148,100,48,22,14
"7173","Cirurgia na coluna","RMDQ5_v1",0.318840579710145,0.779181831593866,69,127,84,43,47,22
"7174","Aposentado","RMDQ5_v1",0.441176470588235,0.15446007396301,34,150,103,47,19,15
"7175","Desempregado","RMDQ5_v1",0.269230769230769,0.382903243430447,26,154,99,55,19,7
"7176","Licenca_Medica","RMDQ5_v1",0.210526315789474,0.205975110924668,19,163,105,58,15,4
"7177","Aposentado_Invalidez","RMDQ5_v1",0.5,0.36284882192333,8,172,113,59,4,4
"7178","Analgésicos","RMDQ5_v1",0.387323943661972,0.00395942573176394,142,57,47,10,87,55
"7179","OutraDoenca","RMDQ5_v1",0.394736842105263,0.168008008369529,76,114,80,34,46,30
"7180","Dor nas costas","RMDQ5_v1",0.346774193548387,0.64131499335514,124,67,46,21,81,43
"7181","Dor nas pernas","RMDQ5_v1",0.338461538461538,0.997267956586687,65,124,82,42,43,22
"7182","Retornar_trabalho","RMDQ5_v1",0.6,0.00793388580791674,20,168,117,51,8,12
"7183","Masc","RMDQ5_v1",0.34,0.656412994827159,150,71,49,22,99,51
"7184","Fem","RMDQ5_v1",0.309859154929577,0.656412994827159,71,150,99,51,49,22
"7185","Casado/Amasiaado","RMDQ5_v1",0.37037037037037,0.343571574727339,81,102,71,31,51,30
"7186","Solteiro","RMDQ5_v1",0.28,0.202164715977912,75,108,68,40,54,21
"7187","Separado_Divorciado","RMDQ5_v1",0.25,0.609140401551206,8,175,116,59,6,2
"7188","X4","RMDQ5_v1",0,0.21686440944597,3,180,119,61,3,0
"7189","X5","RMDQ5_v1",0.25,0.720731087282001,4,179,119,60,3,1
"7190","X6","RMDQ5_v1",0.583333333333333,0.0573695405876138,12,171,117,54,5,7
"7191","Livrar_costas","RMDQ5_v1",0.351851851851852,0.192183679105858,108,16,13,3,70,38
"7192","Livrar_perna","RMDQ5_v1",0.214285714285714,0.325810897656119,14,110,72,38,11,3
"7193","Livrar_perda_sens","RMDQ5_v1",0,0.316308953668101,2,122,81,41,2,0
"7194","D1","RMDQ5_v1",0,0.531483921254055,1,117,84,33,1,0
"7195","D15","RMDQ5_v1",0.142857142857143,0.405712579214709,7,111,79,32,6,1
"7196","D16","RMDQ5_v1",0.65,5.14160689224434e-05,20,98,78,20,7,13
"7197","D17","RMDQ5_v1",0.2,0.685070666079238,5,113,81,32,4,1
"7198","D18","RMDQ5_v1",0.307692307692308,0.81132786707398,13,105,76,29,9,4
"7199","D19","RMDQ5_v1",0.5,0.217097695700059,6,112,82,30,3,3
"7200","D2","RMDQ5_v1",0.375,0.533767282950704,8,110,80,30,5,3
"7201","D20","RMDQ5_v1",0.142857142857143,0.405712579214709,7,111,79,32,6,1
"7202","D21","RMDQ5_v1",0.285714285714286,0.970652158540852,7,111,80,31,5,2
"7203","D22","RMDQ5_v1",1,0.107014020238433,1,117,85,32,0,1
"7204","D23","RMDQ5_v1",0,0.374143062948929,2,116,83,33,2,0
"7205","D24","RMDQ5_v1",0.166666666666667,0.167023529664458,24,94,65,29,20,4
"7206","D25","RMDQ5_v1",0,0.274305339715658,3,115,82,33,3,0
"7207","D26","RMDQ5_v1",0.5,0.483790516345729,2,116,84,32,1,1
"7208","D27","RMDQ5_v1",0.5,0.317839263222615,4,114,83,31,2,2
"7209","D28","RMDQ5_v1",0.2,0.685070666079238,5,113,81,32,4,1
"7210","D29","RMDQ5_v1",0.404761904761905,0.0243988930803844,42,76,60,16,25,17
"7211","D3","RMDQ5_v1",0.5,0.483790516345729,2,116,84,32,1,1
"7212","Lombalgia","RMDQ5_v1",0.387096774193548,0.00622015451316101,62,56,47,9,38,24
"7213","D31","RMDQ5_v1",0.176470588235294,0.3055459316822,17,101,71,30,14,3
"7214","D32","RMDQ5_v1",0.432432432432432,0.0124562963042038,37,81,64,17,21,16
"7215","D33","RMDQ5_v1",0.0833333333333333,0.109880046842287,12,106,74,32,11,1
"7216","D34","RMDQ5_v1",0.5,0.483790516345729,2,116,84,32,1,1
"7217","D35","RMDQ5_v1",1,0.107014020238433,1,117,85,32,0,1
"7218","D36","RMDQ5_v1",0.142857142857143,0.405712579214709,7,111,79,32,6,1
"7219","D37","RMDQ5_v1",0.619047619047619,0.000132447566781264,21,97,77,20,8,13
"7220","D38","RMDQ5_v1",0,0.274305339715658,3,115,82,33,3,0
"7221","D39","RMDQ5_v1",0.785714285714286,7.0009541633534e-06,14,104,82,22,3,11
"7222","D4","RMDQ5_v1",0.666666666666667,0.130326862481361,3,115,84,31,1,2
"7223","D40","RMDQ5_v1",0,0.154518328207651,5,113,80,33,5,0
"7224","D41","RMDQ5_v1",0.285714285714286,0.970652158540852,7,111,80,31,5,2
"7225","D42","RMDQ5_v1",0.5,0.483790516345729,2,116,84,32,1,1
"7226","D43","RMDQ5_v1",0.5,0.483790516345729,2,116,84,32,1,1
"7227","D44","RMDQ5_v1",0.378378378378378,0.106362286393871,37,81,62,19,23,14
"7228","D45","RMDQ5_v1",0.166666666666667,0.357502828284442,12,106,75,31,10,2
"7229","D46","RMDQ5_v1",0.432432432432432,0.0124562963042038,37,81,64,17,21,16
"7230","D47","RMDQ5_v1",0.25,0.809140392447248,12,106,76,30,9,3
"7231","D48","RMDQ5_v1",0.461538461538462,0.0192803113455495,26,92,71,21,14,12
"7232","D49","RMDQ5_v1",0.153846153846154,0.283974187424066,13,105,74,31,11,2
"7233","D5","RMDQ5_v1",0.666666666666667,0.130326862481361,3,115,84,31,1,2
"7234","D50","RMDQ5_v1",0,0.531483921254055,1,117,84,33,1,0
"7235","D51","RMDQ5_v1",1,0.107014020238433,1,117,85,32,0,1
"7236","D52","RMDQ5_v1",0,0.531483921254055,1,117,84,33,1,0
"7237","D53","RMDQ5_v1",0,0.531483921254055,1,117,84,33,1,0
"7238","D9","RMDQ5_v1",1,0.107014020238433,1,117,85,32,0,1
"7239","RMDQ1_v1","RMDQ5_v1",0.529411764705882,2.38752129181465e-06,85,134,107,27,40,45
"7240","RMDQ2_v1","RMDQ5_v1",0.544444444444444,7.65572292102654e-08,90,129,106,23,41,49
"7241","RMDQ3_v1","RMDQ5_v1",0.9,6.61042041026502e-42,80,141,140,1,8,72
"7242","RMDQ4_v1","RMDQ5_v1",0.854545454545454,1.4601745853292e-21,55,166,140,26,8,47
"7243","RMDQ5_v1","RMDQ5_v1",1,5.47343909811787e-50,73,148,148,0,0,73
"7244","RMDQ6_v1","RMDQ5_v1",0.947368421052632,1.34558574394274e-30,57,164,145,19,3,54
"7245","RMDQ7_v1","RMDQ5_v1",0.897435897435897,5.94979007433809e-17,39,181,144,37,4,35
"7246","RMDQ8_v1","RMDQ5_v1",1,3.61221198710401e-05,8,212,148,64,0,8
"7247","RMDQ9_v1","RMDQ5_v1",0.941176470588235,1.06788944634653e-16,34,186,146,40,2,32
"7248","RMDQ10_v1","RMDQ5_v1",0.85,6.73108324199017e-15,40,180,142,38,6,34
"7249","RMDQ11_v1","RMDQ5_v1",0.904761904761905,7.48857863041968e-19,42,178,144,34,4,38
"7250","RMDQ12_v1","RMDQ5_v1",0.863636363636364,2.30144275281162e-17,44,176,142,34,6,38
"7251","RMDQ13_v1","RMDQ5_v1",0.782608695652174,1.35462118744328e-13,46,174,138,36,10,36
"7252","RMDQ14_v1","RMDQ5_v1",0.755102040816326,4.50404679452514e-13,49,171,136,35,12,37
"7253","RMDQ15_v1","RMDQ5_v1",0.870967741935484,3.38998765801881e-12,31,189,144,45,4,27
"7254","RMDQ16_v1","RMDQ5_v1",0.864864864864865,2.15101371218421e-14,37,183,143,40,5,32
"7255","RMDQ17_v1","RMDQ5_v1",0.836734693877551,6.64752924286541e-18,49,171,140,31,8,41
"7256","RMDQ18_v1","RMDQ5_v1",0.916666666666667,1.70641682108911e-16,36,184,145,39,3,33
"7257","RMDQ19_v1","RMDQ5_v1",0.96875,5.96423312338212e-17,32,188,147,41,1,31
"7258","RMDQ20_v1","RMDQ5_v1",0.894736842105263,2.47371595353761e-16,38,182,144,38,4,34
"7259","RMDQ21_v1","RMDQ5_v1",0.875,5.87766115702892e-20,48,172,142,30,6,42
"7260","RMDQ22_v1","RMDQ5_v1",1,2.55197534833148e-22,38,182,148,34,0,38
"7261","RMDQ23_v1","RMDQ5_v1",0.918918918918919,4.11481526565052e-17,37,183,145,38,3,34
"7262","RMDQ24_v1","RMDQ5_v1",0.971428571428571,8.23563250271037e-19,35,185,147,38,1,34
"7263","DN4 - Queimação","RMDQ5_v1",0.35,0.466437351380103,100,109,76,33,65,35
"7264","DN4 - Sensação de frio dolorosa","RMDQ5_v1",0.340425531914894,0.580504516566278,47,161,113,48,31,16
"7265","DN4 - Choque elétrico","RMDQ5_v1",0.283333333333333,0.463313617812442,60,152,101,51,43,17
"7266","DN4 - Formigamento","RMDQ5_v1",0.285714285714286,0.512537717775224,56,156,104,52,40,16
"7267","DN4 - Alfinetada e agulhada","RMDQ5_v1",0.419354838709677,0.047995803762316,62,150,108,42,36,26
"7268","DN4 - Adormecimento","RMDQ5_v1",0.440677966101695,0.0256343629274268,59,150,108,42,33,26
"7269","DN4 - Coceira","RMDQ5_v1",0.272727272727273,0.725982954394664,11,201,136,65,8,3
"7270","DH4 - Hipoestesia ao toque","RMDQ5_v1",0.571428571428571,0.148475296901625,7,205,141,64,3,4
"7271","DN4 - Hipoestesia a picada de agulha","RMDQ5_v1",0.571428571428571,0.148475296901625,7,205,141,64,3,4
"7272","DN4 - Escovação","RMDQ5_v1",0.666666666666667,0.0655458709319826,6,206,142,64,2,4
"7273","Fuma","RMDQ6_v1",0.361111111111111,0.126703511190992,36,148,113,35,23,13
"7274","Cirurgia na coluna","RMDQ6_v1",0.27536231884058,0.545564242361793,69,127,97,30,50,19
"7275","Aposentado","RMDQ6_v1",0.323529411764706,0.403116298009275,34,150,112,38,23,11
"7276","Desempregado","RMDQ6_v1",0.230769230769231,0.60767039152446,26,154,111,43,20,6
"7277","Licenca_Medica","RMDQ6_v1",0.210526315789474,0.542133963304453,19,163,118,45,15,4
"7278","Aposentado_Invalidez","RMDQ6_v1",0.5,0.15112853728011,8,172,126,46,4,4
"7279","Analgésicos","RMDQ6_v1",0.295774647887324,0.0439931173903649,142,57,48,9,100,42
"7280","OutraDoenca","RMDQ6_v1",0.328947368421053,0.0926693739313007,76,114,89,25,51,25
"7281","Dor nas costas","RMDQ6_v1",0.298387096774194,0.0412921038496754,124,67,56,11,87,37
"7282","Dor nas pernas","RMDQ6_v1",0.276923076923077,0.599647884962992,65,124,94,30,47,18
"7283","Retornar_trabalho","RMDQ6_v1",0.45,0.0346690099072591,20,168,129,39,11,9
"7284","Masc","RMDQ6_v1",0.266666666666667,0.665686296372905,150,71,54,17,110,40
"7285","Fem","RMDQ6_v1",0.23943661971831,0.665686296372905,71,150,110,40,54,17
"7286","Casado/Amasiaado","RMDQ6_v1",0.271604938271605,0.798616793856344,81,102,76,26,59,22
"7287","Solteiro","RMDQ6_v1",0.213333333333333,0.209561553877755,75,108,76,32,59,16
"7288","Separado_Divorciado","RMDQ6_v1",0.25,0.935566202781219,8,175,129,46,6,2
"7289","X4","RMDQ6_v1",0,0.297705426781462,3,180,132,48,3,0
"7290","X5","RMDQ6_v1",0.25,0.954925294150218,4,179,132,47,3,1
"7291","X6","RMDQ6_v1",0.583333333333333,0.00891224466223994,12,171,130,41,5,7
"7292","Livrar_costas","RMDQ6_v1",0.277777777777778,0.445713397608081,108,16,13,3,78,30
"7293","Livrar_perna","RMDQ6_v1",0.214285714285714,0.64119291265472,14,110,80,30,11,3
"7294","Livrar_perda_sens","RMDQ6_v1",0,0.390570714659516,2,122,89,33,2,0
"7295","D1","RMDQ6_v1",0,0.566468281116867,1,117,88,29,1,0
"7296","D15","RMDQ6_v1",0.142857142857143,0.514393596899754,7,111,83,28,6,1
"7297","D16","RMDQ6_v1",0.5,0.00375775691349187,20,98,79,19,10,10
"7298","D17","RMDQ6_v1",0,0.192117716744612,5,113,84,29,5,0
"7299","D18","RMDQ6_v1",0.307692307692308,0.582456953374208,13,105,80,25,9,4
"7300","D19","RMDQ6_v1",0.333333333333333,0.60907649294245,6,112,85,27,4,2
"7301","D2","RMDQ6_v1",0.375,0.379207441847455,8,110,84,26,5,3
"7302","D20","RMDQ6_v1",0.285714285714286,0.8001646885775,7,111,84,27,5,2
"7303","D21","RMDQ6_v1",0.285714285714286,0.8001646885775,7,111,84,27,5,2
"7304","D22","RMDQ6_v1",1,0.0785236958912466,1,117,89,28,0,1
"7305","D23","RMDQ6_v1",0,0.415530488075431,2,116,87,29,2,0
"7306","D24","RMDQ6_v1",0.0833333333333333,0.0383787700472785,24,94,67,27,22,2
"7307","D25","RMDQ6_v1",0,0.316578729661288,3,115,86,29,3,0
"7308","D26","RMDQ6_v1",0.5,0.399633662575936,2,116,88,28,1,1
"7309","D27","RMDQ6_v1",0.5,0.229533656665443,4,114,87,27,2,2
"7310","D28","RMDQ6_v1",0.4,0.413022811044145,5,113,86,27,3,2
"7311","D29","RMDQ6_v1",0.333333333333333,0.100486495604777,42,76,61,15,28,14
"7312","D3","RMDQ6_v1",0.5,0.399633662575936,2,116,88,28,1,1
"7313","Lombalgia","RMDQ6_v1",0.32258064516129,0.0414143166396466,62,56,47,9,42,20
"7314","D31","RMDQ6_v1",0.176470588235294,0.473213640547643,17,101,75,26,14,3
"7315","D32","RMDQ6_v1",0.351351351351351,0.0717742484575685,37,81,65,16,24,13
"7316","D33","RMDQ6_v1",0.0833333333333333,0.16792704685569,12,106,78,28,11,1
"7317","D34","RMDQ6_v1",0.5,0.399633662575936,2,116,88,28,1,1
"7318","D35","RMDQ6_v1",1,0.0785236958912466,1,117,89,28,0,1
"7319","D36","RMDQ6_v1",0,0.119433106213211,7,111,82,29,7,0
"7320","D37","RMDQ6_v1",0.476190476190476,0.00682783619766193,21,97,78,19,11,10
"7321","D38","RMDQ6_v1",0,0.316578729661288,3,115,86,29,3,0
"7322","D39","RMDQ6_v1",0.571428571428571,0.00257207129991767,14,104,83,21,6,8
"7323","D4","RMDQ6_v1",0.666666666666667,0.0863020835729633,3,115,88,27,1,2
"7324","D40","RMDQ6_v1",0,0.192117716744612,5,113,84,29,5,0
"7325","D41","RMDQ6_v1",0.142857142857143,0.514393596899754,7,111,83,28,6,1
"7326","D42","RMDQ6_v1",0.5,0.399633662575936,2,116,88,28,1,1
"7327","D43","RMDQ6_v1",1,0.0124631786329641,2,116,89,27,0,2
"7328","D44","RMDQ6_v1",0.297297297297297,0.379514006202056,37,81,63,18,26,11
"7329","D45","RMDQ6_v1",0.0833333333333333,0.16792704685569,12,106,78,28,11,1
"7330","D46","RMDQ6_v1",0.324324324324324,0.180352737383203,37,81,64,17,25,12
"7331","D47","RMDQ6_v1",0.166666666666667,0.501926231189993,12,106,79,27,10,2
"7332","D48","RMDQ6_v1",0.346153846153846,0.178130556434573,26,92,72,20,17,9
"7333","D49","RMDQ6_v1",0.0769230769230769,0.133892609362277,13,105,77,28,12,1
"7334","D5","RMDQ6_v1",0.333333333333333,0.721195830689568,3,115,87,28,2,1
"7335","D50","RMDQ6_v1",0,0.566468281116867,1,117,88,29,1,0
"7336","D51","RMDQ6_v1",1,0.0785236958912466,1,117,89,28,0,1
"7337","D52","RMDQ6_v1",0,0.566468281116867,1,117,88,29,1,0
"7338","D53","RMDQ6_v1",1,0.0785236958912466,1,117,89,28,0,1
"7339","D9","RMDQ6_v1",1,0.0785236958912466,1,117,89,28,0,1
"7340","RMDQ1_v1","RMDQ6_v1",0.352941176470588,0.0264557483071908,85,134,108,26,55,30
"7341","RMDQ2_v1","RMDQ6_v1",0.344444444444444,0.0353763368153779,90,129,104,25,59,31
"7342","RMDQ3_v1","RMDQ6_v1",0.6625,3.95177001935911e-25,80,141,137,4,27,53
"7343","RMDQ4_v1","RMDQ6_v1",0.581818181818182,2.36888292597745e-10,55,166,141,25,23,32
"7344","RMDQ5_v1","RMDQ6_v1",0.73972602739726,1.34558574394274e-30,73,148,145,3,19,54
"7345","RMDQ6_v1","RMDQ6_v1",1,5.4734390981178e-50,57,164,164,0,0,57
"7346","RMDQ7_v1","RMDQ6_v1",0.846153846153846,8.70464760196738e-21,39,181,158,23,6,33
"7347","RMDQ8_v1","RMDQ6_v1",0.875,4.06104550807512e-05,8,212,163,49,1,7
"7348","RMDQ9_v1","RMDQ6_v1",0.970588235294118,1.92401364300004e-25,34,186,163,23,1,33
"7349","RMDQ10_v1","RMDQ6_v1",0.875,2.30046124551526e-23,40,180,159,21,5,35
"7350","RMDQ11_v1","RMDQ6_v1",0.928571428571429,7.29724459206877e-29,42,178,161,17,3,39
"7351","RMDQ12_v1","RMDQ6_v1",0.886363636363636,5.50913333201881e-27,44,176,159,17,5,39
"7352","RMDQ13_v1","RMDQ6_v1",0.804347826086957,6.23262409158129e-22,46,174,155,19,9,37
"7353","RMDQ14_v1","RMDQ6_v1",0.693877551020408,1.1681741522927e-15,49,171,149,22,15,34
"7354","RMDQ15_v1","RMDQ6_v1",0.870967741935484,1.88715666965384e-17,31,189,160,29,4,27
"7355","RMDQ16_v1","RMDQ6_v1",0.891891891891892,1.70176558457016e-22,37,183,160,23,4,33
"7356","RMDQ17_v1","RMDQ6_v1",0.795918367346939,5.74846908770791e-23,49,171,154,17,10,39
"7357","RMDQ18_v1","RMDQ6_v1",0.916666666666667,2.01386881098122e-23,36,184,161,23,3,33
"7358","RMDQ19_v1","RMDQ6_v1",0.96875,1.08997105246467e-23,32,188,163,25,1,31
"7359","RMDQ20_v1","RMDQ6_v1",0.973684210526316,4.6219951348945e-29,38,182,163,19,1,37
"7360","RMDQ21_v1","RMDQ6_v1",0.729166666666667,1.37369259993242e-17,48,172,151,21,13,35
"7361","RMDQ22_v1","RMDQ6_v1",1,4.20211794682366e-31,38,182,164,18,0,38
"7362","RMDQ23_v1","RMDQ6_v1",0.918918918918919,2.64465390003181e-24,37,183,161,22,3,34
"7363","RMDQ24_v1","RMDQ6_v1",1,2.43765345961036e-28,35,185,164,21,0,35
"7364","DN4 - Queimação","RMDQ6_v1",0.24,0.896901661150236,100,109,82,27,76,24
"7365","DN4 - Sensação de frio dolorosa","RMDQ6_v1",0.25531914893617,0.584376565461367,47,161,126,35,35,12
"7366","DN4 - Choque elétrico","RMDQ6_v1",0.233333333333333,0.876981982189141,60,152,115,37,46,14
"7367","DN4 - Formigamento","RMDQ6_v1",0.267857142857143,0.577524443925025,56,156,120,36,41,15
"7368","DN4 - Alfinetada e agulhada","RMDQ6_v1",0.370967741935484,0.00429183596148837,62,150,122,28,39,23
"7369","DN4 - Adormecimento","RMDQ6_v1",0.372881355932203,0.0065228926516506,59,150,121,29,37,22
"7370","DN4 - Coceira","RMDQ6_v1",0.272727272727273,0.797724578374081,11,201,153,48,8,3
"7371","DH4 - Hipoestesia ao toque","RMDQ6_v1",0.571428571428571,0.0372791334115866,7,205,158,47,3,4
"7372","DN4 - Hipoestesia a picada de agulha","RMDQ6_v1",0.571428571428571,0.0372791334115866,7,205,158,47,3,4
"7373","DN4 - Escovação","RMDQ6_v1",0.666666666666667,0.0132420038532461,6,206,159,47,2,4
"7374","Fuma","RMDQ7_v1",0.333333333333333,0.0155892967516733,36,147,124,23,24,12
"7375","Cirurgia na coluna","RMDQ7_v1",0.191176470588235,0.45509881513079,68,127,108,19,55,13
"7376","Aposentado","RMDQ7_v1",0.212121212121212,0.599782928377044,33,150,124,26,26,7
"7377","Desempregado","RMDQ7_v1",0.192307692307692,0.909971950371168,26,153,125,28,21,5
"7378","Licenca_Medica","RMDQ7_v1",0.157894736842105,0.770690562200125,19,162,132,30,16,3
"7379","Aposentado_Invalidez","RMDQ7_v1",0.5,0.0184963401733147,8,171,142,29,4,4
"7380","Analgésicos","RMDQ7_v1",0.226950354609929,0.00960630295187735,141,57,53,4,109,32
"7381","OutraDoenca","RMDQ7_v1",0.226666666666667,0.233740762886372,75,114,96,18,58,17
"7382","Dor nas costas","RMDQ7_v1",0.227642276422764,0.0176626439468487,123,67,61,6,95,28
"7383","Dor nas pernas","RMDQ7_v1",0.230769230769231,0.196112821438704,65,123,104,19,50,15
"7384","Retornar_trabalho","RMDQ7_v1",0.315789473684211,0.110178653160073,19,168,140,28,13,6
"7385","Masc","RMDQ7_v1",0.181208053691275,0.824769269525231,149,71,59,12,122,27
"7386","Fem","RMDQ7_v1",0.169014084507042,0.824769269525231,71,149,122,27,59,12
"7387","Casado/Amasiaado","RMDQ7_v1",0.197530864197531,0.611193575320539,81,101,84,17,65,16
"7388","Solteiro","RMDQ7_v1",0.16,0.531993687594629,75,107,86,21,63,12
"7389","Separado_Divorciado","RMDQ7_v1",0,0.20416192016128,7,175,142,33,7,0
"7390","X4","RMDQ7_v1",0,0.411118020233273,3,179,146,33,3,0
"7391","X5","RMDQ7_v1",0.25,0.718466846384741,4,178,146,32,3,1
"7392","X6","RMDQ7_v1",0.333333333333333,0.157305331985917,12,170,141,29,8,4
"7393","Livrar_costas","RMDQ7_v1",0.224299065420561,0.36421929783921,107,16,14,2,83,24
"7394","Livrar_perna","RMDQ7_v1",0.142857142857143,0.504714328746874,14,109,85,24,12,2
"7395","Livrar_perda_sens","RMDQ7_v1",0,0.460391234966393,2,121,95,26,2,0
"7396","D1","RMDQ7_v1",0,0.648368667298824,1,116,96,20,1,0
"7397","D15","RMDQ7_v1",0.142857142857143,0.838703911858419,7,110,91,19,6,1
"7398","D16","RMDQ7_v1",0.3,0.0922146018040814,20,97,83,14,14,6
"7399","D17","RMDQ7_v1",0.2,0.859964262675104,5,112,93,19,4,1
"7400","D18","RMDQ7_v1",0.307692307692308,0.164769724203116,13,104,88,16,9,4
"7401","D19","RMDQ7_v1",0.333333333333333,0.277999040548378,6,111,93,18,4,2
"7402","D2","RMDQ7_v1",0.5,0.0104238620744466,8,109,93,16,4,4
"7403","D20","RMDQ7_v1",0.142857142857143,0.838703911858419,7,110,91,19,6,1
"7404","D21","RMDQ7_v1",0.285714285714286,0.405461680142142,7,110,92,18,5,2
"7405","D22","RMDQ7_v1",0,0.648368667298824,1,116,96,20,1,0
"7406","D23","RMDQ7_v1",0,0.517165263403425,2,115,95,20,2,0
"7407","D24","RMDQ7_v1",0.125,0.502503786304834,24,93,76,17,21,3
"7408","D25","RMDQ7_v1",0,0.425587509741219,3,114,94,20,3,0
"7409","D26","RMDQ7_v1",0,0.517165263403425,2,115,95,20,2,0
"7410","D27","RMDQ7_v1",0.5,0.0752615085065314,4,113,95,18,2,2
"7411","D28","RMDQ7_v1",0.4,0.164346148470325,5,112,94,18,3,2
"7412","D29","RMDQ7_v1",0.214285714285714,0.351335992977655,42,75,64,11,33,9
"7413","D3","RMDQ7_v1",0.5,0.212447592946906,2,115,96,19,1,1
"7414","Lombalgia","RMDQ7_v1",0.213114754098361,0.205966241630309,61,56,49,7,48,13
"7415","D31","RMDQ7_v1",0.176470588235294,0.947761616195463,17,100,83,17,14,3
"7416","D32","RMDQ7_v1",0.27027027027027,0.0522641699448741,37,80,70,10,27,10
"7417","D33","RMDQ7_v1",0.0833333333333333,0.394788570407184,12,105,86,19,11,1
"7418","D34","RMDQ7_v1",0.5,0.212447592946906,2,115,96,19,1,1
"7419","D35","RMDQ7_v1",1,0.0269843768229582,1,116,97,19,0,1
"7420","D36","RMDQ7_v1",0,0.215341871421237,7,110,90,20,7,0
"7421","D37","RMDQ7_v1",0.285714285714286,0.122977375694485,21,96,82,14,15,6
"7422","D38","RMDQ7_v1",0,0.425587509741219,3,114,94,20,3,0
"7423","D39","RMDQ7_v1",0.285714285714286,0.224055629733022,14,103,87,16,10,4
"7424","D4","RMDQ7_v1",0.666666666666667,0.0208539320778979,3,114,96,18,1,2
"7425","D40","RMDQ7_v1",0,0.29938055120971,5,112,92,20,5,0
"7426","D41","RMDQ7_v1",0.142857142857143,0.838703911858419,7,110,91,19,6,1
"7427","D42","RMDQ7_v1",0.5,0.212447592946906,2,115,96,19,1,1
"7428","D43","RMDQ7_v1",0.5,0.212447592946906,2,115,96,19,1,1
"7429","D44","RMDQ7_v1",0.216216216216216,0.376311582115925,37,80,68,12,29,8
"7430","D45","RMDQ7_v1",0.166666666666667,0.966888916247175,12,105,87,18,10,2
"7431","D46","RMDQ7_v1",0.243243243243243,0.157705102959809,37,80,69,11,28,9
"7432","D47","RMDQ7_v1",0.25,0.442520223632859,12,105,88,17,9,3
"7433","D48","RMDQ7_v1",0.192307692307692,0.742783600553943,26,91,76,15,21,5
"7434","D49","RMDQ7_v1",0.153846153846154,0.862139817963145,13,104,86,18,11,2
"7435","D5","RMDQ7_v1",0.666666666666667,0.0208539320778979,3,114,96,18,1,2
"7436","D50","RMDQ7_v1",0,0.648368667298824,1,116,96,20,1,0
"7437","D51","RMDQ7_v1",1,0.0269843768229582,1,116,97,19,0,1
"7438","D52","RMDQ7_v1",1,0.0269843768229582,1,116,97,19,0,1
"7439","D53","RMDQ7_v1",1,0.0269843768229582,1,116,97,19,0,1
"7440","D9","RMDQ7_v1",1,0.0269843768229582,1,116,97,19,0,1
"7441","RMDQ1_v1","RMDQ7_v1",0.388235294117647,6.58361960131162e-10,85,134,128,6,52,33
"7442","RMDQ2_v1","RMDQ7_v1",0.388888888888889,6.97704241388092e-11,90,129,125,4,55,35
"7443","RMDQ3_v1","RMDQ7_v1",0.430379746835443,1.86429770521999e-13,79,141,136,5,45,34
"7444","RMDQ4_v1","RMDQ7_v1",0.185185185185185,0.860864600166572,54,166,137,29,44,10
"7445","RMDQ5_v1","RMDQ7_v1",0.486111111111111,5.94979007433809e-17,72,148,144,4,37,35
"7446","RMDQ6_v1","RMDQ7_v1",0.589285714285714,8.70464760196738e-21,56,164,158,6,23,33
"7447","RMDQ7_v1","RMDQ7_v1",1,9.04447975804488e-50,39,181,181,0,0,39
"7448","RMDQ8_v1","RMDQ7_v1",1,5.39386623647874e-10,8,212,181,31,0,8
"7449","RMDQ9_v1","RMDQ7_v1",0.970588235294118,1.25173624461053e-39,34,186,180,6,1,33
"7450","RMDQ10_v1","RMDQ7_v1",0.825,1.93251410019288e-32,40,180,174,6,7,33
"7451","RMDQ11_v1","RMDQ7_v1",0.785714285714286,1.68632370136105e-30,42,178,172,6,9,33
"7452","RMDQ12_v1","RMDQ7_v1",0.818181818181818,1.47080352648302e-35,44,176,173,3,8,36
"7453","RMDQ13_v1","RMDQ7_v1",0.717391304347826,4.01355679415581e-27,46,174,168,6,13,33
"7454","RMDQ14_v1","RMDQ7_v1",0.714285714285714,6.06931963566391e-29,49,171,167,4,14,35
"7455","RMDQ15_v1","RMDQ7_v1",0.870967741935484,1.0166500250513e-27,31,189,177,12,4,27
"7456","RMDQ16_v1","RMDQ7_v1",0.864864864864865,3.22770470404949e-33,37,183,176,7,5,32
"7457","RMDQ17_v1","RMDQ7_v1",0.63265306122449,2.86539143881379e-21,49,171,163,8,18,31
"7458","RMDQ18_v1","RMDQ7_v1",0.861111111111111,7.24419482876699e-32,36,184,176,8,5,31
"7459","RMDQ19_v1","RMDQ7_v1",0.96875,7.41541968676058e-37,32,188,180,8,1,31
"7460","RMDQ20_v1","RMDQ7_v1",0.868421052631579,1.38533765590654e-34,38,182,176,6,5,33
"7461","RMDQ21_v1","RMDQ7_v1",0.6875,1.20598091840535e-25,48,172,166,6,15,33
"7462","RMDQ22_v1","RMDQ7_v1",0.842105263157895,3.96817775660089e-32,38,182,175,7,6,32
"7463","RMDQ23_v1","RMDQ7_v1",0.864864864864865,3.22770470404949e-33,37,183,176,7,5,32
"7464","RMDQ24_v1","RMDQ7_v1",0.942857142857143,2.92654056250376e-38,35,185,179,6,2,33
"7465","DN4 - Queimação","RMDQ7_v1",0.17,0.934274867763459,100,109,90,19,83,17
"7466","DN4 - Sensação de frio dolorosa","RMDQ7_v1",0.0638297872340425,0.0244347864127157,47,161,128,33,44,3
"7467","DN4 - Choque elétrico","RMDQ7_v1",0.15,0.629319679842136,60,152,125,27,51,9
"7468","DN4 - Formigamento","RMDQ7_v1",0.125,0.29780330905441,56,156,127,29,49,7
"7469","DN4 - Alfinetada e agulhada","RMDQ7_v1",0.290322580645161,0.0026600662266838,62,150,132,18,44,18
"7470","DN4 - Adormecimento","RMDQ7_v1",0.23728813559322,0.11835531946683,59,150,128,22,45,14
"7471","DN4 - Coceira","RMDQ7_v1",0.272727272727273,0.350492102089586,11,201,168,33,8,3
"7472","DH4 - Hipoestesia ao toque","RMDQ7_v1",0.571428571428571,0.00400290344824931,7,205,173,32,3,4
"7473","DN4 - Hipoestesia a picada de agulha","RMDQ7_v1",0.571428571428571,0.00400290344824931,7,205,173,32,3,4
"7474","DN4 - Escovação","RMDQ7_v1",0.666666666666667,0.00100803164363727,6,206,174,32,2,4
"7475","Fuma","RMDQ8_v1",0.111111111111111,0.0273381213191091,36,147,143,4,32,4
"7476","Cirurgia na coluna","RMDQ8_v1",0.0588235294117647,0.207945629010943,68,127,124,3,64,4
"7477","Aposentado","RMDQ8_v1",0.0909090909090909,0.143044114661345,33,150,145,5,30,3
"7478","Desempregado","RMDQ8_v1",0,0.232897378529783,26,153,145,8,26,0
"7479","Licenca_Medica","RMDQ8_v1",0.0526315789473684,0.85006787188331,19,162,155,7,18,1
"7480","Aposentado_Invalidez","RMDQ8_v1",0,0.531365937649463,8,171,163,8,8,0
"7481","Analgésicos","RMDQ8_v1",0.049645390070922,0.298951634436328,141,57,56,1,134,7
"7482","OutraDoenca","RMDQ8_v1",0.08,0.0369392541349894,75,114,112,2,69,6
"7483","Dor nas costas","RMDQ8_v1",0.0569105691056911,0.168562916891474,123,67,66,1,116,7
"7484","Dor nas pernas","RMDQ8_v1",0.0461538461538462,0.858877036374012,65,123,118,5,62,3
"7485","Retornar_trabalho","RMDQ8_v1",0.105263157894737,0.155624355704656,19,168,162,6,17,2
"7486","Masc","RMDQ8_v1",0.0335570469798658,0.747335802149721,149,71,68,3,144,5
"7487","Fem","RMDQ8_v1",0.0422535211267606,0.747335802149721,71,149,144,5,68,3
"7488","Casado/Amasiaado","RMDQ8_v1",0.037037037037037,0.683444070485744,81,101,96,5,78,3
"7489","Solteiro","RMDQ8_v1",0.0533333333333333,0.605394615032179,75,107,103,4,71,4
"7490","Separado_Divorciado","RMDQ8_v1",0,0.562897201280188,7,175,167,8,7,0
"7491","X4","RMDQ8_v1",0,0.708039827186728,3,179,171,8,3,0
"7492","X5","RMDQ8_v1",0,0.664552260223522,4,178,170,8,4,0
"7493","X6","RMDQ8_v1",0.0833333333333333,0.49114246192435,12,170,163,7,11,1
"7494","Livrar_costas","RMDQ8_v1",0.0654205607476635,0.29210506754582,107,16,16,0,100,7
"7495","Livrar_perna","RMDQ8_v1",0,0.32887120486905,14,109,102,7,14,0
"7496","Livrar_perda_sens","RMDQ8_v1",0,0.726140948600676,2,121,114,7,2,0
"7497","D1","RMDQ8_v1",0,0.850129340451501,1,116,112,4,1,0
"7498","D15","RMDQ8_v1",0,0.607687652229803,7,110,106,4,7,0
"7499","D16","RMDQ8_v1",0,0.355441049039986,20,97,93,4,20,0
"7500","D17","RMDQ8_v1",0,0.667201950354723,5,112,108,4,5,0
"7501","D18","RMDQ8_v1",0.0769230769230769,0.368444225205557,13,104,101,3,12,1
"7502","D19","RMDQ8_v1",0,0.636106947053544,6,111,107,4,6,0
"7503","D2","RMDQ8_v1",0.125,0.143061967523735,8,109,106,3,7,1
"7504","D20","RMDQ8_v1",0,0.607687652229803,7,110,106,4,7,0
"7505","D21","RMDQ8_v1",0,0.607687652229803,7,110,106,4,7,0
"7506","D22","RMDQ8_v1",0,0.850129340451501,1,116,112,4,1,0
"7507","D23","RMDQ8_v1",0,0.788407006817525,2,115,111,4,2,0
"7508","D24","RMDQ8_v1",0.0416666666666667,0.821085032375238,24,93,90,3,23,1
"7509","D25","RMDQ8_v1",0,0.741297764641791,3,114,110,4,3,0
"7510","D26","RMDQ8_v1",0,0.788407006817525,2,115,111,4,2,0
"7511","D27","RMDQ8_v1",0.25,0.0156492038886713,4,113,110,3,3,1
"7512","D28","RMDQ8_v1",0.2,0.0370277526940214,5,112,109,3,4,1
"7513","D29","RMDQ8_v1",0.0238095238095238,0.6438549649288,42,75,72,3,41,1
"7514","D3","RMDQ8_v1",0,0.788407006817525,2,115,111,4,2,0
"7515","Lombalgia","RMDQ8_v1",0.0491803278688525,0.351633021218575,61,56,55,1,58,3
"7516","D31","RMDQ8_v1",0.0588235294117647,0.545419649321645,17,100,97,3,16,1
"7517","D32","RMDQ8_v1",0.027027027027027,0.771897165960905,37,80,77,3,36,1
"7518","D33","RMDQ8_v1",0,0.491461520297486,12,105,101,4,12,0
"7519","D34","RMDQ8_v1",0,0.788407006817525,2,115,111,4,2,0
"7520","D35","RMDQ8_v1",0,0.850129340451501,1,116,112,4,1,0
"7521","D36","RMDQ8_v1",0,0.607687652229803,7,110,106,4,7,0
"7522","D37","RMDQ8_v1",0,0.341185042678911,21,96,92,4,21,0
"7523","D38","RMDQ8_v1",0,0.741297764641791,3,114,110,4,3,0
"7524","D39","RMDQ8_v1",0,0.453080113817211,14,103,99,4,14,0
"7525","D4","RMDQ8_v1",0,0.741297764641791,3,114,110,4,3,0
"7526","D40","RMDQ8_v1",0,0.667201950354723,5,112,108,4,5,0
"7527","D41","RMDQ8_v1",0,0.607687652229803,7,110,106,4,7,0
"7528","D42","RMDQ8_v1",0,0.788407006817525,2,115,111,4,2,0
"7529","D43","RMDQ8_v1",0,0.788407006817525,2,115,111,4,2,0
"7530","D44","RMDQ8_v1",0.027027027027027,0.771897165960905,37,80,77,3,36,1
"7531","D45","RMDQ8_v1",0.0833333333333333,0.322672901837808,12,105,102,3,11,1
"7532","D46","RMDQ8_v1",0.027027027027027,0.771897165960905,37,80,77,3,36,1
"7533","D47","RMDQ8_v1",0.0833333333333333,0.322672901837808,12,105,102,3,11,1
"7534","D48","RMDQ8_v1",0.0769230769230769,0.17390842717539,26,91,89,2,24,2
"7535","D49","RMDQ8_v1",0.0769230769230769,0.368444225205557,13,104,101,3,12,1
"7536","D5","RMDQ8_v1",0.333333333333333,0.00386858247612339,3,114,111,3,2,1
"7537","D50","RMDQ8_v1",0,0.850129340451501,1,116,112,4,1,0
"7538","D51","RMDQ8_v1",0,0.850129340451501,1,116,112,4,1,0
"7539","D52","RMDQ8_v1",0,0.850129340451501,1,116,112,4,1,0
"7540","D53","RMDQ8_v1",0,0.850129340451501,1,116,112,4,1,0
"7541","D9","RMDQ8_v1",0,0.850129340451501,1,116,112,4,1,0
"7542","RMDQ1_v1","RMDQ8_v1",0.0470588235294118,0.787645961045798,85,134,130,4,81,4
"7543","RMDQ2_v1","RMDQ8_v1",0.0555555555555556,0.445689195666228,90,129,126,3,85,5
"7544","RMDQ3_v1","RMDQ8_v1",0.10126582278481,0.000118444481158393,79,141,141,0,71,8
"7545","RMDQ4_v1","RMDQ8_v1",0.12962962962963,2.49889128986684e-05,54,166,165,1,47,7
"7546","RMDQ5_v1","RMDQ8_v1",0.111111111111111,3.61221198710401e-05,72,148,148,0,64,8
"7547","RMDQ6_v1","RMDQ8_v1",0.125,4.06104550807512e-05,56,164,163,1,49,7
"7548","RMDQ7_v1","RMDQ8_v1",0.205128205128205,5.39386623647874e-10,39,181,181,0,31,8
"7549","RMDQ8_v1","RMDQ8_v1",1,9.04447975804475e-50,8,212,212,0,0,8
"7550","RMDQ9_v1","RMDQ8_v1",0.205882352941176,9.31378967761368e-09,34,186,185,1,27,7
"7551","RMDQ10_v1","RMDQ8_v1",0.175,2.23848400948438e-07,40,180,179,1,33,7
"7552","RMDQ11_v1","RMDQ8_v1",0.166666666666667,5.29719634896312e-07,42,178,177,1,35,7
"7553","RMDQ12_v1","RMDQ8_v1",0.159090909090909,1.160924040668e-06,44,176,175,1,37,7
"7554","RMDQ13_v1","RMDQ8_v1",0.152173913043478,2.37989535306747e-06,46,174,173,1,39,7
"7555","RMDQ14_v1","RMDQ8_v1",0.142857142857143,6.27400194866598e-06,49,171,170,1,42,7
"7556","RMDQ15_v1","RMDQ8_v1",0.129032258064516,0.00294189307973926,31,189,185,4,27,4
"7557","RMDQ16_v1","RMDQ8_v1",0.189189189189189,5.18254372179348e-08,37,183,182,1,30,7
"7558","RMDQ17_v1","RMDQ8_v1",0.142857142857143,6.27400194866598e-06,49,171,170,1,42,7
"7559","RMDQ18_v1","RMDQ8_v1",0.194444444444444,3.01749370049668e-08,36,184,183,1,29,7
"7560","RMDQ19_v1","RMDQ8_v1",0.21875,2.48801829643636e-09,32,188,187,1,25,7
"7561","RMDQ20_v1","RMDQ8_v1",0.184210526315789,8.65541275507187e-08,38,182,181,1,31,7
"7562","RMDQ21_v1","RMDQ8_v1",0.145833333333333,4.60170653811448e-06,48,172,171,1,41,7
"7563","RMDQ22_v1","RMDQ8_v1",0.184210526315789,8.65541275507187e-08,38,182,181,1,31,7
"7564","RMDQ23_v1","RMDQ8_v1",0.189189189189189,5.18254372179348e-08,37,183,182,1,30,7
"7565","RMDQ24_v1","RMDQ8_v1",0.2,1.704357034572e-08,35,185,184,1,28,7
"7566","DN4 - Queimação","RMDQ8_v1",0.01,0.0705946729285762,100,109,103,6,99,1
"7567","DN4 - Sensação de frio dolorosa","RMDQ8_v1",0,0.145895960672681,47,161,154,7,47,0
"7568","DN4 - Choque elétrico","RMDQ8_v1",0.0166666666666667,0.402503259502644,60,152,146,6,59,1
"7569","DN4 - Formigamento","RMDQ8_v1",0.0178571428571429,0.459169246624527,56,156,150,6,55,1
"7570","DN4 - Alfinetada e agulhada","RMDQ8_v1",0.112903225806452,2.8523454992126e-05,62,150,150,0,55,7
"7571","DN4 - Adormecimento","RMDQ8_v1",0.0508474576271186,0.381812300990245,59,150,146,4,56,3
"7572","DN4 - Coceira","RMDQ8_v1",0,0.529076219218887,11,201,194,7,11,0
"7573","DH4 - Hipoestesia ao toque","RMDQ8_v1",0,0.61906336739482,7,205,198,7,7,0
"7574","DN4 - Hipoestesia a picada de agulha","RMDQ8_v1",0,0.61906336739482,7,205,198,7,7,0
"7575","DN4 - Escovação","RMDQ8_v1",0,0.646105616644332,6,206,199,7,6,0
"7576","Fuma","RMDQ9_v1",0.277777777777778,0.0395332184219696,36,147,127,20,26,10
"7577","Cirurgia na coluna","RMDQ9_v1",0.191176470588235,0.16556191656699,68,127,112,15,55,13
"7578","Aposentado","RMDQ9_v1",0.151515151515152,0.979043887998176,33,150,127,23,28,5
"7579","Desempregado","RMDQ9_v1",0.153846153846154,0.968772513757998,26,153,129,24,22,4
"7580","Licenca_Medica","RMDQ9_v1",0.157894736842105,0.967491810108547,19,162,137,25,16,3
"7581","Aposentado_Invalidez","RMDQ9_v1",0.5,0.00619948306247476,8,171,147,24,4,4
"7582","Analgésicos","RMDQ9_v1",0.198581560283688,0.010501955672672,141,57,54,3,113,28
"7583","OutraDoenca","RMDQ9_v1",0.213333333333333,0.0956716871434678,75,114,100,14,59,16
"7584","Dor nas costas","RMDQ9_v1",0.195121951219512,0.0273418247313347,123,67,62,5,99,24
"7585","Dor nas pernas","RMDQ9_v1",0.215384615384615,0.0916200474716384,65,123,108,15,51,14
"7586","Retornar_trabalho","RMDQ9_v1",0.263157894736842,0.197998001862274,19,168,143,25,14,5
"7587","Masc","RMDQ9_v1",0.154362416107383,0.991318878305776,149,71,60,11,126,23
"7588","Fem","RMDQ9_v1",0.154929577464789,0.991318878305776,71,149,126,23,60,11
"7589","Casado/Amasiaado","RMDQ9_v1",0.185185185185185,0.393589890666139,81,101,87,14,66,15
"7590","Solteiro","RMDQ9_v1",0.133333333333333,0.422208472117945,75,107,88,19,65,10
"7591","Separado_Divorciado","RMDQ9_v1",0,0.24012341477796,7,175,146,29,7,0
"7592","X4","RMDQ9_v1",0,0.447035421800336,3,179,150,29,3,0
"7593","X5","RMDQ9_v1",0.25,0.616405875993634,4,178,150,28,3,1
"7594","X6","RMDQ9_v1",0.25,0.374619807629857,12,170,144,26,9,3
"7595","Livrar_costas","RMDQ9_v1",0.186915887850467,0.546677512023865,107,16,14,2,87,20
"7596","Livrar_perna","RMDQ9_v1",0.142857142857143,0.708837555071883,14,109,89,20,12,2
"7597","Livrar_perda_sens","RMDQ9_v1",0,0.505752825555412,2,121,99,22,2,0
"7598","D1","RMDQ9_v1",0,0.668479726871623,1,116,98,18,1,0
"7599","D15","RMDQ9_v1",0.142857142857143,0.933766669511119,7,110,93,17,6,1
"7600","D16","RMDQ9_v1",0.25,0.190553660220271,20,97,84,13,15,5
"7601","D17","RMDQ9_v1",0,0.329801954387474,5,112,94,18,5,0
"7602","D18","RMDQ9_v1",0.230769230769231,0.41488003047373,13,104,89,15,10,3
"7603","D19","RMDQ9_v1",0.166666666666667,0.928795596474829,6,111,94,17,5,1
"7604","D2","RMDQ9_v1",0.375,0.0724650214267889,8,109,94,15,5,3
"7605","D20","RMDQ9_v1",0.142857142857143,0.933766669511119,7,110,93,17,6,1
"7606","D21","RMDQ9_v1",0.142857142857143,0.933766669511119,7,110,93,17,6,1
"7607","D22","RMDQ9_v1",0,0.668479726871623,1,116,98,18,1,0
"7608","D23","RMDQ9_v1",0,0.543025813812971,2,115,97,18,2,0
"7609","D24","RMDQ9_v1",0.0416666666666667,0.0875526820172389,24,93,76,17,23,1
"7610","D25","RMDQ9_v1",0,0.454337365794028,3,114,96,18,3,0
"7611","D26","RMDQ9_v1",0,0.543025813812971,2,115,97,18,2,0
"7612","D27","RMDQ9_v1",0.5,0.0508821581424617,4,113,97,16,2,2
"7613","D28","RMDQ9_v1",0.4,0.118944180443227,5,112,96,16,3,2
"7614","D29","RMDQ9_v1",0.214285714285714,0.175118476880782,42,75,66,9,33,9
"7615","D3","RMDQ9_v1",0.5,0.17114046257831,2,115,98,17,1,1
"7616","Lombalgia","RMDQ9_v1",0.19672131147541,0.179747246137126,61,56,50,6,49,12
"7617","D31","RMDQ9_v1",0.176470588235294,0.779739960140811,17,100,85,15,14,3
"7618","D32","RMDQ9_v1",0.216216216216216,0.203508542098318,37,80,70,10,29,8
"7619","D33","RMDQ9_v1",0.0833333333333333,0.474829810654609,12,105,88,17,11,1
"7620","D34","RMDQ9_v1",0.5,0.17114046257831,2,115,98,17,1,1
"7621","D35","RMDQ9_v1",1,0.0185080139064539,1,116,99,17,0,1
"7622","D36","RMDQ9_v1",0,0.244629005571412,7,110,92,18,7,0
"7623","D37","RMDQ9_v1",0.238095238095238,0.23747929131637,21,96,83,13,16,5
"7624","D38","RMDQ9_v1",0,0.454337365794028,3,114,96,18,3,0
"7625","D39","RMDQ9_v1",0.214285714285714,0.504118685281497,14,103,88,15,11,3
"7626","D4","RMDQ9_v1",0.666666666666667,0.0126308285810314,3,114,98,16,1,2
"7627","D40","RMDQ9_v1",0,0.329801954387474,5,112,94,18,5,0
"7628","D41","RMDQ9_v1",0.142857142857143,0.933766669511119,7,110,93,17,6,1
"7629","D42","RMDQ9_v1",0,0.543025813812971,2,115,97,18,2,0
"7630","D43","RMDQ9_v1",0.5,0.17114046257831,2,115,98,17,1,1
"7631","D44","RMDQ9_v1",0.162162162162162,0.865364682224068,37,80,68,12,31,6
"7632","D45","RMDQ9_v1",0.0833333333333333,0.474829810654609,12,105,88,17,11,1
"7633","D46","RMDQ9_v1",0.189189189189189,0.471165458428779,37,80,69,11,30,7
"7634","D47","RMDQ9_v1",0.166666666666667,0.896617814475036,12,105,89,16,10,2
"7635","D48","RMDQ9_v1",0.153846153846154,1,26,91,77,14,22,4
"7636","D49","RMDQ9_v1",0.0769230769230769,0.41488003047373,13,104,87,17,12,1
"7637","D5","RMDQ9_v1",0.333333333333333,0.382715303047254,3,114,97,17,2,1
"7638","D50","RMDQ9_v1",0,0.668479726871623,1,116,98,18,1,0
"7639","D51","RMDQ9_v1",1,0.0185080139064539,1,116,99,17,0,1
"7640","D52","RMDQ9_v1",0,0.668479726871623,1,116,98,18,1,0
"7641","D53","RMDQ9_v1",1,0.0185080139064539,1,116,99,17,0,1
"7642","D9","RMDQ9_v1",1,0.0185080139064539,1,116,99,17,0,1
"7643","RMDQ1_v1","RMDQ9_v1",0.364705882352941,6.78569757203779e-11,85,134,131,3,54,31
"7644","RMDQ2_v1","RMDQ9_v1",0.333333333333333,8.07881001677841e-09,90,129,125,4,60,30
"7645","RMDQ3_v1","RMDQ9_v1",0.40506329113924,1.42042079788437e-14,79,141,139,2,47,32
"7646","RMDQ4_v1","RMDQ9_v1",0.203703703703704,0.249948124795998,54,166,143,23,43,11
"7647","RMDQ5_v1","RMDQ9_v1",0.444444444444444,1.06788944634653e-16,72,148,146,2,40,32
"7648","RMDQ6_v1","RMDQ9_v1",0.589285714285714,1.92401364300004e-25,56,164,163,1,23,33
"7649","RMDQ7_v1","RMDQ9_v1",0.846153846153846,1.25173624461053e-39,39,181,180,1,6,33
"7650","RMDQ8_v1","RMDQ9_v1",0.875,9.31378967761368e-09,8,212,185,27,1,7
"7651","RMDQ9_v1","RMDQ9_v1",1,9.04447975804488e-50,34,186,186,0,0,34
"7652","RMDQ10_v1","RMDQ9_v1",0.825,1.83787767560477e-38,40,180,179,1,7,33
"7653","RMDQ11_v1","RMDQ9_v1",0.785714285714286,2.70276201560039e-36,42,178,177,1,9,33
"7654","RMDQ12_v1","RMDQ9_v1",0.75,2.52908639173568e-34,44,176,175,1,11,33
"7655","RMDQ13_v1","RMDQ9_v1",0.717391304347826,1.59726362813938e-32,46,174,173,1,13,33
"7656","RMDQ14_v1","RMDQ9_v1",0.653061224489796,6.63947855075367e-28,49,171,169,2,17,32
"7657","RMDQ15_v1","RMDQ9_v1",0.870967741935484,1.10452378994493e-32,31,189,182,7,4,27
"7658","RMDQ16_v1","RMDQ9_v1",0.864864864864865,3.04597864637659e-39,37,183,181,2,5,32
"7659","RMDQ17_v1","RMDQ9_v1",0.63265306122449,8.47487722220644e-26,49,171,168,3,18,31
"7660","RMDQ18_v1","RMDQ9_v1",0.861111111111111,1.19896882997217e-37,36,184,181,3,5,31
"7661","RMDQ19_v1","RMDQ9_v1",0.96875,3.1920770092871e-43,32,188,185,3,1,31
"7662","RMDQ20_v1","RMDQ9_v1",0.868421052631579,7.40478349902737e-41,38,182,181,1,5,33
"7663","RMDQ21_v1","RMDQ9_v1",0.6875,7.15114298375069e-31,48,172,171,1,15,33
"7664","RMDQ22_v1","RMDQ9_v1",0.842105263157895,5.02330188683508e-38,38,182,180,2,6,32
"7665","RMDQ23_v1","RMDQ9_v1",0.864864864864865,3.04597864637659e-39,37,183,181,2,5,32
"7666","RMDQ24_v1","RMDQ9_v1",0.942857142857143,5.83329023750466e-45,35,185,184,1,2,33
"7667","DN4 - Queimação","RMDQ9_v1",0.14,0.745670586316139,100,109,92,17,86,14
"7668","DN4 - Sensação de frio dolorosa","RMDQ9_v1",0.0851063829787234,0.161847157985229,47,161,134,27,43,4
"7669","DN4 - Choque elétrico","RMDQ9_v1",0.116666666666667,0.4440860960561,60,152,128,24,53,7
"7670","DN4 - Formigamento","RMDQ9_v1",0.107142857142857,0.334564676943188,56,156,131,25,50,6
"7671","DN4 - Alfinetada e agulhada","RMDQ9_v1",0.241935483870968,0.0112243234722338,62,150,134,16,47,15
"7672","DN4 - Adormecimento","RMDQ9_v1",0.23728813559322,0.0232420322146906,59,150,133,17,45,14
"7673","DN4 - Coceira","RMDQ9_v1",0.272727272727273,0.222661254184648,11,201,173,28,8,3
"7674","DH4 - Hipoestesia ao toque","RMDQ9_v1",0.714285714285714,1.52096182008966e-05,7,205,179,26,2,5
"7675","DN4 - Hipoestesia a picada de agulha","RMDQ9_v1",0.571428571428571,0.00120451487286722,7,205,178,27,3,4
"7676","DN4 - Escovação","RMDQ9_v1",0.666666666666667,0.000252086995375938,6,206,179,27,2,4
"7677","Fuma","RMDQ10_v1",0.305555555555556,0.0517070262410556,36,147,123,24,25,11
"7678","Cirurgia na coluna","RMDQ10_v1",0.205882352941176,0.317886853296308,68,127,108,19,54,14
"7679","Aposentado","RMDQ10_v1",0.212121212121212,0.667541902034753,33,150,123,27,26,7
"7680","Desempregado","RMDQ10_v1",0.269230769230769,0.264936056633861,26,153,126,27,19,7
"7681","Licenca_Medica","RMDQ10_v1",0.210526315789474,0.789047381656993,19,162,132,30,15,4
"7682","Aposentado_Invalidez","RMDQ10_v1",0.5,0.0221722220036869,8,171,141,30,4,4
"7683","Analgésicos","RMDQ10_v1",0.234042553191489,0.00739991372741452,141,57,53,4,108,33
"7684","OutraDoenca","RMDQ10_v1",0.226666666666667,0.304088866143312,75,114,95,19,58,17
"7685","Dor nas costas","RMDQ10_v1",0.235772357723577,0.0129869015417078,123,67,61,6,94,29
"7686","Dor nas pernas","RMDQ10_v1",0.230769230769231,0.253431775477885,65,123,103,20,50,15
"7687","Retornar_trabalho","RMDQ10_v1",0.368421052631579,0.0401915700856117,19,168,139,29,12,7
"7688","Masc","RMDQ10_v1",0.181208053691275,0.972885024164127,149,71,58,13,122,27
"7689","Fem","RMDQ10_v1",0.183098591549296,0.972885024164127,71,149,122,27,58,13
"7690","Casado/Amasiaado","RMDQ10_v1",0.209876543209877,0.474675107950862,81,101,84,17,64,17
"7691","Solteiro","RMDQ10_v1",0.173333333333333,0.69607401441796,75,107,86,21,62,13
"7692","Separado_Divorciado","RMDQ10_v1",0,0.195933046727639,7,175,141,34,7,0
"7693","X4","RMDQ10_v1",0,0.402535206901696,3,179,145,34,3,0
"7694","X5","RMDQ10_v1",0.25,0.743020499647911,4,178,145,33,3,1
"7695","X6","RMDQ10_v1",0.25,0.561192441198149,12,170,139,31,9,3
"7696","Livrar_costas","RMDQ10_v1",0.233644859813084,0.327453638750848,107,16,14,2,82,25
"7697","Livrar_perna","RMDQ10_v1",0.142857142857143,0.461675099076693,14,109,84,25,12,2
"7698","Livrar_perda_sens","RMDQ10_v1",0,0.44954551242066,2,121,94,27,2,0
"7699","D1","RMDQ10_v1",0,0.628885363875848,1,116,94,22,1,0
"7700","D15","RMDQ10_v1",0.142857142857143,0.752394853272729,7,110,89,21,6,1
"7701","D16","RMDQ10_v1",0.25,0.436033107334636,20,97,80,17,15,5
"7702","D17","RMDQ10_v1",0,0.271414036674767,5,112,90,22,5,0
"7703","D18","RMDQ10_v1",0.384615384615385,0.0543559369541834,13,104,87,17,8,5
"7704","D19","RMDQ10_v1",0.333333333333333,0.349709263533331,6,111,91,20,4,2
"7705","D2","RMDQ10_v1",0.375,0.160865525892034,8,109,90,19,5,3
"7706","D20","RMDQ10_v1",0.285714285714286,0.495159471383125,7,110,90,20,5,2
"7707","D21","RMDQ10_v1",0.428571428571429,0.0930089772607866,7,110,91,19,4,3
"7708","D22","RMDQ10_v1",1,0.0368916317321308,1,116,95,21,0,1
"7709","D23","RMDQ10_v1",0.5,0.254752373169046,2,115,94,21,1,1
"7710","D24","RMDQ10_v1",0.0833333333333333,0.140918187032406,24,93,73,20,22,2
"7711","D25","RMDQ10_v1",0.333333333333333,0.514082165897887,3,114,93,21,2,1
"7712","D26","RMDQ10_v1",0.5,0.254752373169046,2,115,94,21,1,1
"7713","D27","RMDQ10_v1",0.75,0.00342370557055419,4,113,94,19,1,3
"7714","D28","RMDQ10_v1",0.6,0.0159705379392901,5,112,93,19,2,3
"7715","D29","RMDQ10_v1",0.214285714285714,0.586566166961994,42,75,62,13,33,9
"7716","D3","RMDQ10_v1",0.5,0.254752373169046,2,115,94,21,1,1
"7717","Lombalgia","RMDQ10_v1",0.245901639344262,0.0945435791383965,61,56,49,7,46,15
"7718","D31","RMDQ10_v1",0.176470588235294,0.894996496016723,17,100,81,19,14,3
"7719","D32","RMDQ10_v1",0.216216216216216,0.595724348514155,37,80,66,14,29,8
"7720","D33","RMDQ10_v1",0.166666666666667,0.8415073123212,12,105,85,20,10,2
"7721","D34","RMDQ10_v1",0.5,0.254752373169046,2,115,94,21,1,1
"7722","D35","RMDQ10_v1",1,0.0368916317321308,1,116,95,21,0,1
"7723","D36","RMDQ10_v1",0,0.189151958767347,7,110,88,22,7,0
"7724","D37","RMDQ10_v1",0.238095238095238,0.516883970539141,21,96,79,17,16,5
"7725","D38","RMDQ10_v1",0,0.398443266068114,3,114,92,22,3,0
"7726","D39","RMDQ10_v1",0.214285714285714,0.788760671232565,14,103,84,19,11,3
"7727","D4","RMDQ10_v1",0.666666666666667,0.031603186824878,3,114,94,20,1,2
"7728","D40","RMDQ10_v1",0,0.271414036674767,5,112,90,22,5,0
"7729","D41","RMDQ10_v1",0.142857142857143,0.752394853272729,7,110,89,21,6,1
"7730","D42","RMDQ10_v1",0.5,0.254752373169046,2,115,94,21,1,1
"7731","D43","RMDQ10_v1",1,0.00303457735757642,2,115,95,20,0,2
"7732","D44","RMDQ10_v1",0.162162162162162,0.626208269250909,37,80,64,16,31,6
"7733","D45","RMDQ10_v1",0.0833333333333333,0.327168795969465,12,105,84,21,11,1
"7734","D46","RMDQ10_v1",0.189189189189189,0.982651985520405,37,80,65,15,30,7
"7735","D47","RMDQ10_v1",0.166666666666667,0.8415073123212,12,105,85,20,10,2
"7736","D48","RMDQ10_v1",0.153846153846154,0.612942326761131,26,91,73,18,22,4
"7737","D49","RMDQ10_v1",0.153846153846154,0.737921701280218,13,104,84,20,11,2
"7738","D5","RMDQ10_v1",0.333333333333333,0.514082165897887,3,114,93,21,2,1
"7739","D50","RMDQ10_v1",0,0.628885363875848,1,116,94,22,1,0
"7740","D51","RMDQ10_v1",1,0.0368916317321308,1,116,95,21,0,1
"7741","D52","RMDQ10_v1",0,0.628885363875848,1,116,94,22,1,0
"7742","D53","RMDQ10_v1",1,0.0368916317321308,1,116,95,21,0,1
"7743","D9","RMDQ10_v1",1,0.0368916317321308,1,116,95,21,0,1
"7744","RMDQ1_v1","RMDQ10_v1",0.352941176470588,1.17754037412817e-06,85,134,124,10,55,30
"7745","RMDQ2_v1","RMDQ10_v1",0.366666666666667,2.50673127666809e-08,90,129,122,7,57,33
"7746","RMDQ3_v1","RMDQ10_v1",0.417721518987342,1.11696010371198e-11,79,141,134,7,46,33
"7747","RMDQ4_v1","RMDQ10_v1",0.259259259259259,0.0894013050729901,54,166,140,26,40,14
"7748","RMDQ5_v1","RMDQ10_v1",0.472222222222222,6.73108324199017e-15,72,148,142,6,38,34
"7749","RMDQ6_v1","RMDQ10_v1",0.625,2.30046124551526e-23,56,164,159,5,21,35
"7750","RMDQ7_v1","RMDQ10_v1",0.846153846153846,1.93251410019288e-32,39,181,174,7,6,33
"7751","RMDQ8_v1","RMDQ10_v1",0.875,2.23848400948438e-07,8,212,179,33,1,7
"7752","RMDQ9_v1","RMDQ10_v1",0.970588235294118,1.83787767560477e-38,34,186,179,7,1,33
"7753","RMDQ10_v1","RMDQ10_v1",1,9.04447975804488e-50,40,180,180,0,0,40
"7754","RMDQ11_v1","RMDQ10_v1",0.880952380952381,5.57324773652127e-39,42,178,175,3,5,37
"7755","RMDQ12_v1","RMDQ10_v1",0.795454545454545,3.94510314773932e-32,44,176,171,5,9,35
"7756","RMDQ13_v1","RMDQ10_v1",0.717391304347826,3.32034513985841e-26,46,174,167,7,13,33
"7757","RMDQ14_v1","RMDQ10_v1",0.73469387755102,5.17687226522671e-30,49,171,167,4,13,36
"7758","RMDQ15_v1","RMDQ10_v1",0.870967741935484,7.10532254706397e-27,31,189,176,13,4,27
"7759","RMDQ16_v1","RMDQ10_v1",0.864864864864865,3.41710399034611e-32,37,183,175,8,5,32
"7760","RMDQ17_v1","RMDQ10_v1",0.673469387755102,4.45683909243186e-24,49,171,164,7,16,33
"7761","RMDQ18_v1","RMDQ10_v1",0.972222222222222,3.29618584049123e-41,36,184,179,5,1,35
"7762","RMDQ19_v1","RMDQ10_v1",0.96875,8.97406152632487e-36,32,188,179,9,1,31
"7763","RMDQ20_v1","RMDQ10_v1",0.921052631578947,1.39594776624632e-38,38,182,177,5,3,35
"7764","RMDQ21_v1","RMDQ10_v1",0.770833333333333,5.3519458890139e-33,48,172,169,3,11,37
"7765","RMDQ22_v1","RMDQ10_v1",0.894736842105263,5.28115491603497e-36,38,182,176,6,4,34
"7766","RMDQ23_v1","RMDQ10_v1",1,1.92334772571708e-45,37,183,180,3,0,37
"7767","RMDQ24_v1","RMDQ10_v1",1,1.23678548857098e-42,35,185,180,5,0,35
"7768","DN4 - Queimação","RMDQ10_v1",0.14,0.496792633658893,100,109,90,19,86,14
"7769","DN4 - Sensação de frio dolorosa","RMDQ10_v1",0.127659574468085,0.508578174512341,47,161,134,27,41,6
"7770","DN4 - Choque elétrico","RMDQ10_v1",0.1,0.160171416672835,60,152,125,27,54,6
"7771","DN4 - Formigamento","RMDQ10_v1",0.160714285714286,0.903205654734907,56,156,132,24,47,9
"7772","DN4 - Alfinetada e agulhada","RMDQ10_v1",0.241935483870968,0.0259007596214018,62,150,132,18,47,15
"7773","DN4 - Adormecimento","RMDQ10_v1",0.23728813559322,0.0483694705066989,59,150,131,19,45,14
"7774","DN4 - Coceira","RMDQ10_v1",0.272727272727273,0.271376225839429,11,201,171,30,8,3
"7775","DH4 - Hipoestesia ao toque","RMDQ10_v1",0.571428571428571,0.00203122329892033,7,205,176,29,3,4
"7776","DN4 - Hipoestesia a picada de agulha","RMDQ10_v1",0.571428571428571,0.00203122329892033,7,205,176,29,3,4
"7777","DN4 - Escovação","RMDQ10_v1",0.666666666666667,0.000460768376442171,6,206,177,29,2,4
"7778","Fuma","RMDQ11_v1",0.305555555555556,0.0668261736475372,36,147,122,25,25,11
"7779","Cirurgia na coluna","RMDQ11_v1",0.220588235294118,0.273793510915317,68,127,107,20,53,15
"7780","Aposentado","RMDQ11_v1",0.212121212121212,0.736409983699538,33,150,122,28,26,7
"7781","Desempregado","RMDQ11_v1",0.230769230769231,0.62411264050878,26,153,124,29,20,6
"7782","Licenca_Medica","RMDQ11_v1",0.210526315789474,0.841366533014604,19,162,131,31,15,4
"7783","Aposentado_Invalidez","RMDQ11_v1",0.5,0.0309446301208362,8,171,139,32,4,4
"7784","Analgésicos","RMDQ11_v1",0.24113475177305,0.00567835904530934,141,57,53,4,107,34
"7785","OutraDoenca","RMDQ11_v1",0.253333333333333,0.145833663109846,75,114,95,19,56,19
"7786","Dor nas costas","RMDQ11_v1",0.235772357723577,0.0129869015417078,123,67,61,6,94,29
"7787","Dor nas pernas","RMDQ11_v1",0.246153846153846,0.124536027938523,65,123,104,19,49,16
"7788","Retornar_trabalho","RMDQ11_v1",0.368421052631579,0.0489688269629625,19,168,138,30,12,7
"7789","Masc","RMDQ11_v1",0.187919463087248,0.870165460476907,149,71,57,14,121,28
"7790","Fem","RMDQ11_v1",0.197183098591549,0.870165460476907,71,149,121,28,57,14
"7791","Casado/Amasiaado","RMDQ11_v1",0.222222222222222,0.458911585926666,81,101,83,18,63,18
"7792","Solteiro","RMDQ11_v1",0.173333333333333,0.487809980792072,75,107,84,23,62,13
"7793","Separado_Divorciado","RMDQ11_v1",0,0.180309835229217,7,175,139,36,7,0
"7794","X4","RMDQ11_v1",0,0.385804696018125,3,179,143,36,3,0
"7795","X5","RMDQ11_v1",0.25,0.791006762917235,4,178,143,35,3,1
"7796","X6","RMDQ11_v1",0.333333333333333,0.222651452609313,12,170,138,32,8,4
"7797","Livrar_costas","RMDQ11_v1",0.233644859813084,0.327453638750848,107,16,14,2,82,25
"7798","Livrar_perna","RMDQ11_v1",0.142857142857143,0.461675099076693,14,109,84,25,12,2
"7799","Livrar_perda_sens","RMDQ11_v1",0,0.44954551242066,2,121,94,27,2,0
"7800","D1","RMDQ11_v1",0,0.61934434211196,1,116,93,23,1,0
"7801","D15","RMDQ11_v1",0.142857142857143,0.712225217901405,7,110,88,22,6,1
"7802","D16","RMDQ11_v1",0.3,0.201198863190655,20,97,80,17,14,6
"7803","D17","RMDQ11_v1",0,0.258267411370114,5,112,89,23,5,0
"7804","D18","RMDQ11_v1",0.384615384615385,0.0703835877226248,13,104,86,18,8,5
"7805","D19","RMDQ11_v1",0.333333333333333,0.386838617744652,6,111,90,21,4,2
"7806","D2","RMDQ11_v1",0.375,0.188308893144328,8,109,89,20,5,3
"7807","D20","RMDQ11_v1",0.285714285714286,0.540545998072804,7,110,89,21,5,2
"7808","D21","RMDQ11_v1",0.285714285714286,0.540545998072804,7,110,89,21,5,2
"7809","D22","RMDQ11_v1",1,0.0423242826421271,1,116,94,22,0,1
"7810","D23","RMDQ11_v1",0.5,0.276118902707155,2,115,93,22,1,1
"7811","D24","RMDQ11_v1",0.125,0.322309100343378,24,93,73,20,21,3
"7812","D25","RMDQ11_v1",0.333333333333333,0.545976469961421,3,114,92,22,2,1
"7813","D26","RMDQ11_v1",0.5,0.276118902707155,2,115,93,22,1,1
"7814","D27","RMDQ11_v1",0.75,0.00459732870229455,4,113,93,20,1,3
"7815","D28","RMDQ11_v1",0.6,0.0203422960878968,5,112,92,20,2,3
"7816","D29","RMDQ11_v1",0.238095238095238,0.397803086724352,42,75,62,13,32,10
"7817","D3","RMDQ11_v1",0.5,0.276118902707155,2,115,93,22,1,1
"7818","Lombalgia","RMDQ11_v1",0.245901639344262,0.161203767460244,61,56,48,8,46,15
"7819","D31","RMDQ11_v1",0.176470588235294,0.821447265417518,17,100,80,20,14,3
"7820","D32","RMDQ11_v1",0.243243243243243,0.387744320673872,37,80,66,14,28,9
"7821","D33","RMDQ11_v1",0.0833333333333333,0.297401424086814,12,105,83,22,11,1
"7822","D34","RMDQ11_v1",0.5,0.276118902707155,2,115,93,22,1,1
"7823","D35","RMDQ11_v1",1,0.0423242826421271,1,116,94,22,0,1
"7824","D36","RMDQ11_v1",0,0.177103903498898,7,110,87,23,7,0
"7825","D37","RMDQ11_v1",0.285714285714286,0.25651978302958,21,96,79,17,15,6
"7826","D38","RMDQ11_v1",0,0.385414685011236,3,114,91,23,3,0
"7827","D39","RMDQ11_v1",0.285714285714286,0.371104034006289,14,103,84,19,10,4
"7828","D4","RMDQ11_v1",0.666666666666667,0.037934361203436,3,114,93,21,1,2
"7829","D40","RMDQ11_v1",0,0.258267411370114,5,112,89,23,5,0
"7830","D41","RMDQ11_v1",0.142857142857143,0.712225217901405,7,110,88,22,6,1
"7831","D42","RMDQ11_v1",0.5,0.276118902707155,2,115,93,22,1,1
"7832","D43","RMDQ11_v1",1,0.00392958907169176,2,115,94,21,0,2
"7833","D44","RMDQ11_v1",0.189189189189189,0.891168187956784,37,80,64,16,30,7
"7834","D45","RMDQ11_v1",0.0833333333333333,0.297401424086814,12,105,83,22,11,1
"7835","D46","RMDQ11_v1",0.216216216216216,0.716272830409109,37,80,65,15,29,8
"7836","D47","RMDQ11_v1",0.166666666666667,0.783123310607865,12,105,84,21,10,2
"7837","D48","RMDQ11_v1",0.192307692307692,0.950425149881039,26,91,73,18,21,5
"7838","D49","RMDQ11_v1",0.0769230769230769,0.249543835306561,13,104,82,22,12,1
"7839","D5","RMDQ11_v1",0.333333333333333,0.545976469961421,3,114,92,22,2,1
"7840","D50","RMDQ11_v1",0,0.61934434211196,1,116,93,23,1,0
"7841","D51","RMDQ11_v1",1,0.0423242826421271,1,116,94,22,0,1
"7842","D52","RMDQ11_v1",0,0.61934434211196,1,116,93,23,1,0
"7843","D53","RMDQ11_v1",1,0.0423242826421271,1,116,94,22,0,1
"7844","D9","RMDQ11_v1",1,0.0423242826421271,1,116,94,22,0,1
"7845","RMDQ1_v1","RMDQ11_v1",0.352941176470588,7.5201692089832e-06,85,134,122,12,55,30
"7846","RMDQ2_v1","RMDQ11_v1",0.366666666666667,2.39311742179001e-07,90,129,120,9,57,33
"7847","RMDQ3_v1","RMDQ11_v1",0.468354430379747,4.59390768870471e-15,79,141,136,5,42,37
"7848","RMDQ4_v1","RMDQ11_v1",0.333333333333333,0.00217179157532563,54,166,142,24,36,18
"7849","RMDQ5_v1","RMDQ11_v1",0.527777777777778,7.48857863041968e-19,72,148,144,4,34,38
"7850","RMDQ6_v1","RMDQ11_v1",0.696428571428571,7.29724459206877e-29,56,164,161,3,17,39
"7851","RMDQ7_v1","RMDQ11_v1",0.846153846153846,1.68632370136105e-30,39,181,172,9,6,33
"7852","RMDQ8_v1","RMDQ11_v1",0.875,5.29719634896312e-07,8,212,177,35,1,7
"7853","RMDQ9_v1","RMDQ11_v1",0.970588235294118,2.70276201560039e-36,34,186,177,9,1,33
"7854","RMDQ10_v1","RMDQ11_v1",0.925,5.57324773652127e-39,40,180,175,5,3,37
"7855","RMDQ11_v1","RMDQ11_v1",1,9.04447975804475e-50,42,178,178,0,0,42
"7856","RMDQ12_v1","RMDQ11_v1",0.795454545454545,3.82686693162048e-30,44,176,169,7,9,35
"7857","RMDQ13_v1","RMDQ11_v1",0.717391304347826,1.67872093980868e-24,46,174,165,9,13,33
"7858","RMDQ14_v1","RMDQ11_v1",0.73469387755102,4.47919789268309e-28,49,171,165,6,13,36
"7859","RMDQ15_v1","RMDQ11_v1",0.870967741935484,2.63183270604289e-25,31,189,174,15,4,27
"7860","RMDQ16_v1","RMDQ11_v1",0.864864864864865,2.73669003394032e-30,37,183,173,10,5,32
"7861","RMDQ17_v1","RMDQ11_v1",0.673469387755102,1.86670439068414e-22,49,171,162,9,16,33
"7862","RMDQ18_v1","RMDQ11_v1",0.972222222222222,6.99542001857602e-39,36,184,177,7,1,35
"7863","RMDQ19_v1","RMDQ11_v1",0.96875,9.21662154873218e-34,32,188,177,11,1,31
"7864","RMDQ20_v1","RMDQ11_v1",0.921052631578947,2.36351824386872e-36,38,182,175,7,3,35
"7865","RMDQ21_v1","RMDQ11_v1",0.770833333333333,6.43141249103896e-31,48,172,167,5,11,37
"7866","RMDQ22_v1","RMDQ11_v1",0.894736842105263,6.70056269121632e-34,38,182,174,8,4,34
"7867","RMDQ23_v1","RMDQ11_v1",0.918918918918919,4.62773129154927e-35,37,183,175,8,3,34
"7868","RMDQ24_v1","RMDQ11_v1",1,2.96671846020933e-40,35,185,178,7,0,35
"7869","DN4 - Queimação","RMDQ11_v1",0.18,0.642008442300391,100,109,92,17,82,18
"7870","DN4 - Sensação de frio dolorosa","RMDQ11_v1",0.0638297872340425,0.0622605966358203,47,161,133,28,44,3
"7871","DN4 - Choque elétrico","RMDQ11_v1",0.1,0.108733731364316,60,152,123,29,54,6
"7872","DN4 - Formigamento","RMDQ11_v1",0.178571428571429,0.751491788555487,56,156,131,25,46,10
"7873","DN4 - Alfinetada e agulhada","RMDQ11_v1",0.306451612903226,0.000365088140169493,62,150,134,16,43,19
"7874","DN4 - Adormecimento","RMDQ11_v1",0.23728813559322,0.0899819283488679,59,150,129,21,45,14
"7875","DN4 - Coceira","RMDQ11_v1",0.272727272727273,0.323409257998533,11,201,169,32,8,3
"7876","DH4 - Hipoestesia ao toque","RMDQ11_v1",0.571428571428571,0.00323285080933449,7,205,174,31,3,4
"7877","DN4 - Hipoestesia a picada de agulha","RMDQ11_v1",0.571428571428571,0.00323285080933449,7,205,174,31,3,4
"7878","DN4 - Escovação","RMDQ11_v1",0.666666666666667,0.000787768634466104,6,206,175,31,2,4
"7879","Fuma","RMDQ12_v1",0.305555555555556,0.106127955311832,36,147,120,27,25,11
"7880","Cirurgia na coluna","RMDQ12_v1",0.205882352941176,0.674064106348984,68,127,104,23,54,14
"7881","Aposentado","RMDQ12_v1",0.212121212121212,0.944243302163813,33,150,119,31,26,7
"7882","Desempregado","RMDQ12_v1",0.269230769230769,0.442510901603368,26,153,122,31,19,7
"7883","Licenca_Medica","RMDQ12_v1",0.210526315789474,0.994750570752259,19,162,128,34,15,4
"7884","Aposentado_Invalidez","RMDQ12_v1",0.5,0.0417496234732317,8,171,137,34,4,4
"7885","Analgésicos","RMDQ12_v1",0.24822695035461,0.024586892795058,141,57,51,6,106,35
"7886","OutraDoenca","RMDQ12_v1",0.253333333333333,0.25504396518131,75,114,93,21,56,19
"7887","Dor nas costas","RMDQ12_v1",0.252032520325203,0.030568113837077,123,67,59,8,92,31
"7888","Dor nas pernas","RMDQ12_v1",0.230769230769231,0.566435176918238,65,123,99,24,50,15
"7889","Retornar_trabalho","RMDQ12_v1",0.368421052631579,0.0703630461763821,19,168,136,32,12,7
"7890","Masc","RMDQ12_v1",0.201342281879195,0.942519185502165,149,71,57,14,119,30
"7891","Fem","RMDQ12_v1",0.197183098591549,0.942519185502165,71,149,119,30,57,14
"7892","Casado/Amasiaado","RMDQ12_v1",0.209876543209877,0.714211764183465,81,101,82,19,64,17
"7893","Solteiro","RMDQ12_v1",0.186666666666667,0.752200150782838,75,107,85,22,61,14
"7894","Separado_Divorciado","RMDQ12_v1",0,0.180309835229217,7,175,139,36,7,0
"7895","X4","RMDQ12_v1",0,0.385804696018125,3,179,143,36,3,0
"7896","X5","RMDQ12_v1",0.25,0.791006762917235,4,178,143,35,3,1
"7897","X6","RMDQ12_v1",0.333333333333333,0.222651452609313,12,170,138,32,8,4
"7898","Livrar_costas","RMDQ12_v1",0.252336448598131,0.263069618166919,107,16,14,2,80,27
"7899","Livrar_perna","RMDQ12_v1",0.142857142857143,0.384286070333107,14,109,82,27,12,2
"7900","Livrar_perda_sens","RMDQ12_v1",0,0.428376882546342,2,121,92,29,2,0
"7901","D1","RMDQ12_v1",0,0.628885363875848,1,116,94,22,1,0
"7902","D15","RMDQ12_v1",0.142857142857143,0.752394853272729,7,110,89,21,6,1
"7903","D16","RMDQ12_v1",0.3,0.159306249364,20,97,81,16,14,6
"7904","D17","RMDQ12_v1",0,0.271414036674767,5,112,90,22,5,0
"7905","D18","RMDQ12_v1",0.307692307692308,0.241548993591403,13,104,86,18,9,4
"7906","D19","RMDQ12_v1",0.333333333333333,0.349709263533331,6,111,91,20,4,2
"7907","D2","RMDQ12_v1",0.375,0.160865525892034,8,109,90,19,5,3
"7908","D20","RMDQ12_v1",0.285714285714286,0.495159471383125,7,110,90,20,5,2
"7909","D21","RMDQ12_v1",0.285714285714286,0.495159471383125,7,110,90,20,5,2
"7910","D22","RMDQ12_v1",1,0.0368916317321308,1,116,95,21,0,1
"7911","D23","RMDQ12_v1",0,0.492429745624424,2,115,93,22,2,0
"7912","D24","RMDQ12_v1",0.0416666666666667,0.0395586887338147,24,93,72,21,23,1
"7913","D25","RMDQ12_v1",0,0.398443266068114,3,114,92,22,3,0
"7914","D26","RMDQ12_v1",0.5,0.254752373169046,2,115,94,21,1,1
"7915","D27","RMDQ12_v1",0.5,0.10420237747905,4,113,93,20,2,2
"7916","D28","RMDQ12_v1",0.4,0.215053785112352,5,112,92,20,3,2
"7917","D29","RMDQ12_v1",0.238095238095238,0.299712642157489,42,75,63,12,32,10
"7918","D3","RMDQ12_v1",0.5,0.254752373169046,2,115,94,21,1,1
"7919","Lombalgia","RMDQ12_v1",0.229508196721311,0.230814196634122,61,56,48,8,47,14
"7920","D31","RMDQ12_v1",0.176470588235294,0.894996496016723,17,100,81,19,14,3
"7921","D32","RMDQ12_v1",0.27027027027027,0.121576839489585,37,80,68,12,27,10
"7922","D33","RMDQ12_v1",0.0833333333333333,0.327168795969465,12,105,84,21,11,1
"7923","D34","RMDQ12_v1",0.5,0.254752373169046,2,115,94,21,1,1
"7924","D35","RMDQ12_v1",1,0.0368916317321308,1,116,95,21,0,1
"7925","D36","RMDQ12_v1",0,0.189151958767347,7,110,88,22,7,0
"7926","D37","RMDQ12_v1",0.285714285714286,0.205980720535328,21,96,80,16,15,6
"7927","D38","RMDQ12_v1",0,0.398443266068114,3,114,92,22,3,0
"7928","D39","RMDQ12_v1",0.285714285714286,0.318806873663325,14,103,85,18,10,4
"7929","D4","RMDQ12_v1",0.666666666666667,0.031603186824878,3,114,94,20,1,2
"7930","D40","RMDQ12_v1",0,0.271414036674767,5,112,90,22,5,0
"7931","D41","RMDQ12_v1",0.142857142857143,0.752394853272729,7,110,89,21,6,1
"7932","D42","RMDQ12_v1",1,0.00303457735757642,2,115,95,20,0,2
"7933","D43","RMDQ12_v1",1,0.00303457735757642,2,115,95,20,0,2
"7934","D44","RMDQ12_v1",0.216216216216216,0.595724348514155,37,80,66,14,29,8
"7935","D45","RMDQ12_v1",0.0833333333333333,0.327168795969465,12,105,84,21,11,1
"7936","D46","RMDQ12_v1",0.216216216216216,0.595724348514155,37,80,66,14,29,8
"7937","D47","RMDQ12_v1",0.166666666666667,0.8415073123212,12,105,85,20,10,2
"7938","D48","RMDQ12_v1",0.192307692307692,0.949579577806421,26,91,74,17,21,5
"7939","D49","RMDQ12_v1",0.0769230769230769,0.27682819675887,13,104,83,21,12,1
"7940","D5","RMDQ12_v1",0.333333333333333,0.514082165897887,3,114,93,21,2,1
"7941","D50","RMDQ12_v1",0,0.628885363875848,1,116,94,22,1,0
"7942","D51","RMDQ12_v1",1,0.0368916317321308,1,116,95,21,0,1
"7943","D52","RMDQ12_v1",1,0.0368916317321308,1,116,95,21,0,1
"7944","D53","RMDQ12_v1",1,0.0368916317321308,1,116,95,21,0,1
"7945","D9","RMDQ12_v1",1,0.0368916317321308,1,116,95,21,0,1
"7946","RMDQ1_v1","RMDQ12_v1",0.388235294117647,2.1372128783049e-07,85,134,123,11,52,33
"7947","RMDQ2_v1","RMDQ12_v1",0.377777777777778,2.87693687167412e-07,90,129,119,10,56,34
"7948","RMDQ3_v1","RMDQ12_v1",0.468354430379747,9.44652915593103e-14,79,141,134,7,42,37
"7949","RMDQ4_v1","RMDQ12_v1",0.296296296296296,0.0416910696342506,54,166,138,28,38,16
"7950","RMDQ5_v1","RMDQ12_v1",0.527777777777778,2.30144275281162e-17,72,148,142,6,34,38
"7951","RMDQ6_v1","RMDQ12_v1",0.696428571428571,5.50913333201881e-27,56,164,159,5,17,39
"7952","RMDQ7_v1","RMDQ12_v1",0.923076923076923,1.47080352648302e-35,39,181,173,8,3,36
"7953","RMDQ8_v1","RMDQ12_v1",0.875,1.160924040668e-06,8,212,175,37,1,7
"7954","RMDQ9_v1","RMDQ12_v1",0.970588235294118,2.52908639173568e-34,34,186,175,11,1,33
"7955","RMDQ10_v1","RMDQ12_v1",0.875,3.94510314773932e-32,40,180,171,9,5,35
"7956","RMDQ11_v1","RMDQ12_v1",0.833333333333333,3.82686693162048e-30,42,178,169,9,7,35
"7957","RMDQ12_v1","RMDQ12_v1",1,9.04447975804488e-50,44,176,176,0,0,44
"7958","RMDQ13_v1","RMDQ12_v1",0.804347826086957,1.01747887939032e-30,46,174,167,7,9,37
"7959","RMDQ14_v1","RMDQ12_v1",0.755102040816326,3.11054146953265e-28,49,171,164,7,12,37
"7960","RMDQ15_v1","RMDQ12_v1",0.935483870967742,2.31195628497245e-28,31,189,174,15,2,29
"7961","RMDQ16_v1","RMDQ12_v1",0.864864864864865,1.47323611159845e-28,37,183,171,12,5,32
"7962","RMDQ17_v1","RMDQ12_v1",0.673469387755102,5.5520928346739e-21,49,171,160,11,16,33
"7963","RMDQ18_v1","RMDQ12_v1",0.916666666666667,6.68116231744111e-32,36,184,173,11,3,33
"7964","RMDQ19_v1","RMDQ12_v1",0.96875,6.22288812484457e-32,32,188,175,13,1,31
"7965","RMDQ20_v1","RMDQ12_v1",0.921052631578947,2.51363890979545e-34,38,182,173,9,3,35
"7966","RMDQ21_v1","RMDQ12_v1",0.729166666666667,3.55007709489676e-25,48,172,163,9,13,35
"7967","RMDQ22_v1","RMDQ12_v1",0.894736842105263,5.48132077282605e-32,38,182,172,10,4,34
"7968","RMDQ23_v1","RMDQ12_v1",0.918918918918919,4.16233038960417e-33,37,183,173,10,3,34
"7969","RMDQ24_v1","RMDQ12_v1",1,4.33110628986617e-38,35,185,176,9,0,35
"7970","DN4 - Queimação","RMDQ12_v1",0.14,0.0976432609787212,100,109,84,25,86,14
"7971","DN4 - Sensação de frio dolorosa","RMDQ12_v1",0.0638297872340425,0.0135492605568523,47,161,125,36,44,3
"7972","DN4 - Choque elétrico","RMDQ12_v1",0.1,0.0474369808423653,60,152,119,33,54,6
"7973","DN4 - Formigamento","RMDQ12_v1",0.107142857142857,0.0836979037188427,56,156,123,33,50,6
"7974","DN4 - Alfinetada e agulhada","RMDQ12_v1",0.241935483870968,0.161322189762555,62,150,126,24,47,15
"7975","DN4 - Adormecimento","RMDQ12_v1",0.23728813559322,0.238170154136472,59,150,125,25,45,14
"7976","DN4 - Coceira","RMDQ12_v1",0.272727272727273,0.435185825682832,11,201,165,36,8,3
"7977","DH4 - Hipoestesia ao toque","RMDQ12_v1",0.571428571428571,0.00713165947264401,7,205,170,35,3,4
"7978","DN4 - Hipoestesia a picada de agulha","RMDQ12_v1",0.571428571428571,0.00713165947264401,7,205,170,35,3,4
"7979","DN4 - Escovação","RMDQ12_v1",0.666666666666667,0.00196288294764954,6,206,171,35,2,4
"7980","Fuma","RMDQ13_v1",0.277777777777778,0.290470834302873,36,147,118,29,26,10
"7981","Cirurgia na coluna","RMDQ13_v1",0.25,0.256171387705129,68,127,104,23,51,17
"7982","Aposentado","RMDQ13_v1",0.303030303030303,0.163563432130849,33,150,121,29,23,10
"7983","Desempregado","RMDQ13_v1",0.269230769230769,0.49264179642995,26,153,121,32,19,7
"7984","Licenca_Medica","RMDQ13_v1",0.157894736842105,0.55596780094511,19,162,127,35,16,3
"7985","Aposentado_Invalidez","RMDQ13_v1",0.5,0.0547239609846476,8,171,135,36,4,4
"7986","Analgésicos","RMDQ13_v1",0.234042553191489,0.235336113507785,141,57,48,9,108,33
"7987","OutraDoenca","RMDQ13_v1",0.28,0.121212851914524,75,114,93,21,54,21
"7988","Dor nas costas","RMDQ13_v1",0.24390243902439,0.126265896680955,123,67,57,10,93,30
"7989","Dor nas pernas","RMDQ13_v1",0.215384615384615,0.949148408669351,65,123,97,26,51,14
"7990","Retornar_trabalho","RMDQ13_v1",0.368421052631579,0.0590022930973136,19,168,137,31,12,7
"7991","Masc","RMDQ13_v1",0.214765100671141,0.764320864519931,149,71,57,14,117,32
"7992","Fem","RMDQ13_v1",0.197183098591549,0.764320864519931,71,149,117,32,57,14
"7993","Casado/Amasiaado","RMDQ13_v1",0.246913580246914,0.257142102373194,81,101,83,18,61,20
"7994","Solteiro","RMDQ13_v1",0.173333333333333,0.32445778459333,75,107,82,25,62,13
"7995","Separado_Divorciado","RMDQ13_v1",0.142857142857143,0.66160570966093,7,175,138,37,6,1
"7996","X4","RMDQ13_v1",0,0.369622021989821,3,179,141,38,3,0
"7997","X5","RMDQ13_v1",0.25,0.837538913112981,4,178,141,37,3,1
"7998","X6","RMDQ13_v1",0.25,0.716302881629038,12,170,135,35,9,3
"7999","Livrar_costas","RMDQ13_v1",0.242990654205607,0.29380489715575,107,16,14,2,81,26
"8000","Livrar_perna","RMDQ13_v1",0.142857142857143,0.421577354506448,14,109,83,26,12,2
"8001","Livrar_perda_sens","RMDQ13_v1",0,0.438876912649035,2,121,93,28,2,0
"8002","D1","RMDQ13_v1",1,0.0368916317321308,1,116,95,21,0,1
"8003","D15","RMDQ13_v1",0.142857142857143,0.752394853272729,7,110,89,21,6,1
"8004","D16","RMDQ13_v1",0.3,0.159306249364,20,97,81,16,14,6
"8005","D17","RMDQ13_v1",0.2,0.944203181175876,5,112,91,21,4,1
"8006","D18","RMDQ13_v1",0.307692307692308,0.241548993591403,13,104,86,18,9,4
"8007","D19","RMDQ13_v1",0.166666666666667,0.890617765836712,6,111,90,21,5,1
"8008","D2","RMDQ13_v1",0.375,0.160865525892034,8,109,90,19,5,3
"8009","D20","RMDQ13_v1",0.142857142857143,0.752394853272729,7,110,89,21,6,1
"8010","D21","RMDQ13_v1",0.142857142857143,0.752394853272729,7,110,89,21,6,1
"8011","D22","RMDQ13_v1",0,0.628885363875848,1,116,94,22,1,0
"8012","D23","RMDQ13_v1",0,0.492429745624424,2,115,93,22,2,0
"8013","D24","RMDQ13_v1",0.0416666666666667,0.0395586887338147,24,93,72,21,23,1
"8014","D25","RMDQ13_v1",0,0.398443266068114,3,114,92,22,3,0
"8015","D26","RMDQ13_v1",0,0.492429745624424,2,115,93,22,2,0
"8016","D27","RMDQ13_v1",0.5,0.10420237747905,4,113,93,20,2,2
"8017","D28","RMDQ13_v1",0.4,0.215053785112352,5,112,92,20,3,2
"8018","D29","RMDQ13_v1",0.261904761904762,0.125947232882611,42,75,64,11,31,11
"8019","D3","RMDQ13_v1",0.5,0.254752373169046,2,115,94,21,1,1
"8020","Lombalgia","RMDQ13_v1",0.229508196721311,0.230814196634122,61,56,48,8,47,14
"8021","D31","RMDQ13_v1",0.176470588235294,0.894996496016723,17,100,81,19,14,3
"8022","D32","RMDQ13_v1",0.27027027027027,0.121576839489585,37,80,68,12,27,10
"8023","D33","RMDQ13_v1",0.0833333333333333,0.327168795969465,12,105,84,21,11,1
"8024","D34","RMDQ13_v1",0.5,0.254752373169046,2,115,94,21,1,1
"8025","D35","RMDQ13_v1",1,0.0368916317321308,1,116,95,21,0,1
"8026","D36","RMDQ13_v1",0,0.189151958767347,7,110,88,22,7,0
"8027","D37","RMDQ13_v1",0.285714285714286,0.205980720535328,21,96,80,16,15,6
"8028","D38","RMDQ13_v1",0,0.398443266068114,3,114,92,22,3,0
"8029","D39","RMDQ13_v1",0.285714285714286,0.318806873663325,14,103,85,18,10,4
"8030","D4","RMDQ13_v1",0.666666666666667,0.031603186824878,3,114,94,20,1,2
"8031","D40","RMDQ13_v1",0,0.271414036674767,5,112,90,22,5,0
"8032","D41","RMDQ13_v1",0.142857142857143,0.752394853272729,7,110,89,21,6,1
"8033","D42","RMDQ13_v1",0,0.492429745624424,2,115,93,22,2,0
"8034","D43","RMDQ13_v1",0.5,0.254752373169046,2,115,94,21,1,1
"8035","D44","RMDQ13_v1",0.216216216216216,0.595724348514155,37,80,66,14,29,8
"8036","D45","RMDQ13_v1",0.0833333333333333,0.327168795969465,12,105,84,21,11,1
"8037","D46","RMDQ13_v1",0.243243243243243,0.298630848415371,37,80,67,13,28,9
"8038","D47","RMDQ13_v1",0.166666666666667,0.8415073123212,12,105,85,20,10,2
"8039","D48","RMDQ13_v1",0.230769230769231,0.527159865660169,26,91,75,16,20,6
"8040","D49","RMDQ13_v1",0.0769230769230769,0.27682819675887,13,104,83,21,12,1
"8041","D5","RMDQ13_v1",0.333333333333333,0.514082165897887,3,114,93,21,2,1
"8042","D50","RMDQ13_v1",0,0.628885363875848,1,116,94,22,1,0
"8043","D51","RMDQ13_v1",1,0.0368916317321308,1,116,95,21,0,1
"8044","D52","RMDQ13_v1",0,0.628885363875848,1,116,94,22,1,0
"8045","D53","RMDQ13_v1",1,0.0368916317321308,1,116,95,21,0,1
"8046","D9","RMDQ13_v1",1,0.0368916317321308,1,116,95,21,0,1
"8047","RMDQ1_v1","RMDQ13_v1",0.388235294117647,1.41417293958435e-06,85,134,121,13,52,33
"8048","RMDQ2_v1","RMDQ13_v1",0.355555555555556,4.94798601733118e-05,90,129,115,14,58,32
"8049","RMDQ3_v1","RMDQ13_v1",0.481012658227848,1.13775344270434e-13,79,141,133,8,41,38
"8050","RMDQ4_v1","RMDQ13_v1",0.314814814814815,0.0278522648007559,54,166,137,29,37,17
"8051","RMDQ5_v1","RMDQ13_v1",0.5,1.35462118744328e-13,72,148,138,10,36,36
"8052","RMDQ6_v1","RMDQ13_v1",0.660714285714286,6.23262409158129e-22,56,164,155,9,19,37
"8053","RMDQ7_v1","RMDQ13_v1",0.846153846153846,4.01355679415581e-27,39,181,168,13,6,33
"8054","RMDQ8_v1","RMDQ13_v1",0.875,2.37989535306747e-06,8,212,173,39,1,7
"8055","RMDQ9_v1","RMDQ13_v1",0.970588235294118,1.59726362813938e-32,34,186,173,13,1,33
"8056","RMDQ10_v1","RMDQ13_v1",0.825,3.32034513985841e-26,40,180,167,13,7,33
"8057","RMDQ11_v1","RMDQ13_v1",0.785714285714286,1.67872093980868e-24,42,178,165,13,9,33
"8058","RMDQ12_v1","RMDQ13_v1",0.840909090909091,1.01747887939032e-30,44,176,167,9,7,37
"8059","RMDQ13_v1","RMDQ13_v1",1,9.04447975804488e-50,46,174,174,0,0,46
"8060","RMDQ14_v1","RMDQ13_v1",0.653061224489796,4.38583964487606e-18,49,171,157,14,17,32
"8061","RMDQ15_v1","RMDQ13_v1",0.870967741935484,1.41275239992842e-22,31,189,170,19,4,27
"8062","RMDQ16_v1","RMDQ13_v1",0.945945945945946,1.27148398890014e-33,37,183,172,11,2,35
"8063","RMDQ17_v1","RMDQ13_v1",0.693877551020408,2.92919435879067e-21,49,171,159,12,15,34
"8064","RMDQ18_v1","RMDQ13_v1",0.861111111111111,7.04483602308015e-26,36,184,169,15,5,31
"8065","RMDQ19_v1","RMDQ13_v1",0.96875,2.91738355065417e-30,32,188,173,15,1,31
"8066","RMDQ20_v1","RMDQ13_v1",0.868421052631579,4.33945751062073e-28,38,182,169,13,5,33
"8067","RMDQ21_v1","RMDQ13_v1",0.6875,3.02717342793665e-20,48,172,159,13,15,33
"8068","RMDQ22_v1","RMDQ13_v1",0.842105263157895,5.0827520652276e-26,38,182,168,14,6,32
"8069","RMDQ23_v1","RMDQ13_v1",0.864864864864865,5.61408317275801e-27,37,183,169,14,5,32
"8070","RMDQ24_v1","RMDQ13_v1",0.942857142857143,2.55322966548863e-31,35,185,172,13,2,33
"8071","DN4 - Queimação","RMDQ13_v1",0.17,0.220834426484533,100,109,83,26,83,17
"8072","DN4 - Sensação de frio dolorosa","RMDQ13_v1",0.127659574468085,0.128133411741689,47,161,124,37,41,6
"8073","DN4 - Choque elétrico","RMDQ13_v1",0.1,0.0193158028304068,60,152,115,37,54,6
"8074","DN4 - Formigamento","RMDQ13_v1",0.160714285714286,0.360874042788507,56,156,122,34,47,9
"8075","DN4 - Alfinetada e agulhada","RMDQ13_v1",0.241935483870968,0.362633980758102,62,150,122,28,47,15
"8076","DN4 - Adormecimento","RMDQ13_v1",0.23728813559322,0.479218981564061,59,150,121,29,45,14
"8077","DN4 - Coceira","RMDQ13_v1",0.272727272727273,0.55379410473523,11,201,161,40,8,3
"8078","DH4 - Hipoestesia ao toque","RMDQ13_v1",0.571428571428571,0.0136504338106029,7,205,166,39,3,4
"8079","DN4 - Hipoestesia a picada de agulha","RMDQ13_v1",0.571428571428571,0.0136504338106029,7,205,166,39,3,4
"8080","DN4 - Escovação","RMDQ13_v1",0.666666666666667,0.00415201059983438,6,206,167,39,2,4
"8081","Fuma","RMDQ14_v1",0.305555555555556,0.226028990162637,36,147,116,31,25,11
"8082","Cirurgia na coluna","RMDQ14_v1",0.235294117647059,0.620689130722894,68,127,101,26,52,16
"8083","Aposentado","RMDQ14_v1",0.272727272727273,0.458780370781703,33,150,118,32,24,9
"8084","Desempregado","RMDQ14_v1",0.346153846153846,0.124306058800395,26,153,121,32,17,9
"8085","Licenca_Medica","RMDQ14_v1",0.210526315789474,0.860262402046614,19,162,125,37,15,4
"8086","Aposentado_Invalidez","RMDQ14_v1",0.375,0.314860947951503,8,171,133,38,5,3
"8087","Analgésicos","RMDQ14_v1",0.276595744680851,0.0091938852823191,141,57,51,6,102,39
"8088","OutraDoenca","RMDQ14_v1",0.24,0.739789741005978,75,114,89,25,57,18
"8089","Dor nas costas","RMDQ14_v1",0.284552845528455,0.00934211538495321,123,67,59,8,88,35
"8090","Dor nas pernas","RMDQ14_v1",0.230769230769231,0.86010327939387,65,123,96,27,50,15
"8091","Retornar_trabalho","RMDQ14_v1",0.315789473684211,0.382830931936709,19,168,130,38,13,6
"8092","Masc","RMDQ14_v1",0.214765100671141,0.680939537637105,149,71,54,17,117,32
"8093","Fem","RMDQ14_v1",0.23943661971831,0.680939537637105,71,149,117,32,54,17
"8094","Casado/Amasiaado","RMDQ14_v1",0.271604938271605,0.130533953574004,81,101,83,18,59,22
"8095","Solteiro","RMDQ14_v1",0.186666666666667,0.366426918354605,75,107,81,26,61,14
"8096","Separado_Divorciado","RMDQ14_v1",0,0.152135804935708,7,175,135,40,7,0
"8097","X4","RMDQ14_v1",0,0.353953248138362,3,179,139,40,3,0
"8098","X5","RMDQ14_v1",0.5,0.171148825895779,4,178,140,38,2,2
"8099","X6","RMDQ14_v1",0.166666666666667,0.645708827467397,12,170,132,38,10,2
"8100","Livrar_costas","RMDQ14_v1",0.271028037383178,0.477518917824818,107,16,13,3,78,29
"8101","Livrar_perna","RMDQ14_v1",0.142857142857143,0.287895495678225,14,109,79,30,12,2
"8102","Livrar_perda_sens","RMDQ14_v1",0.5,0.435701006743543,2,121,90,31,1,1
"8103","D1","RMDQ14_v1",0,0.600606776606717,1,116,91,25,1,0
"8104","D15","RMDQ14_v1",0.142857142857143,0.63733801517531,7,110,86,24,6,1
"8105","D16","RMDQ14_v1",0.2,0.869839819438198,20,97,76,21,16,4
"8106","D17","RMDQ14_v1",0,0.233510138206751,5,112,87,25,5,0
"8107","D18","RMDQ14_v1",0.384615384615385,0.110750569792763,13,104,84,20,8,5
"8108","D19","RMDQ14_v1",0.333333333333333,0.462871352347925,6,111,88,23,4,2
"8109","D2","RMDQ14_v1",0.375,0.248781358310119,8,109,87,22,5,3
"8110","D20","RMDQ14_v1",0.285714285714286,0.631546019495452,7,110,87,23,5,2
"8111","D21","RMDQ14_v1",0.285714285714286,0.631546019495452,7,110,87,23,5,2
"8112","D22","RMDQ14_v1",1,0.0540315515408075,1,116,92,24,0,1
"8113","D23","RMDQ14_v1",0.5,0.319048948084802,2,115,91,24,1,1
"8114","D24","RMDQ14_v1",0.125,0.234548041327828,24,93,71,22,21,3
"8115","D25","RMDQ14_v1",0.333333333333333,0.608489851420513,3,114,90,24,2,1
"8116","D26","RMDQ14_v1",0.5,0.319048948084802,2,115,91,24,1,1
"8117","D27","RMDQ14_v1",0.75,0.0077500562032918,4,113,91,22,1,3
"8118","D28","RMDQ14_v1",0.6,0.0312410511415248,5,112,90,22,2,3
"8119","D29","RMDQ14_v1",0.238095238095238,0.62964197037303,42,75,60,15,32,10
"8120","D3","RMDQ14_v1",0.5,0.319048948084802,2,115,91,24,1,1
"8121","Lombalgia","RMDQ14_v1",0.278688524590164,0.0733644710807919,61,56,48,8,44,17
"8122","D31","RMDQ14_v1",0.176470588235294,0.685627428475482,17,100,78,22,14,3
"8123","D32","RMDQ14_v1",0.243243243243243,0.595674078532934,37,80,64,16,28,9
"8124","D33","RMDQ14_v1",0.0833333333333333,0.244921732627562,12,105,81,24,11,1
"8125","D34","RMDQ14_v1",0.5,0.319048948084802,2,115,91,24,1,1
"8126","D35","RMDQ14_v1",1,0.0540315515408075,1,116,92,24,0,1
"8127","D36","RMDQ14_v1",0.142857142857143,0.63733801517531,7,110,86,24,6,1
"8128","D37","RMDQ14_v1",0.19047619047619,0.774629547697209,21,96,75,21,17,4
"8129","D38","RMDQ14_v1",0,0.360350754533787,3,114,89,25,3,0
"8130","D39","RMDQ14_v1",0.142857142857143,0.490838093204112,14,103,80,23,12,2
"8131","D4","RMDQ14_v1",0.666666666666667,0.0524821629627642,3,114,91,23,1,2
"8132","D40","RMDQ14_v1",0,0.233510138206751,5,112,87,25,5,0
"8133","D41","RMDQ14_v1",0,0.154910205584856,7,110,85,25,7,0
"8134","D42","RMDQ14_v1",1,0.00621115026571818,2,115,92,23,0,2
"8135","D43","RMDQ14_v1",1,0.00621115026571818,2,115,92,23,0,2
"8136","D44","RMDQ14_v1",0.216216216216216,0.963628148596021,37,80,63,17,29,8
"8137","D45","RMDQ14_v1",0.0833333333333333,0.244921732627562,12,105,81,24,11,1
"8138","D46","RMDQ14_v1",0.189189189189189,0.660350491579065,37,80,62,18,30,7
"8139","D47","RMDQ14_v1",0.166666666666667,0.67495257839607,12,105,82,23,10,2
"8140","D48","RMDQ14_v1",0.115384615384615,0.165620625440185,26,91,69,22,23,3
"8141","D49","RMDQ14_v1",0.0769230769230769,0.202003995111537,13,104,80,24,12,1
"8142","D5","RMDQ14_v1",0.333333333333333,0.608489851420513,3,114,90,24,2,1
"8143","D50","RMDQ14_v1",0,0.600606776606717,1,116,91,25,1,0
"8144","D51","RMDQ14_v1",1,0.0540315515408075,1,116,92,24,0,1
"8145","D52","RMDQ14_v1",1,0.0540315515408075,1,116,92,24,0,1
"8146","D53","RMDQ14_v1",1,0.0540315515408075,1,116,92,24,0,1
"8147","D9","RMDQ14_v1",1,0.0540315515408075,1,116,92,24,0,1
"8148","RMDQ1_v1","RMDQ14_v1",0.482352941176471,1.92360002097082e-12,85,134,126,8,44,41
"8149","RMDQ2_v1","RMDQ14_v1",0.5,2.04855149266087e-15,90,129,125,4,45,45
"8150","RMDQ3_v1","RMDQ14_v1",0.468354430379747,5.59488249261901e-11,79,141,129,12,42,37
"8151","RMDQ4_v1","RMDQ14_v1",0.333333333333333,0.0245223053717586,54,166,135,31,36,18
"8152","RMDQ5_v1","RMDQ14_v1",0.513888888888889,4.50404679452514e-13,72,148,136,12,35,37
"8153","RMDQ6_v1","RMDQ14_v1",0.607142857142857,1.1681741522927e-15,56,164,149,15,22,34
"8154","RMDQ7_v1","RMDQ14_v1",0.897435897435897,6.06931963566391e-29,39,181,167,14,4,35
"8155","RMDQ8_v1","RMDQ14_v1",0.875,6.27400194866598e-06,8,212,170,42,1,7
"8156","RMDQ9_v1","RMDQ14_v1",0.941176470588235,6.63947855075367e-28,34,186,169,17,2,32
"8157","RMDQ10_v1","RMDQ14_v1",0.9,5.17687226522671e-30,40,180,167,13,4,36
"8158","RMDQ11_v1","RMDQ14_v1",0.857142857142857,4.47919789268309e-28,42,178,165,13,6,36
"8159","RMDQ12_v1","RMDQ14_v1",0.840909090909091,3.11054146953265e-28,44,176,164,12,7,37
"8160","RMDQ13_v1","RMDQ14_v1",0.695652173913043,4.38583964487606e-18,46,174,157,17,14,32
"8161","RMDQ14_v1","RMDQ14_v1",1,9.04447975804488e-50,49,171,171,0,0,49
"8162","RMDQ15_v1","RMDQ14_v1",0.935483870967742,7.79124507799233e-25,31,189,169,20,2,29
"8163","RMDQ16_v1","RMDQ14_v1",0.864864864864865,7.57897393539647e-25,37,183,166,17,5,32
"8164","RMDQ17_v1","RMDQ14_v1",0.673469387755102,7.87915863197901e-18,49,171,155,16,16,33
"8165","RMDQ18_v1","RMDQ14_v1",0.972222222222222,3.14587991293682e-32,36,184,170,14,1,35
"8166","RMDQ19_v1","RMDQ14_v1",0.9375,7.57394242815375e-26,32,188,169,19,2,30
"8167","RMDQ20_v1","RMDQ14_v1",0.894736842105263,6.9176345235904e-28,38,182,167,15,4,34
"8168","RMDQ21_v1","RMDQ14_v1",0.75,3.09645348653985e-23,48,172,159,13,12,36
"8169","RMDQ22_v1","RMDQ14_v1",0.868421052631579,7.16027453909365e-26,38,182,166,16,5,33
"8170","RMDQ23_v1","RMDQ14_v1",0.891891891891892,7.66785369720488e-27,37,183,167,16,4,33
"8171","RMDQ24_v1","RMDQ14_v1",0.971428571428571,3.70944441058562e-31,35,185,170,15,1,34
"8172","DN4 - Queimação","RMDQ14_v1",0.21,0.754666689039567,100,109,88,21,79,21
"8173","DN4 - Sensação de frio dolorosa","RMDQ14_v1",0.170212765957447,0.538201413250108,47,161,127,34,39,8
"8174","DN4 - Choque elétrico","RMDQ14_v1",0.116666666666667,0.0615797984782919,60,152,117,35,53,7
"8175","DN4 - Formigamento","RMDQ14_v1",0.107142857142857,0.0464733238027768,56,156,120,36,50,6
"8176","DN4 - Alfinetada e agulhada","RMDQ14_v1",0.225806451612903,0.515435616806471,62,150,122,28,48,14
"8177","DN4 - Adormecimento","RMDQ14_v1",0.271186440677966,0.112049966900367,59,150,124,26,43,16
"8178","DN4 - Coceira","RMDQ14_v1",0.181818181818182,0.889249344313632,11,201,161,40,9,2
"8179","DH4 - Hipoestesia ao toque","RMDQ14_v1",0.571428571428571,0.0117350775654101,7,205,167,38,3,4
"8180","DN4 - Hipoestesia a picada de agulha","RMDQ14_v1",0.571428571428571,0.0117350775654101,7,205,167,38,3,4
"8181","DN4 - Escovação","RMDQ14_v1",0.666666666666667,0.00348726888642748,6,206,168,38,2,4
"8182","Fuma","RMDQ15_v1",0.166666666666667,0.557980095719506,36,147,128,19,30,6
"8183","Cirurgia na coluna","RMDQ15_v1",0.147058823529412,0.67991840914,68,127,111,16,58,10
"8184","Aposentado","RMDQ15_v1",0.0909090909090909,0.449437055094453,33,150,129,21,30,3
"8185","Desempregado","RMDQ15_v1",0.153846153846154,0.748990389880421,26,153,133,20,22,4
"8186","Licenca_Medica","RMDQ15_v1",0.157894736842105,0.731078307964245,19,162,141,21,16,3
"8187","Aposentado_Invalidez","RMDQ15_v1",0.375,0.0494559079512997,8,171,149,22,5,3
"8188","Analgésicos","RMDQ15_v1",0.170212765957447,0.0290418269366636,141,57,54,3,117,24
"8189","OutraDoenca","RMDQ15_v1",0.16,0.467676973650704,75,114,100,14,63,12
"8190","Dor nas costas","RMDQ15_v1",0.170731707317073,0.0655286404567252,123,67,62,5,102,21
"8191","Dor nas pernas","RMDQ15_v1",0.169230769230769,0.287253249877641,65,123,109,14,54,11
"8192","Retornar_trabalho","RMDQ15_v1",0.105263157894737,0.608739840807284,19,168,143,25,17,2
"8193","Masc","RMDQ15_v1",0.154362416107383,0.406065670574831,149,71,63,8,126,23
"8194","Fem","RMDQ15_v1",0.112676056338028,0.406065670574831,71,149,126,23,63,8
"8195","Casado/Amasiaado","RMDQ15_v1",0.160493827160494,0.306714197946849,81,101,90,11,68,13
"8196","Solteiro","RMDQ15_v1",0.106666666666667,0.400194469405897,75,107,91,16,67,8
"8197","Separado_Divorciado","RMDQ15_v1",0,0.292991788296941,7,175,151,24,7,0
"8198","X4","RMDQ15_v1",0,0.496070132399276,3,179,155,24,3,0
"8199","X5","RMDQ15_v1",0.25,0.480132247700843,4,178,155,23,3,1
"8200","X6","RMDQ15_v1",0.166666666666667,0.712397607303263,12,170,148,22,10,2
"8201","Livrar_costas","RMDQ15_v1",0.14018691588785,0.617492553600973,107,16,13,3,92,15
"8202","Livrar_perna","RMDQ15_v1",0.142857142857143,0.968744634503816,14,109,93,16,12,2
"8203","Livrar_perda_sens","RMDQ15_v1",0.5,0.153665853249879,2,121,104,17,1,1
"8204","D1","RMDQ15_v1",0,0.700139702762516,1,116,101,15,1,0
"8205","D15","RMDQ15_v1",0.142857142857143,0.904810508581279,7,110,96,14,6,1
"8206","D16","RMDQ15_v1",0.2,0.291532902301946,20,97,86,11,16,4
"8207","D17","RMDQ15_v1",0,0.380799352580873,5,112,97,15,5,0
"8208","D18","RMDQ15_v1",0.153846153846154,0.769286962232618,13,104,91,13,11,2
"8209","D19","RMDQ15_v1",0.166666666666667,0.772338849125788,6,111,97,14,5,1
"8210","D2","RMDQ15_v1",0.25,0.285717336283617,8,109,96,13,6,2
"8211","D20","RMDQ15_v1",0,0.295383708358243,7,110,95,15,7,0
"8212","D21","RMDQ15_v1",0,0.295383708358243,7,110,95,15,7,0
"8213","D22","RMDQ15_v1",0,0.700139702762516,1,116,101,15,1,0
"8214","D23","RMDQ15_v1",0,0.584363826258582,2,115,100,15,2,0
"8215","D24","RMDQ15_v1",0.0416666666666667,0.154924749544463,24,93,79,14,23,1
"8216","D25","RMDQ15_v1",0,0.501014709533698,3,114,99,15,3,0
"8217","D26","RMDQ15_v1",0,0.584363826258582,2,115,100,15,2,0
"8218","D27","RMDQ15_v1",0.25,0.458450662997124,4,113,99,14,3,1
"8219","D28","RMDQ15_v1",0,0.380799352580873,5,112,97,15,5,0
"8220","D29","RMDQ15_v1",0.142857142857143,0.722775646432368,42,75,66,9,36,6
"8221","D3","RMDQ15_v1",0.5,0.112657006702594,2,115,101,14,1,1
"8222","Lombalgia","RMDQ15_v1",0.163934426229508,0.227623540145872,61,56,51,5,51,10
"8223","D31","RMDQ15_v1",0.0588235294117647,0.354677720671371,17,100,86,14,16,1
"8224","D32","RMDQ15_v1",0.189189189189189,0.179643317519845,37,80,72,8,30,7
"8225","D33","RMDQ15_v1",0.0833333333333333,0.623569558117348,12,105,91,14,11,1
"8226","D34","RMDQ15_v1",0.5,0.112657006702594,2,115,101,14,1,1
"8227","D35","RMDQ15_v1",1,0.00882146183803565,1,116,102,14,0,1
"8228","D36","RMDQ15_v1",0,0.295383708358243,7,110,95,15,7,0
"8229","D37","RMDQ15_v1",0.19047619047619,0.346034413595767,21,96,85,11,17,4
"8230","D38","RMDQ15_v1",0,0.501014709533698,3,114,99,15,3,0
"8231","D39","RMDQ15_v1",0.142857142857143,0.861257534748584,14,103,90,13,12,2
"8232","D4","RMDQ15_v1",0.666666666666667,0.00471104716586064,3,114,101,13,1,2
"8233","D40","RMDQ15_v1",0,0.380799352580873,5,112,97,15,5,0
"8234","D41","RMDQ15_v1",0,0.295383708358243,7,110,95,15,7,0
"8235","D42","RMDQ15_v1",0,0.584363826258582,2,115,100,15,2,0
"8236","D43","RMDQ15_v1",0,0.584363826258582,2,115,100,15,2,0
"8237","D44","RMDQ15_v1",0.162162162162162,0.454961709824423,37,80,71,9,31,6
"8238","D45","RMDQ15_v1",0.0833333333333333,0.623569558117348,12,105,91,14,11,1
"8239","D46","RMDQ15_v1",0.162162162162162,0.454961709824423,37,80,71,9,31,6
"8240","D47","RMDQ15_v1",0.166666666666667,0.673986052700643,12,105,92,13,10,2
"8241","D48","RMDQ15_v1",0.115384615384615,0.824532025810749,26,91,79,12,23,3
"8242","D49","RMDQ15_v1",0.0769230769230769,0.557462026301778,13,104,90,14,12,1
"8243","D5","RMDQ15_v1",0.333333333333333,0.281645394833599,3,114,100,14,2,1
"8244","D50","RMDQ15_v1",0,0.700139702762516,1,116,101,15,1,0
"8245","D51","RMDQ15_v1",1,0.00882146183803565,1,116,102,14,0,1
"8246","D52","RMDQ15_v1",0,0.700139702762516,1,116,101,15,1,0
"8247","D53","RMDQ15_v1",0,0.700139702762516,1,116,101,15,1,0
"8248","D9","RMDQ15_v1",1,0.00882146183803565,1,116,102,14,0,1
"8249","RMDQ1_v1","RMDQ15_v1",0.341176470588235,1.08138535596357e-10,85,134,132,2,56,29
"8250","RMDQ2_v1","RMDQ15_v1",0.322222222222222,1.04211040204672e-09,90,129,127,2,61,29
"8251","RMDQ3_v1","RMDQ15_v1",0.341772151898734,1.45966753489881e-10,79,141,137,4,52,27
"8252","RMDQ4_v1","RMDQ15_v1",0.0925925925925926,0.240078396774443,54,166,140,26,49,5
"8253","RMDQ5_v1","RMDQ15_v1",0.375,3.38998765801881e-12,72,148,144,4,45,27
"8254","RMDQ6_v1","RMDQ15_v1",0.482142857142857,1.88715666965384e-17,56,164,160,4,29,27
"8255","RMDQ7_v1","RMDQ15_v1",0.692307692307692,1.0166500250513e-27,39,181,177,4,12,27
"8256","RMDQ8_v1","RMDQ15_v1",0.5,0.00294189307973926,8,212,185,27,4,4
"8257","RMDQ9_v1","RMDQ15_v1",0.794117647058823,1.10452378994493e-32,34,186,182,4,7,27
"8258","RMDQ10_v1","RMDQ15_v1",0.675,7.10532254706397e-27,40,180,176,4,13,27
"8259","RMDQ11_v1","RMDQ15_v1",0.642857142857143,2.63183270604289e-25,42,178,174,4,15,27
"8260","RMDQ12_v1","RMDQ15_v1",0.659090909090909,2.31195628497245e-28,44,176,174,2,15,29
"8261","RMDQ13_v1","RMDQ15_v1",0.58695652173913,1.41275239992842e-22,46,174,170,4,19,27
"8262","RMDQ14_v1","RMDQ15_v1",0.591836734693878,7.79124507799233e-25,49,171,169,2,20,29
"8263","RMDQ15_v1","RMDQ15_v1",1,9.04447975804488e-50,31,189,189,0,0,31
"8264","RMDQ16_v1","RMDQ15_v1",0.72972972972973,1.52047338237707e-29,37,183,179,4,10,27
"8265","RMDQ17_v1","RMDQ15_v1",0.551020408163265,8.05841936383107e-21,49,171,167,4,22,27
"8266","RMDQ18_v1","RMDQ15_v1",0.75,1.56181925140462e-30,36,184,180,4,9,27
"8267","RMDQ19_v1","RMDQ15_v1",0.84375,4.21577239144344e-35,32,188,184,4,5,27
"8268","RMDQ20_v1","RMDQ15_v1",0.710526315789474,1.31370570973966e-28,38,182,178,4,11,27
"8269","RMDQ21_v1","RMDQ15_v1",0.5625,2.21372577838713e-21,48,172,168,4,21,27
"8270","RMDQ22_v1","RMDQ15_v1",0.710526315789474,1.31370570973966e-28,38,182,178,4,11,27
"8271","RMDQ23_v1","RMDQ15_v1",0.72972972972973,1.52047338237707e-29,37,183,179,4,10,27
"8272","RMDQ24_v1","RMDQ15_v1",0.771428571428571,1.40934099121581e-31,35,185,181,4,8,27
"8273","DN4 - Queimação","RMDQ15_v1",0.14,0.88879326316211,100,109,93,16,86,14
"8274","DN4 - Sensação de frio dolorosa","RMDQ15_v1",0.0638297872340425,0.0745392795527733,47,161,134,27,44,3
"8275","DN4 - Choque elétrico","RMDQ15_v1",0.1,0.275954597741857,60,152,128,24,54,6
"8276","DN4 - Formigamento","RMDQ15_v1",0.107142857142857,0.389704980538703,56,156,132,24,50,6
"8277","DN4 - Alfinetada e agulhada","RMDQ15_v1",0.17741935483871,0.33482880483961,62,150,131,19,51,11
"8278","DN4 - Adormecimento","RMDQ15_v1",0.169491525423729,0.502179363737638,59,150,130,20,49,10
"8279","DN4 - Coceira","RMDQ15_v1",0.181818181818182,0.693642072654427,11,201,173,28,9,2
"8280","DH4 - Hipoestesia ao toque","RMDQ15_v1",0.571428571428571,0.000904416361714182,7,205,179,26,3,4
"8281","DN4 - Hipoestesia a picada de agulha","RMDQ15_v1",0.571428571428571,0.000904416361714182,7,205,179,26,3,4
"8282","DN4 - Escovação","RMDQ15_v1",0.666666666666667,0.000181095024232787,6,206,180,26,2,4
"8283","Fuma","RMDQ16_v1",0.277777777777778,0.0697133721004221,36,147,125,22,26,10
"8284","Cirurgia na coluna","RMDQ16_v1",0.220588235294118,0.0851074997133805,68,127,111,16,53,15
"8285","Aposentado","RMDQ16_v1",0.242424242424242,0.178552570613183,33,150,128,22,25,8
"8286","Desempregado","RMDQ16_v1",0.192307692307692,0.715208419026586,26,153,128,25,21,5
"8287","Licenca_Medica","RMDQ16_v1",0.157894736842105,0.922504735469014,19,162,135,27,16,3
"8288","Aposentado_Invalidez","RMDQ16_v1",0.375,0.122741415423386,8,171,143,28,5,3
"8289","Analgésicos","RMDQ16_v1",0.205673758865248,0.0462990106372058,141,57,52,5,112,29
"8290","OutraDoenca","RMDQ16_v1",0.226666666666667,0.12619685298872,75,114,98,16,58,17
"8291","Dor nas costas","RMDQ16_v1",0.219512195121951,0.0107818276470636,123,67,62,5,96,27
"8292","Dor nas pernas","RMDQ16_v1",0.184615384615385,0.70247329917042,65,123,103,20,53,12
"8293","Retornar_trabalho","RMDQ16_v1",0.210526315789474,0.481174922431539,19,168,143,25,15,4
"8294","Masc","RMDQ16_v1",0.167785234899329,0.981823574961799,149,71,59,12,124,25
"8295","Fem","RMDQ16_v1",0.169014084507042,0.981823574961799,71,149,124,25,59,12
"8296","Casado/Amasiaado","RMDQ16_v1",0.197530864197531,0.382012910761673,81,101,86,15,65,16
"8297","Solteiro","RMDQ16_v1",0.133333333333333,0.266324823643383,75,107,86,21,65,10
"8298","Separado_Divorciado","RMDQ16_v1",0.142857142857143,0.843685433592571,7,175,145,30,6,1
"8299","X4","RMDQ16_v1",0,0.428746611205637,3,179,148,31,3,0
"8300","X5","RMDQ16_v1",0.25,0.668212762738764,4,178,148,30,3,1
"8301","X6","RMDQ16_v1",0.25,0.447477423437325,12,170,142,28,9,3
"8302","Livrar_costas","RMDQ16_v1",0.196261682242991,0.495326116175534,107,16,14,2,86,21
"8303","Livrar_perna","RMDQ16_v1",0.142857142857143,0.65277584695815,14,109,88,21,12,2
"8304","Livrar_perda_sens","RMDQ16_v1",0,0.494091831099047,2,121,98,23,2,0
"8305","D1","RMDQ16_v1",0,0.658337884368623,1,116,97,19,1,0
"8306","D15","RMDQ16_v1",0.142857142857143,0.88507678924591,7,110,92,18,6,1
"8307","D16","RMDQ16_v1",0.25,0.243334917175902,20,97,83,14,15,5
"8308","D17","RMDQ16_v1",0,0.314265473296222,5,112,93,19,5,0
"8309","D18","RMDQ16_v1",0.230769230769231,0.478322601755956,13,104,88,16,10,3
"8310","D19","RMDQ16_v1",0.166666666666667,0.976753057814779,6,111,93,18,5,1
"8311","D2","RMDQ16_v1",0.375,0.0911685513036505,8,109,93,16,5,3
"8312","D20","RMDQ16_v1",0.142857142857143,0.88507678924591,7,110,92,18,6,1
"8313","D21","RMDQ16_v1",0.142857142857143,0.88507678924591,7,110,92,18,6,1
"8314","D22","RMDQ16_v1",0,0.658337884368623,1,116,97,19,1,0
"8315","D23","RMDQ16_v1",0,0.529944138338696,2,115,96,19,2,0
"8316","D24","RMDQ16_v1",0.0833333333333333,0.238835880237147,24,93,76,17,22,2
"8317","D25","RMDQ16_v1",0,0.439748411324023,3,114,95,19,3,0
"8318","D26","RMDQ16_v1",0,0.529944138338696,2,115,96,19,2,0
"8319","D27","RMDQ16_v1",0.5,0.0624754800677752,4,113,96,17,2,2
"8320","D28","RMDQ16_v1",0.4,0.14091465862111,5,112,95,17,3,2
"8321","D29","RMDQ16_v1",0.214285714285714,0.254742236818866,42,75,65,10,33,9
"8322","D3","RMDQ16_v1",0.5,0.191631215221544,2,115,97,18,1,1
"8323","Lombalgia","RMDQ16_v1",0.213114754098361,0.120524579592681,61,56,50,6,48,13
"8324","D31","RMDQ16_v1",0.176470588235294,0.864829085571817,17,100,84,16,14,3
"8325","D32","RMDQ16_v1",0.216216216216216,0.28303452459432,37,80,69,11,29,8
"8326","D33","RMDQ16_v1",0.0833333333333333,0.433119831393324,12,105,87,18,11,1
"8327","D34","RMDQ16_v1",0.5,0.191631215221544,2,115,97,18,1,1
"8328","D35","RMDQ16_v1",1,0.0225562523721356,1,116,98,18,0,1
"8329","D36","RMDQ16_v1",0,0.229572755395786,7,110,91,19,7,0
"8330","D37","RMDQ16_v1",0.238095238095238,0.299077089450997,21,96,82,14,16,5
"8331","D38","RMDQ16_v1",0,0.439748411324023,3,114,95,19,3,0
"8332","D39","RMDQ16_v1",0.214285714285714,0.574730143735297,14,103,87,16,11,3
"8333","D4","RMDQ16_v1",0.666666666666667,0.0164317176559626,3,114,97,17,1,2
"8334","D40","RMDQ16_v1",0,0.314265473296222,5,112,93,19,5,0
"8335","D41","RMDQ16_v1",0,0.229572755395786,7,110,91,19,7,0
"8336","D42","RMDQ16_v1",0,0.529944138338696,2,115,96,19,2,0
"8337","D43","RMDQ16_v1",0.5,0.191631215221544,2,115,97,18,1,1
"8338","D44","RMDQ16_v1",0.189189189189189,0.593023300735864,37,80,68,12,30,7
"8339","D45","RMDQ16_v1",0.0833333333333333,0.433119831393324,12,105,87,18,11,1
"8340","D46","RMDQ16_v1",0.189189189189189,0.593023300735864,37,80,68,12,30,7
"8341","D47","RMDQ16_v1",0.166666666666667,0.966202918505237,12,105,88,17,10,2
"8342","D48","RMDQ16_v1",0.153846153846154,0.893411291142895,26,91,76,15,22,4
"8343","D49","RMDQ16_v1",0.0769230769230769,0.375480790918795,13,104,86,18,12,1
"8344","D5","RMDQ16_v1",0.333333333333333,0.416056255685071,3,114,96,18,2,1
"8345","D50","RMDQ16_v1",0,0.658337884368623,1,116,97,19,1,0
"8346","D51","RMDQ16_v1",1,0.0225562523721356,1,116,98,18,0,1
"8347","D52","RMDQ16_v1",0,0.658337884368623,1,116,97,19,1,0
"8348","D53","RMDQ16_v1",1,0.0225562523721356,1,116,98,18,0,1
"8349","D9","RMDQ16_v1",1,0.0225562523721356,1,116,98,18,0,1
"8350","RMDQ1_v1","RMDQ16_v1",0.352941176470588,4.53186243686946e-08,85,134,127,7,55,30
"8351","RMDQ2_v1","RMDQ16_v1",0.333333333333333,3.52642005073268e-07,90,129,122,7,60,30
"8352","RMDQ3_v1","RMDQ16_v1",0.40506329113924,2.04450175535716e-12,79,141,136,5,47,32
"8353","RMDQ4_v1","RMDQ16_v1",0.203703703703704,0.421727933842598,54,166,140,26,43,11
"8354","RMDQ5_v1","RMDQ16_v1",0.444444444444444,2.15101371218421e-14,72,148,143,5,40,32
"8355","RMDQ6_v1","RMDQ16_v1",0.589285714285714,1.70176558457016e-22,56,164,160,4,23,33
"8356","RMDQ7_v1","RMDQ16_v1",0.82051282051282,3.22770470404949e-33,39,181,176,5,7,32
"8357","RMDQ8_v1","RMDQ16_v1",0.875,5.18254372179348e-08,8,212,182,30,1,7
"8358","RMDQ9_v1","RMDQ16_v1",0.941176470588235,3.04597864637659e-39,34,186,181,5,2,32
"8359","RMDQ10_v1","RMDQ16_v1",0.8,3.41710399034611e-32,40,180,175,5,8,32
"8360","RMDQ11_v1","RMDQ16_v1",0.761904761904762,2.73669003394032e-30,42,178,173,5,10,32
"8361","RMDQ12_v1","RMDQ16_v1",0.727272727272727,1.47323611159845e-28,44,176,171,5,12,32
"8362","RMDQ13_v1","RMDQ16_v1",0.760869565217391,1.27148398890014e-33,46,174,172,2,11,35
"8363","RMDQ14_v1","RMDQ16_v1",0.653061224489796,7.57897393539647e-25,49,171,166,5,17,32
"8364","RMDQ15_v1","RMDQ16_v1",0.870967741935484,1.52047338237707e-29,31,189,179,10,4,27
"8365","RMDQ16_v1","RMDQ16_v1",1,9.04447975804488e-50,37,183,183,0,0,37
"8366","RMDQ17_v1","RMDQ16_v1",0.693877551020408,6.44024441045586e-29,49,171,168,3,15,34
"8367","RMDQ18_v1","RMDQ16_v1",0.861111111111111,5.42599230399142e-34,36,184,178,6,5,31
"8368","RMDQ19_v1","RMDQ16_v1",0.9375,2.50106579418143e-36,32,188,181,7,2,30
"8369","RMDQ20_v1","RMDQ16_v1",0.868421052631579,6.84880214391621e-37,38,182,178,4,5,33
"8370","RMDQ21_v1","RMDQ16_v1",0.666666666666667,1.58117638108734e-25,48,172,167,5,16,32
"8371","RMDQ22_v1","RMDQ16_v1",0.815789473684211,8.45258776283249e-32,38,182,176,6,7,31
"8372","RMDQ23_v1","RMDQ16_v1",0.837837837837838,7.24914946220842e-33,37,183,177,6,6,31
"8373","RMDQ24_v1","RMDQ16_v1",0.914285714285714,6.70026680622147e-38,35,185,180,5,3,32
"8374","DN4 - Queimação","RMDQ16_v1",0.14,0.394823566882916,100,109,89,20,86,14
"8375","DN4 - Sensação de frio dolorosa","RMDQ16_v1",0.0638297872340425,0.035773360480661,47,161,130,31,44,3
"8376","DN4 - Choque elétrico","RMDQ16_v1",0.1,0.132283299607425,60,152,124,28,54,6
"8377","DN4 - Formigamento","RMDQ16_v1",0.107142857142857,0.205674311599173,56,156,128,28,50,6
"8378","DN4 - Alfinetada e agulhada","RMDQ16_v1",0.225806451612903,0.0951028251111057,62,150,130,20,48,14
"8379","DN4 - Adormecimento","RMDQ16_v1",0.220338983050847,0.156632936691205,59,150,129,21,46,13
"8380","DN4 - Coceira","RMDQ16_v1",0.181818181818182,0.842248038288819,11,201,169,32,9,2
"8381","DH4 - Hipoestesia ao toque","RMDQ16_v1",0.571428571428571,0.00257951051202975,7,205,175,30,3,4
"8382","DN4 - Hipoestesia a picada de agulha","RMDQ16_v1",0.571428571428571,0.00257951051202975,7,205,175,30,3,4
"8383","DN4 - Escovação","RMDQ16_v1",0.666666666666667,0.000607086316376842,6,206,176,30,2,4
"8384","Fuma","RMDQ17_v1",0.25,0.610776724454523,36,147,116,31,27,9
"8385","Cirurgia na coluna","RMDQ17_v1",0.235294117647059,0.445253196569288,68,127,103,24,52,16
"8386","Aposentado","RMDQ17_v1",0.242424242424242,0.714298197771417,33,150,118,32,25,8
"8387","Desempregado","RMDQ17_v1",0.269230769230769,0.49264179642995,26,153,121,32,19,7
"8388","Licenca_Medica","RMDQ17_v1",0.210526315789474,0.907459721336339,19,162,126,36,15,4
"8389","Aposentado_Invalidez","RMDQ17_v1",0.375,0.292477195226406,8,171,134,37,5,3
"8390","Analgésicos","RMDQ17_v1",0.24822695035461,0.0955380427032517,141,57,49,8,106,35
"8391","OutraDoenca","RMDQ17_v1",0.346666666666667,0.000844379623581643,75,114,98,16,49,26
"8392","Dor nas costas","RMDQ17_v1",0.252032520325203,0.163213774684252,123,67,56,11,92,31
"8393","Dor nas pernas","RMDQ17_v1",0.215384615384615,0.847813712224347,65,123,95,28,51,14
"8394","Retornar_trabalho","RMDQ17_v1",0.315789473684211,0.253188258722443,19,168,134,34,13,6
"8395","Masc","RMDQ17_v1",0.248322147651007,0.186245757731077,149,71,59,12,112,37
"8396","Fem","RMDQ17_v1",0.169014084507042,0.186245757731077,71,149,112,37,59,12
"8397","Casado/Amasiaado","RMDQ17_v1",0.222222222222222,0.815234880579339,81,101,80,21,63,18
"8398","Solteiro","RMDQ17_v1",0.2,0.694149066116179,75,107,83,24,60,15
"8399","Separado_Divorciado","RMDQ17_v1",0.285714285714286,0.638578518137544,7,175,138,37,5,2
"8400","X4","RMDQ17_v1",0,0.361725325701722,3,179,140,39,3,0
"8401","X5","RMDQ17_v1",0.25,0.860276094665209,4,178,140,38,3,1
"8402","X6","RMDQ17_v1",0.25,0.755062199425663,12,170,134,36,9,3
"8403","Livrar_costas","RMDQ17_v1",0.224299065420561,0.36421929783921,107,16,14,2,83,24
"8404","Livrar_perna","RMDQ17_v1",0.142857142857143,0.504714328746874,14,109,85,24,12,2
"8405","Livrar_perda_sens","RMDQ17_v1",0,0.460391234966393,2,121,95,26,2,0
"8406","D1","RMDQ17_v1",0,0.628885363875848,1,116,94,22,1,0
"8407","D15","RMDQ17_v1",0.142857142857143,0.752394853272729,7,110,89,21,6,1
"8408","D16","RMDQ17_v1",0.2,0.88044108578768,20,97,79,18,16,4
"8409","D17","RMDQ17_v1",0,0.271414036674767,5,112,90,22,5,0
"8410","D18","RMDQ17_v1",0.230769230769231,0.675758112096709,13,104,85,19,10,3
"8411","D19","RMDQ17_v1",0.333333333333333,0.349709263533331,6,111,91,20,4,2
"8412","D2","RMDQ17_v1",0.25,0.642133382304007,8,109,89,20,6,2
"8413","D20","RMDQ17_v1",0.142857142857143,0.752394853272729,7,110,89,21,6,1
"8414","D21","RMDQ17_v1",0.142857142857143,0.752394853272729,7,110,89,21,6,1
"8415","D22","RMDQ17_v1",1,0.0368916317321308,1,116,95,21,0,1
"8416","D23","RMDQ17_v1",0,0.492429745624424,2,115,93,22,2,0
"8417","D24","RMDQ17_v1",0.0416666666666667,0.0395586887338147,24,93,72,21,23,1
"8418","D25","RMDQ17_v1",0,0.398443266068114,3,114,92,22,3,0
"8419","D26","RMDQ17_v1",0.5,0.254752373169046,2,115,94,21,1,1
"8420","D27","RMDQ17_v1",0.5,0.10420237747905,4,113,93,20,2,2
"8421","D28","RMDQ17_v1",0.2,0.944203181175876,5,112,91,21,4,1
"8422","D29","RMDQ17_v1",0.19047619047619,0.959653987902759,42,75,61,14,34,8
"8423","D3","RMDQ17_v1",0.5,0.254752373169046,2,115,94,21,1,1
"8424","Lombalgia","RMDQ17_v1",0.213114754098361,0.468681529434374,61,56,47,9,48,13
"8425","D31","RMDQ17_v1",0.176470588235294,0.894996496016723,17,100,81,19,14,3
"8426","D32","RMDQ17_v1",0.189189189189189,0.982651985520405,37,80,65,15,30,7
"8427","D33","RMDQ17_v1",0.0833333333333333,0.327168795969465,12,105,84,21,11,1
"8428","D34","RMDQ17_v1",0.5,0.254752373169046,2,115,94,21,1,1
"8429","D35","RMDQ17_v1",1,0.0368916317321308,1,116,95,21,0,1
"8430","D36","RMDQ17_v1",0,0.189151958767347,7,110,88,22,7,0
"8431","D37","RMDQ17_v1",0.19047619047619,0.974777189156348,21,96,78,18,17,4
"8432","D38","RMDQ17_v1",0,0.398443266068114,3,114,92,22,3,0
"8433","D39","RMDQ17_v1",0.142857142857143,0.644746851913485,14,103,83,20,12,2
"8434","D4","RMDQ17_v1",0.666666666666667,0.031603186824878,3,114,94,20,1,2
"8435","D40","RMDQ17_v1",0,0.271414036674767,5,112,90,22,5,0
"8436","D41","RMDQ17_v1",0,0.189151958767347,7,110,88,22,7,0
"8437","D42","RMDQ17_v1",0.5,0.254752373169046,2,115,94,21,1,1
"8438","D43","RMDQ17_v1",0.5,0.254752373169046,2,115,94,21,1,1
"8439","D44","RMDQ17_v1",0.162162162162162,0.626208269250909,37,80,64,16,31,6
"8440","D45","RMDQ17_v1",0.0833333333333333,0.327168795969465,12,105,84,21,11,1
"8441","D46","RMDQ17_v1",0.162162162162162,0.626208269250909,37,80,64,16,31,6
"8442","D47","RMDQ17_v1",0.166666666666667,0.8415073123212,12,105,85,20,10,2
"8443","D48","RMDQ17_v1",0.115384615384615,0.282378909506142,26,91,72,19,23,3
"8444","D49","RMDQ17_v1",0.0769230769230769,0.27682819675887,13,104,83,21,12,1
"8445","D5","RMDQ17_v1",0.333333333333333,0.514082165897887,3,114,93,21,2,1
"8446","D50","RMDQ17_v1",0,0.628885363875848,1,116,94,22,1,0
"8447","D51","RMDQ17_v1",1,0.0368916317321308,1,116,95,21,0,1
"8448","D52","RMDQ17_v1",0,0.628885363875848,1,116,94,22,1,0
"8449","D53","RMDQ17_v1",0,0.628885363875848,1,116,94,22,1,0
"8450","D9","RMDQ17_v1",1,0.0368916317321308,1,116,95,21,0,1
"8451","RMDQ1_v1","RMDQ17_v1",0.411764705882353,5.99187808282579e-07,85,134,120,14,50,35
"8452","RMDQ2_v1","RMDQ17_v1",0.411111111111111,1.61969694346102e-07,90,129,117,12,53,37
"8453","RMDQ3_v1","RMDQ17_v1",0.518987341772152,2.67418826934506e-15,79,141,133,8,38,41
"8454","RMDQ4_v1","RMDQ17_v1",0.351851851851852,0.00865561410133531,54,166,136,30,35,19
"8455","RMDQ5_v1","RMDQ17_v1",0.569444444444444,6.64752924286541e-18,72,148,140,8,31,41
"8456","RMDQ6_v1","RMDQ17_v1",0.696428571428571,5.74846908770791e-23,56,164,154,10,17,39
"8457","RMDQ7_v1","RMDQ17_v1",0.794871794871795,2.86539143881379e-21,39,181,163,18,8,31
"8458","RMDQ8_v1","RMDQ17_v1",0.875,6.27400194866598e-06,8,212,170,42,1,7
"8459","RMDQ9_v1","RMDQ17_v1",0.911764705882353,8.47487722220644e-26,34,186,168,18,3,31
"8460","RMDQ10_v1","RMDQ17_v1",0.825,4.45683909243186e-24,40,180,164,16,7,33
"8461","RMDQ11_v1","RMDQ17_v1",0.785714285714286,1.86670439068414e-22,42,178,162,16,9,33
"8462","RMDQ12_v1","RMDQ17_v1",0.75,5.5520928346739e-21,44,176,160,16,11,33
"8463","RMDQ13_v1","RMDQ17_v1",0.739130434782609,2.92919435879067e-21,46,174,159,15,12,34
"8464","RMDQ14_v1","RMDQ17_v1",0.673469387755102,7.87915863197901e-18,49,171,155,16,16,33
"8465","RMDQ15_v1","RMDQ17_v1",0.870967741935484,8.05841936383107e-21,31,189,167,22,4,27
"8466","RMDQ16_v1","RMDQ17_v1",0.918918918918919,6.44024441045586e-29,37,183,168,15,3,34
"8467","RMDQ17_v1","RMDQ17_v1",1,9.04447975804488e-50,49,171,171,0,0,49
"8468","RMDQ18_v1","RMDQ17_v1",0.916666666666667,7.24780935552451e-28,36,184,168,16,3,33
"8469","RMDQ19_v1","RMDQ17_v1",0.9375,7.57394242815375e-26,32,188,169,19,2,30
"8470","RMDQ20_v1","RMDQ17_v1",0.921052631578947,5.56955305021044e-30,38,182,168,14,3,35
"8471","RMDQ21_v1","RMDQ17_v1",0.75,3.09645348653985e-23,48,172,159,13,12,36
"8472","RMDQ22_v1","RMDQ17_v1",0.868421052631579,7.16027453909365e-26,38,182,166,16,5,33
"8473","RMDQ23_v1","RMDQ17_v1",0.891891891891892,7.66785369720488e-27,37,183,167,16,4,33
"8474","RMDQ24_v1","RMDQ17_v1",0.942857142857143,5.98266303908852e-29,35,185,169,16,2,33
"8475","DN4 - Queimação","RMDQ17_v1",0.18,0.234217519719875,100,109,82,27,82,18
"8476","DN4 - Sensação de frio dolorosa","RMDQ17_v1",0.148936170212766,0.202054732293545,47,161,123,38,40,7
"8477","DN4 - Choque elétrico","RMDQ17_v1",0.166666666666667,0.307690766607806,60,152,117,35,50,10
"8478","DN4 - Formigamento","RMDQ17_v1",0.178571428571429,0.472265128431607,56,156,121,35,46,10
"8479","DN4 - Alfinetada e agulhada","RMDQ17_v1",0.290322580645161,0.073947616220736,62,150,123,27,44,18
"8480","DN4 - Adormecimento","RMDQ17_v1",0.288135593220339,0.108189325659196,59,150,122,28,42,17
"8481","DN4 - Coceira","RMDQ17_v1",0.181818181818182,0.799796400427567,11,201,158,43,9,2
"8482","DH4 - Hipoestesia ao toque","RMDQ17_v1",0.571428571428571,0.0181167666764295,7,205,164,41,3,4
"8483","DN4 - Hipoestesia a picada de agulha","RMDQ17_v1",0.571428571428571,0.0181167666764295,7,205,164,41,3,4
"8484","DN4 - Escovação","RMDQ17_v1",0.666666666666667,0.00575622969320227,6,206,165,41,2,4
"8485","Fuma","RMDQ18_v1",0.25,0.150294452815812,36,147,125,22,27,9
"8486","Cirurgia na coluna","RMDQ18_v1",0.176470588235294,0.425453756427533,68,127,110,17,56,12
"8487","Aposentado","RMDQ18_v1",0.181818181818182,0.759218672015919,33,150,126,24,27,6
"8488","Desempregado","RMDQ18_v1",0.269230769230769,0.133426357263689,26,153,130,23,19,7
"8489","Licenca_Medica","RMDQ18_v1",0.210526315789474,0.578996382117435,19,162,136,26,15,4
"8490","Aposentado_Invalidez","RMDQ18_v1",0.375,0.108078495180126,8,171,144,27,5,3
"8491","Analgésicos","RMDQ18_v1",0.212765957446809,0.00618949664597304,141,57,54,3,111,30
"8492","OutraDoenca","RMDQ18_v1",0.226666666666667,0.0881291314127013,75,114,99,15,58,17
"8493","Dor nas costas","RMDQ18_v1",0.219512195121951,0.00439466950630126,123,67,63,4,96,27
"8494","Dor nas pernas","RMDQ18_v1",0.215384615384615,0.175035103529074,65,123,106,17,51,14
"8495","Retornar_trabalho","RMDQ18_v1",0.315789473684211,0.0773133645580507,19,168,142,26,13,6
"8496","Masc","RMDQ18_v1",0.161073825503356,0.881682998146209,149,71,59,12,125,24
"8497","Fem","RMDQ18_v1",0.169014084507042,0.881682998146209,71,149,125,24,59,12
"8498","Casado/Amasiaado","RMDQ18_v1",0.197530864197531,0.382012910761673,81,101,86,15,65,16
"8499","Solteiro","RMDQ18_v1",0.16,0.756288717982329,75,107,88,19,63,12
"8500","Separado_Divorciado","RMDQ18_v1",0,0.221508821782249,7,175,144,31,7,0
"8501","X4","RMDQ18_v1",0,0.428746611205637,3,179,148,31,3,0
"8502","X5","RMDQ18_v1",0.25,0.668212762738764,4,178,148,30,3,1
"8503","X6","RMDQ18_v1",0.166666666666667,0.972139233880974,12,170,141,29,10,2
"8504","Livrar_costas","RMDQ18_v1",0.196261682242991,0.934261991716333,107,16,13,3,86,21
"8505","Livrar_perna","RMDQ18_v1",0.214285714285714,0.847581168623816,14,109,88,21,11,3
"8506","Livrar_perda_sens","RMDQ18_v1",0,0.482653175722585,2,121,97,24,2,0
"8507","D1","RMDQ18_v1",0,0.648368667298824,1,116,96,20,1,0
"8508","D15","RMDQ18_v1",0.142857142857143,0.838703911858419,7,110,91,19,6,1
"8509","D16","RMDQ18_v1",0.2,0.704583574822705,20,97,81,16,16,4
"8510","D17","RMDQ18_v1",0,0.29938055120971,5,112,92,20,5,0
"8511","D18","RMDQ18_v1",0.307692307692308,0.164769724203116,13,104,88,16,9,4
"8512","D19","RMDQ18_v1",0.333333333333333,0.277999040548378,6,111,93,18,4,2
"8513","D2","RMDQ18_v1",0.25,0.538283058858107,8,109,91,18,6,2
"8514","D20","RMDQ18_v1",0.142857142857143,0.838703911858419,7,110,91,19,6,1
"8515","D21","RMDQ18_v1",0.142857142857143,0.838703911858419,7,110,91,19,6,1
"8516","D22","RMDQ18_v1",1,0.0269843768229582,1,116,97,19,0,1
"8517","D23","RMDQ18_v1",0.5,0.212447592946906,2,115,96,19,1,1
"8518","D24","RMDQ18_v1",0.0833333333333333,0.200990882270354,24,93,75,18,22,2
"8519","D25","RMDQ18_v1",0.333333333333333,0.449093732608259,3,114,95,19,2,1
"8520","D26","RMDQ18_v1",0.5,0.212447592946906,2,115,96,19,1,1
"8521","D27","RMDQ18_v1",0.75,0.00174601392465509,4,113,96,17,1,3
"8522","D28","RMDQ18_v1",0.4,0.164346148470325,5,112,94,18,3,2
"8523","D29","RMDQ18_v1",0.19047619047619,0.674443958608444,42,75,63,12,34,8
"8524","D3","RMDQ18_v1",0.5,0.212447592946906,2,115,96,19,1,1
"8525","Lombalgia","RMDQ18_v1",0.229508196721311,0.0790298022673549,61,56,50,6,47,14
"8526","D31","RMDQ18_v1",0.176470588235294,0.947761616195463,17,100,83,17,14,3
"8527","D32","RMDQ18_v1",0.189189189189189,0.721396218577618,37,80,67,13,30,7
"8528","D33","RMDQ18_v1",0.0833333333333333,0.394788570407184,12,105,86,19,11,1
"8529","D34","RMDQ18_v1",0.5,0.212447592946906,2,115,96,19,1,1
"8530","D35","RMDQ18_v1",1,0.0269843768229582,1,116,97,19,0,1
"8531","D36","RMDQ18_v1",0,0.215341871421237,7,110,90,20,7,0
"8532","D37","RMDQ18_v1",0.19047619047619,0.792908618695523,21,96,80,16,17,4
"8533","D38","RMDQ18_v1",0,0.425587509741219,3,114,94,20,3,0
"8534","D39","RMDQ18_v1",0.142857142857143,0.7660951104274,14,103,85,18,12,2
"8535","D4","RMDQ18_v1",0.666666666666667,0.0208539320778979,3,114,96,18,1,2
"8536","D40","RMDQ18_v1",0,0.29938055120971,5,112,92,20,5,0
"8537","D41","RMDQ18_v1",0,0.215341871421237,7,110,90,20,7,0
"8538","D42","RMDQ18_v1",0.5,0.212447592946906,2,115,96,19,1,1
"8539","D43","RMDQ18_v1",0.5,0.212447592946906,2,115,96,19,1,1
"8540","D44","RMDQ18_v1",0.162162162162162,0.863810235831744,37,80,66,14,31,6
"8541","D45","RMDQ18_v1",0.0833333333333333,0.394788570407184,12,105,86,19,11,1
"8542","D46","RMDQ18_v1",0.162162162162162,0.863810235831744,37,80,66,14,31,6
"8543","D47","RMDQ18_v1",0.166666666666667,0.966888916247175,12,105,87,18,10,2
"8544","D48","RMDQ18_v1",0.115384615384615,0.393526014899011,26,91,74,17,23,3
"8545","D49","RMDQ18_v1",0.0769230769230769,0.339537234605017,13,104,85,19,12,1
"8546","D5","RMDQ18_v1",0.333333333333333,0.449093732608259,3,114,95,19,2,1
"8547","D50","RMDQ18_v1",0,0.648368667298824,1,116,96,20,1,0
"8548","D51","RMDQ18_v1",1,0.0269843768229582,1,116,97,19,0,1
"8549","D52","RMDQ18_v1",0,0.648368667298824,1,116,96,20,1,0
"8550","D53","RMDQ18_v1",0,0.648368667298824,1,116,96,20,1,0
"8551","D9","RMDQ18_v1",1,0.0269843768229582,1,116,97,19,0,1
"8552","RMDQ1_v1","RMDQ18_v1",0.329411764705882,9.00574812795764e-07,85,134,126,8,57,28
"8553","RMDQ2_v1","RMDQ18_v1",0.355555555555556,1.25170659308546e-09,90,129,125,4,58,32
"8554","RMDQ3_v1","RMDQ18_v1",0.417721518987342,2.43460663739859e-14,79,141,138,3,46,33
"8555","RMDQ4_v1","RMDQ18_v1",0.240740740740741,0.0778707674352351,54,166,143,23,41,13
"8556","RMDQ5_v1","RMDQ18_v1",0.458333333333333,1.70641682108911e-16,72,148,145,3,39,33
"8557","RMDQ6_v1","RMDQ18_v1",0.589285714285714,2.01386881098122e-23,56,164,161,3,23,33
"8558","RMDQ7_v1","RMDQ18_v1",0.794871794871795,7.24419482876699e-32,39,181,176,5,8,31
"8559","RMDQ8_v1","RMDQ18_v1",0.875,3.01749370049668e-08,8,212,183,29,1,7
"8560","RMDQ9_v1","RMDQ18_v1",0.911764705882353,1.19896882997217e-37,34,186,181,5,3,31
"8561","RMDQ10_v1","RMDQ18_v1",0.875,3.29618584049123e-41,40,180,179,1,5,35
"8562","RMDQ11_v1","RMDQ18_v1",0.833333333333333,6.99542001857602e-39,42,178,177,1,7,35
"8563","RMDQ12_v1","RMDQ18_v1",0.75,6.68116231744111e-32,44,176,173,3,11,33
"8564","RMDQ13_v1","RMDQ18_v1",0.673913043478261,7.04483602308015e-26,46,174,169,5,15,31
"8565","RMDQ14_v1","RMDQ18_v1",0.714285714285714,3.14587991293682e-32,49,171,170,1,14,35
"8566","RMDQ15_v1","RMDQ18_v1",0.870967741935484,1.56181925140462e-30,31,189,180,9,4,27
"8567","RMDQ16_v1","RMDQ18_v1",0.837837837837838,5.42599230399142e-34,37,183,178,5,6,31
"8568","RMDQ17_v1","RMDQ18_v1",0.673469387755102,7.24780935552451e-28,49,171,168,3,16,33
"8569","RMDQ18_v1","RMDQ18_v1",1,9.04447975804488e-50,36,184,184,0,0,36
"8570","RMDQ19_v1","RMDQ18_v1",0.9375,1.62440250336199e-37,32,188,182,6,2,30
"8571","RMDQ20_v1","RMDQ18_v1",0.868421052631579,3.8622169865704e-38,38,182,179,3,5,33
"8572","RMDQ21_v1","RMDQ18_v1",0.729166666666667,4.6308617057448e-33,48,172,171,1,13,35
"8573","RMDQ22_v1","RMDQ18_v1",0.868421052631579,3.8622169865704e-38,38,182,179,3,5,33
"8574","RMDQ23_v1","RMDQ18_v1",0.891891891891892,2.24484708691214e-39,37,183,180,3,4,33
"8575","RMDQ24_v1","RMDQ18_v1",0.942857142857143,4.66382581652858e-42,35,185,182,3,2,33
"8576","DN4 - Queimação","RMDQ18_v1",0.15,0.798647651088386,100,109,94,15,85,15
"8577","DN4 - Sensação de frio dolorosa","RMDQ18_v1",0.0638297872340425,0.0745392795527733,47,161,134,27,44,3
"8578","DN4 - Choque elétrico","RMDQ18_v1",0.1,0.275954597741857,60,152,128,24,54,6
"8579","DN4 - Formigamento","RMDQ18_v1",0.107142857142857,0.389704980538703,56,156,132,24,50,6
"8580","DN4 - Alfinetada e agulhada","RMDQ18_v1",0.225806451612903,0.0235762076742553,62,150,134,16,48,14
"8581","DN4 - Adormecimento","RMDQ18_v1",0.23728813559322,0.01534126871084,59,150,134,16,45,14
"8582","DN4 - Coceira","RMDQ18_v1",0.181818181818182,0.693642072654427,11,201,173,28,9,2
"8583","DH4 - Hipoestesia ao toque","RMDQ18_v1",0.571428571428571,0.000904416361714182,7,205,179,26,3,4
"8584","DN4 - Hipoestesia a picada de agulha","RMDQ18_v1",0.571428571428571,0.000904416361714182,7,205,179,26,3,4
"8585","DN4 - Escovação","RMDQ18_v1",0.666666666666667,0.000181095024232787,6,206,180,26,2,4
"8586","Fuma","RMDQ19_v1",0.222222222222222,0.198035355349415,36,147,127,20,28,8
"8587","Cirurgia na coluna","RMDQ19_v1",0.191176470588235,0.118864274131215,68,127,113,14,55,13
"8588","Aposentado","RMDQ19_v1",0.151515151515152,0.863800455842768,33,150,129,21,28,5
"8589","Desempregado","RMDQ19_v1",0.115384615384615,0.640146102216178,26,153,130,23,23,3
"8590","Licenca_Medica","RMDQ19_v1",0.210526315789474,0.379630163175822,19,162,140,22,15,4
"8591","Aposentado_Invalidez","RMDQ19_v1",0.5,0.00357403624347196,8,171,149,22,4,4
"8592","Analgésicos","RMDQ19_v1",0.184397163120567,0.0175813141576387,141,57,54,3,115,26
"8593","OutraDoenca","RMDQ19_v1",0.186666666666667,0.226639067524949,75,114,100,14,61,14
"8594","Dor nas costas","RMDQ19_v1",0.178861788617886,0.0492877297742991,123,67,62,5,101,22
"8595","Dor nas pernas","RMDQ19_v1",0.215384615384615,0.0413763918885079,65,123,110,13,51,14
"8596","Retornar_trabalho","RMDQ19_v1",0.210526315789474,0.38682096479595,19,168,145,23,15,4
"8597","Masc","RMDQ19_v1",0.147651006711409,0.89350918762575,149,71,61,10,127,22
"8598","Fem","RMDQ19_v1",0.140845070422535,0.89350918762575,71,149,127,22,61,10
"8599","Casado/Amasiaado","RMDQ19_v1",0.172839506172839,0.405226573198601,81,101,88,13,67,14
"8600","Solteiro","RMDQ19_v1",0.133333333333333,0.633204949012387,75,107,90,17,65,10
"8601","Separado_Divorciado","RMDQ19_v1",0,0.260117965806364,7,175,148,27,7,0
"8602","X4","RMDQ19_v1",0,0.466044467910479,3,179,152,27,3,0
"8603","X5","RMDQ19_v1",0.25,0.563037780257756,4,178,152,26,3,1
"8604","X6","RMDQ19_v1",0.166666666666667,0.853475696193983,12,170,145,25,10,2
"8605","Livrar_costas","RMDQ19_v1",0.168224299065421,0.662098688194421,107,16,14,2,89,18
"8606","Livrar_perna","RMDQ19_v1",0.142857142857143,0.831578880879003,14,109,91,18,12,2
"8607","Livrar_perda_sens","RMDQ19_v1",0,0.529803457460897,2,121,101,20,2,0
"8608","D1","RMDQ19_v1",0,0.689357768311308,1,116,100,16,1,0
"8609","D15","RMDQ19_v1",0.142857142857143,0.961330653334592,7,110,95,15,6,1
"8610","D16","RMDQ19_v1",0.3,0.0196143295292612,20,97,87,10,14,6
"8611","D17","RMDQ19_v1",0,0.363013858556909,5,112,96,16,5,0
"8612","D18","RMDQ19_v1",0.153846153846154,0.849102045227504,13,104,90,14,11,2
"8613","D19","RMDQ19_v1",0.166666666666667,0.826685272526541,6,111,96,15,5,1
"8614","D2","RMDQ19_v1",0.25,0.334107901877522,8,109,95,14,6,2
"8615","D20","RMDQ19_v1",0,0.277462300625661,7,110,94,16,7,0
"8616","D21","RMDQ19_v1",0,0.277462300625661,7,110,94,16,7,0
"8617","D22","RMDQ19_v1",0,0.689357768311308,1,116,100,16,1,0
"8618","D23","RMDQ19_v1",0,0.570203696419443,2,115,99,16,2,0
"8619","D24","RMDQ19_v1",0.0416666666666667,0.128341404212721,24,93,78,15,23,1
"8620","D25","RMDQ19_v1",0,0.48493089059007,3,114,98,16,3,0
"8621","D26","RMDQ19_v1",0,0.570203696419443,2,115,99,16,2,0
"8622","D27","RMDQ19_v1",0.5,0.0314326132122058,4,113,99,14,2,2
"8623","D28","RMDQ19_v1",0.2,0.673968889771742,5,112,97,15,4,1
"8624","D29","RMDQ19_v1",0.214285714285714,0.0677608838433293,42,75,68,7,33,9
"8625","D3","RMDQ19_v1",0.5,0.131531494087171,2,115,100,15,1,1
"8626","Lombalgia","RMDQ19_v1",0.19672131147541,0.0487911470170059,61,56,52,4,49,12
"8627","D31","RMDQ19_v1",0.117647058823529,0.804143372262422,17,100,86,14,15,2
"8628","D32","RMDQ19_v1",0.243243243243243,0.0226100314380063,37,80,73,7,28,9
"8629","D33","RMDQ19_v1",0.0833333333333333,0.569679711109244,12,105,90,15,11,1
"8630","D34","RMDQ19_v1",0.5,0.131531494087171,2,115,100,15,1,1
"8631","D35","RMDQ19_v1",1,0.0116267347685025,1,116,101,15,0,1
"8632","D36","RMDQ19_v1",0,0.277462300625661,7,110,94,16,7,0
"8633","D37","RMDQ19_v1",0.285714285714286,0.0282821226473738,21,96,86,10,15,6
"8634","D38","RMDQ19_v1",0,0.48493089059007,3,114,98,16,3,0
"8635","D39","RMDQ19_v1",0.214285714285714,0.368174471926226,14,103,90,13,11,3
"8636","D4","RMDQ19_v1",0.666666666666667,0.00680423952160824,3,114,100,14,1,2
"8637","D40","RMDQ19_v1",0,0.363013858556909,5,112,96,16,5,0
"8638","D41","RMDQ19_v1",0.142857142857143,0.961330653334592,7,110,95,15,6,1
"8639","D42","RMDQ19_v1",0,0.570203696419443,2,115,99,16,2,0
"8640","D43","RMDQ19_v1",0,0.570203696419443,2,115,99,16,2,0
"8641","D44","RMDQ19_v1",0.189189189189189,0.261577523539599,37,80,71,9,30,7
"8642","D45","RMDQ19_v1",0.0833333333333333,0.569679711109244,12,105,90,15,11,1
"8643","D46","RMDQ19_v1",0.216216216216216,0.0888837729206359,37,80,72,8,29,8
"8644","D47","RMDQ19_v1",0.166666666666667,0.750201993823347,12,105,91,14,10,2
"8645","D48","RMDQ19_v1",0.192307692307692,0.349854895890217,26,91,80,11,21,5
"8646","D49","RMDQ19_v1",0.0769230769230769,0.505459059896831,13,104,89,15,12,1
"8647","D5","RMDQ19_v1",0.333333333333333,0.315406941789669,3,114,99,15,2,1
"8648","D50","RMDQ19_v1",0,0.689357768311308,1,116,100,16,1,0
"8649","D51","RMDQ19_v1",1,0.0116267347685025,1,116,101,15,0,1
"8650","D52","RMDQ19_v1",0,0.689357768311308,1,116,100,16,1,0
"8651","D53","RMDQ19_v1",0,0.689357768311308,1,116,100,16,1,0
"8652","D9","RMDQ19_v1",1,0.0116267347685025,1,116,101,15,0,1
"8653","RMDQ1_v1","RMDQ19_v1",0.329411764705882,6.44774590091149e-09,85,134,130,4,57,28
"8654","RMDQ2_v1","RMDQ19_v1",0.3,4.38773576836436e-07,90,129,124,5,63,27
"8655","RMDQ3_v1","RMDQ19_v1",0.379746835443038,1.60614407592184e-13,79,141,139,2,49,30
"8656","RMDQ4_v1","RMDQ19_v1",0.148148148148148,0.948465952717107,54,166,142,24,46,8
"8657","RMDQ5_v1","RMDQ19_v1",0.430555555555556,5.96423312338212e-17,72,148,147,1,41,31
"8658","RMDQ6_v1","RMDQ19_v1",0.553571428571429,1.08997105246467e-23,56,164,163,1,25,31
"8659","RMDQ7_v1","RMDQ19_v1",0.794871794871795,7.41541968676058e-37,39,181,180,1,8,31
"8660","RMDQ8_v1","RMDQ19_v1",0.875,2.48801829643636e-09,8,212,187,25,1,7
"8661","RMDQ9_v1","RMDQ19_v1",0.911764705882353,3.1920770092871e-43,34,186,185,1,3,31
"8662","RMDQ10_v1","RMDQ19_v1",0.775,8.97406152632487e-36,40,180,179,1,9,31
"8663","RMDQ11_v1","RMDQ19_v1",0.738095238095238,9.21662154873218e-34,42,178,177,1,11,31
"8664","RMDQ12_v1","RMDQ19_v1",0.704545454545455,6.22288812484457e-32,44,176,175,1,13,31
"8665","RMDQ13_v1","RMDQ19_v1",0.673913043478261,2.91738355065417e-30,46,174,173,1,15,31
"8666","RMDQ14_v1","RMDQ19_v1",0.612244897959184,7.57394242815375e-26,49,171,169,2,19,30
"8667","RMDQ15_v1","RMDQ19_v1",0.870967741935484,4.21577239144344e-35,31,189,184,5,4,27
"8668","RMDQ16_v1","RMDQ19_v1",0.810810810810811,2.50106579418143e-36,37,183,181,2,7,30
"8669","RMDQ17_v1","RMDQ19_v1",0.612244897959184,7.57394242815375e-26,49,171,169,2,19,30
"8670","RMDQ18_v1","RMDQ19_v1",0.833333333333333,1.62440250336199e-37,36,184,182,2,6,30
"8671","RMDQ19_v1","RMDQ19_v1",1,9.04447975804488e-50,32,188,188,0,0,32
"8672","RMDQ20_v1","RMDQ19_v1",0.815789473684211,5.37655401110131e-38,38,182,181,1,7,31
"8673","RMDQ21_v1","RMDQ19_v1",0.645833333333333,9.93950282782106e-29,48,172,171,1,17,31
"8674","RMDQ22_v1","RMDQ19_v1",0.815789473684211,5.37655401110131e-38,38,182,181,1,7,31
"8675","RMDQ23_v1","RMDQ19_v1",0.837837837837838,3.38449294022428e-39,37,183,182,1,6,31
"8676","RMDQ24_v1","RMDQ19_v1",0.885714285714286,8.36196224498593e-42,35,185,184,1,4,31
"8677","DN4 - Queimação","RMDQ19_v1",0.15,0.94798014608573,100,109,93,16,85,15
"8678","DN4 - Sensação de frio dolorosa","RMDQ19_v1",0.0851063829787234,0.161847157985229,47,161,134,27,43,4
"8679","DN4 - Choque elétrico","RMDQ19_v1",0.116666666666667,0.4440860960561,60,152,128,24,53,7
"8680","DN4 - Formigamento","RMDQ19_v1",0.125,0.60022756681232,56,156,132,24,49,7
"8681","DN4 - Alfinetada e agulhada","RMDQ19_v1",0.241935483870968,0.0112243234722338,62,150,134,16,47,15
"8682","DN4 - Adormecimento","RMDQ19_v1",0.254237288135593,0.00689644079596225,59,150,134,16,44,15
"8683","DN4 - Coceira","RMDQ19_v1",0.272727272727273,0.222661254184648,11,201,173,28,8,3
"8684","DH4 - Hipoestesia ao toque","RMDQ19_v1",0.571428571428571,0.00120451487286722,7,205,178,27,3,4
"8685","DN4 - Hipoestesia a picada de agulha","RMDQ19_v1",0.571428571428571,0.00120451487286722,7,205,178,27,3,4
"8686","DN4 - Escovação","RMDQ19_v1",0.666666666666667,0.000252086995375938,6,206,179,27,2,4
"8687","Fuma","RMDQ20_v1",0.305555555555556,0.0212605359177866,36,147,126,21,25,11
"8688","Cirurgia na coluna","RMDQ20_v1",0.191176470588235,0.290413173481526,68,127,110,17,55,13
"8689","Aposentado","RMDQ20_v1",0.212121212121212,0.469882667138764,33,150,126,24,26,7
"8690","Desempregado","RMDQ20_v1",0.192307692307692,0.780457597294657,26,153,127,26,21,5
"8691","Licenca_Medica","RMDQ20_v1",0.210526315789474,0.631171563746075,19,162,135,27,15,4
"8692","Aposentado_Invalidez","RMDQ20_v1",0.5,0.0124440481664514,8,171,144,27,4,4
"8693","Analgésicos","RMDQ20_v1",0.219858156028369,0.00472757738008209,141,57,54,3,110,31
"8694","OutraDoenca","RMDQ20_v1",0.213333333333333,0.190567051079525,75,114,98,16,59,16
"8695","Dor nas costas","RMDQ20_v1",0.219512195121951,0.0107818276470636,123,67,62,5,96,27
"8696","Dor nas pernas","RMDQ20_v1",0.215384615384615,0.230901271720972,65,123,105,18,51,14
"8697","Retornar_trabalho","RMDQ20_v1",0.315789473684211,0.0773133645580507,19,168,142,26,13,6
"8698","Masc","RMDQ20_v1",0.181208053691275,0.629759193064311,149,71,60,11,122,27
"8699","Fem","RMDQ20_v1",0.154929577464789,0.629759193064311,71,149,122,27,60,11
"8700","Casado/Amasiaado","RMDQ20_v1",0.197530864197531,0.490880536568513,81,101,85,16,65,16
"8701","Solteiro","RMDQ20_v1",0.146666666666667,0.386973721497225,75,107,86,21,64,11
"8702","Separado_Divorciado","RMDQ20_v1",0,0.212683288254652,7,175,143,32,7,0
"8703","X4","RMDQ20_v1",0,0.419853143376068,3,179,147,32,3,0
"8704","X5","RMDQ20_v1",0.25,0.693532397529908,4,178,147,31,3,1
"8705","X6","RMDQ20_v1",0.333333333333333,0.13805873100664,12,170,142,28,8,4
"8706","Livrar_costas","RMDQ20_v1",0.205607476635514,0.447941658950252,107,16,14,2,85,22
"8707","Livrar_perna","RMDQ20_v1",0.142857142857143,0.600141486098285,14,109,87,22,12,2
"8708","Livrar_perda_sens","RMDQ20_v1",0,0.482653175722585,2,121,97,24,2,0
"8709","D1","RMDQ20_v1",0,0.638555915507599,1,116,95,21,1,0
"8710","D15","RMDQ20_v1",0.142857142857143,0.794517050138976,7,110,90,20,6,1
"8711","D16","RMDQ20_v1",0.25,0.366809488218735,20,97,81,16,15,5
"8712","D17","RMDQ20_v1",0,0.285108215160341,5,112,91,21,5,0
"8713","D18","RMDQ20_v1",0.307692307692308,0.201391507842252,13,104,87,17,9,4
"8714","D19","RMDQ20_v1",0.333333333333333,0.313372258034747,6,111,92,19,4,2
"8715","D2","RMDQ20_v1",0.375,0.135454549151766,8,109,91,18,5,3
"8716","D20","RMDQ20_v1",0.285714285714286,0.450066836690652,7,110,91,19,5,2
"8717","D21","RMDQ20_v1",0.285714285714286,0.450066836690652,7,110,91,19,5,2
"8718","D22","RMDQ20_v1",1,0.0317705146451596,1,116,96,20,0,1
"8719","D23","RMDQ20_v1",0,0.504666956170422,2,115,94,21,2,0
"8720","D24","RMDQ20_v1",0.0833333333333333,0.168580484445162,24,93,74,19,22,2
"8721","D25","RMDQ20_v1",0,0.41182715147907,3,114,93,21,3,0
"8722","D26","RMDQ20_v1",0.5,0.233510138206751,2,115,95,20,1,1
"8723","D27","RMDQ20_v1",0.5,0.0891892591515812,4,113,94,19,2,2
"8724","D28","RMDQ20_v1",0.4,0.189102841692137,5,112,93,19,3,2
"8725","D29","RMDQ20_v1",0.214285714285714,0.462956524719494,42,75,63,12,33,9
"8726","D3","RMDQ20_v1",0.5,0.233510138206751,2,115,95,20,1,1
"8727","Lombalgia","RMDQ20_v1",0.229508196721311,0.141158982275601,61,56,49,7,47,14
"8728","D31","RMDQ20_v1",0.176470588235294,0.972034308139522,17,100,82,18,14,3
"8729","D32","RMDQ20_v1",0.216216216216216,0.481406246914079,37,80,67,13,29,8
"8730","D33","RMDQ20_v1",0.0833333333333333,0.359555505535032,12,105,85,20,11,1
"8731","D34","RMDQ20_v1",0.5,0.233510138206751,2,115,95,20,1,1
"8732","D35","RMDQ20_v1",1,0.0317705146451596,1,116,96,20,0,1
"8733","D36","RMDQ20_v1",0,0.201883895175961,7,110,89,21,7,0
"8734","D37","RMDQ20_v1",0.238095238095238,0.439748411324023,21,96,80,16,16,5
"8735","D38","RMDQ20_v1",0,0.41182715147907,3,114,93,21,3,0
"8736","D39","RMDQ20_v1",0.214285714285714,0.71764382653265,14,103,85,18,11,3
"8737","D4","RMDQ20_v1",0.666666666666667,0.0259094208039915,3,114,95,19,1,2
"8738","D40","RMDQ20_v1",0,0.285108215160341,5,112,91,21,5,0
"8739","D41","RMDQ20_v1",0.142857142857143,0.794517050138976,7,110,90,20,6,1
"8740","D42","RMDQ20_v1",0.5,0.233510138206751,2,115,95,20,1,1
"8741","D43","RMDQ20_v1",1,0.00228920903819295,2,115,96,19,0,2
"8742","D44","RMDQ20_v1",0.162162162162162,0.739817099451421,37,80,65,15,31,6
"8743","D45","RMDQ20_v1",0.0833333333333333,0.359555505535032,12,105,85,20,11,1
"8744","D46","RMDQ20_v1",0.189189189189189,0.852465530180661,37,80,66,14,30,7
"8745","D47","RMDQ20_v1",0.166666666666667,0.902770995656725,12,105,86,19,10,2
"8746","D48","RMDQ20_v1",0.153846153846154,0.699267787550123,26,91,74,17,22,4
"8747","D49","RMDQ20_v1",0.0769230769230769,0.306744119256604,13,104,84,20,12,1
"8748","D5","RMDQ20_v1",0.333333333333333,0.481780260520299,3,114,94,20,2,1
"8749","D50","RMDQ20_v1",0,0.638555915507599,1,116,95,21,1,0
"8750","D51","RMDQ20_v1",1,0.0317705146451596,1,116,96,20,0,1
"8751","D52","RMDQ20_v1",0,0.638555915507599,1,116,95,21,1,0
"8752","D53","RMDQ20_v1",1,0.0317705146451596,1,116,96,20,0,1
"8753","D9","RMDQ20_v1",1,0.0317705146451596,1,116,96,20,0,1
"8754","RMDQ1_v1","RMDQ20_v1",0.364705882352941,1.72875315140032e-08,85,134,127,7,54,31
"8755","RMDQ2_v1","RMDQ20_v1",0.355555555555556,1.82004320823127e-08,90,129,123,6,58,32
"8756","RMDQ3_v1","RMDQ20_v1",0.417721518987342,6.21912955863492e-13,79,141,136,5,46,33
"8757","RMDQ4_v1","RMDQ20_v1",0.222222222222222,0.268004517929777,54,166,140,26,42,12
"8758","RMDQ5_v1","RMDQ20_v1",0.472222222222222,2.47371595353761e-16,72,148,144,4,38,34
"8759","RMDQ6_v1","RMDQ20_v1",0.660714285714286,4.6219951348945e-29,56,164,163,1,19,37
"8760","RMDQ7_v1","RMDQ20_v1",0.846153846153846,1.38533765590654e-34,39,181,176,5,6,33
"8761","RMDQ8_v1","RMDQ20_v1",0.875,8.65541275507187e-08,8,212,181,31,1,7
"8762","RMDQ9_v1","RMDQ20_v1",0.970588235294118,7.40478349902737e-41,34,186,181,5,1,33
"8763","RMDQ10_v1","RMDQ20_v1",0.875,1.39594776624632e-38,40,180,177,3,5,35
"8764","RMDQ11_v1","RMDQ20_v1",0.833333333333333,2.36351824386872e-36,42,178,175,3,7,35
"8765","RMDQ12_v1","RMDQ20_v1",0.795454545454545,2.51363890979545e-34,44,176,173,3,9,35
"8766","RMDQ13_v1","RMDQ20_v1",0.717391304347826,4.33945751062073e-28,46,174,169,5,13,33
"8767","RMDQ14_v1","RMDQ20_v1",0.693877551020408,6.9176345235904e-28,49,171,167,4,15,34
"8768","RMDQ15_v1","RMDQ20_v1",0.870967741935484,1.31370570973966e-28,31,189,178,11,4,27
"8769","RMDQ16_v1","RMDQ20_v1",0.891891891891892,6.84880214391621e-37,37,183,178,5,4,33
"8770","RMDQ17_v1","RMDQ20_v1",0.714285714285714,5.56955305021044e-30,49,171,168,3,14,35
"8771","RMDQ18_v1","RMDQ20_v1",0.916666666666667,3.8622169865704e-38,36,184,179,5,3,33
"8772","RMDQ19_v1","RMDQ20_v1",0.96875,5.37655401110131e-38,32,188,181,7,1,31
"8773","RMDQ20_v1","RMDQ20_v1",1,9.04447975804488e-50,38,182,182,0,0,38
"8774","RMDQ21_v1","RMDQ20_v1",0.729166666666667,8.88911617501351e-31,48,172,169,3,13,35
"8775","RMDQ22_v1","RMDQ20_v1",0.894736842105263,2.50419694842993e-38,38,182,178,4,4,34
"8776","RMDQ23_v1","RMDQ20_v1",0.918918918918919,1.38902562344499e-39,37,183,179,4,3,34
"8777","RMDQ24_v1","RMDQ20_v1",1,2.901511902757e-45,35,185,182,3,0,35
"8778","DN4 - Queimação","RMDQ20_v1",0.14,0.496792633658893,100,109,90,19,86,14
"8779","DN4 - Sensação de frio dolorosa","RMDQ20_v1",0.0638297872340425,0.0431319284443871,47,161,131,30,44,3
"8780","DN4 - Choque elétrico","RMDQ20_v1",0.1,0.160171416672835,60,152,125,27,54,6
"8781","DN4 - Formigamento","RMDQ20_v1",0.107142857142857,0.243015315021093,56,156,129,27,50,6
"8782","DN4 - Alfinetada e agulhada","RMDQ20_v1",0.241935483870968,0.0259007596214018,62,150,132,18,47,15
"8783","DN4 - Adormecimento","RMDQ20_v1",0.23728813559322,0.0483694705066989,59,150,131,19,45,14
"8784","DN4 - Coceira","RMDQ20_v1",0.272727272727273,0.271376225839429,11,201,171,30,8,3
"8785","DH4 - Hipoestesia ao toque","RMDQ20_v1",0.571428571428571,0.00203122329892033,7,205,176,29,3,4
"8786","DN4 - Hipoestesia a picada de agulha","RMDQ20_v1",0.571428571428571,0.00203122329892033,7,205,176,29,3,4
"8787","DN4 - Escovação","RMDQ20_v1",0.666666666666667,0.000460768376442171,6,206,177,29,2,4
"8788","Fuma","RMDQ21_v1",0.305555555555556,0.190621992109653,36,147,117,30,25,11
"8789","Cirurgia na coluna","RMDQ21_v1",0.191176470588235,0.724050556181161,68,127,100,27,55,13
"8790","Aposentado","RMDQ21_v1",0.303030303030303,0.194780065813509,33,150,120,30,23,10
"8791","Desempregado","RMDQ21_v1",0.269230769230769,0.49264179642995,26,153,121,32,19,7
"8792","Licenca_Medica","RMDQ21_v1",0.210526315789474,0.907459721336339,19,162,126,36,15,4
"8793","Aposentado_Invalidez","RMDQ21_v1",0.5,0.0479583982745571,8,171,136,35,4,4
"8794","Analgésicos","RMDQ21_v1",0.276595744680851,0.000482356511369728,141,57,54,3,102,39
"8795","OutraDoenca","RMDQ21_v1",0.28,0.121212851914524,75,114,93,21,54,21
"8796","Dor nas costas","RMDQ21_v1",0.268292682926829,0.0609938629334045,123,67,57,10,90,33
"8797","Dor nas pernas","RMDQ21_v1",0.276923076923077,0.252688384451229,65,123,98,25,47,18
"8798","Retornar_trabalho","RMDQ21_v1",0.526315789473684,0.00119976828482172,19,168,135,33,9,10
"8799","Masc","RMDQ21_v1",0.214765100671141,0.858915264924219,149,71,55,16,117,32
"8800","Fem","RMDQ21_v1",0.225352112676056,0.858915264924219,71,149,117,32,55,16
"8801","Casado/Amasiaado","RMDQ21_v1",0.246913580246914,0.428580619761824,81,101,81,20,61,20
"8802","Solteiro","RMDQ21_v1",0.2,0.589532195826978,75,107,82,25,60,15
"8803","Separado_Divorciado","RMDQ21_v1",0.142857142857143,0.616223475186609,7,175,136,39,6,1
"8804","X4","RMDQ21_v1",0,0.353953248138362,3,179,139,40,3,0
"8805","X5","RMDQ21_v1",0.25,0.882669759851911,4,178,139,39,3,1
"8806","X6","RMDQ21_v1",0.25,0.793651839738159,12,170,133,37,9,3
"8807","Livrar_costas","RMDQ21_v1",0.280373831775701,0.186416370187659,107,16,14,2,77,30
"8808","Livrar_perna","RMDQ21_v1",0.142857142857143,0.287895495678225,14,109,79,30,12,2
"8809","Livrar_perda_sens","RMDQ21_v1",0,0.397814837807423,2,121,89,32,2,0
"8810","D1","RMDQ21_v1",0,0.609921533119359,1,116,92,24,1,0
"8811","D15","RMDQ21_v1",0.142857142857143,0.673904727525455,7,110,87,23,6,1
"8812","D16","RMDQ21_v1",0.35,0.0780427272903602,20,97,80,17,13,7
"8813","D17","RMDQ21_v1",0,0.245640976946185,5,112,88,24,5,0
"8814","D18","RMDQ21_v1",0.384615384615385,0.0891521205222315,13,104,85,19,8,5
"8815","D19","RMDQ21_v1",0.333333333333333,0.42460565910448,6,111,89,22,4,2
"8816","D2","RMDQ21_v1",0.375,0.217658768652099,8,109,88,21,5,3
"8817","D20","RMDQ21_v1",0.285714285714286,0.586057318067706,7,110,88,22,5,2
"8818","D21","RMDQ21_v1",0.285714285714286,0.586057318067706,7,110,88,22,5,2
"8819","D22","RMDQ21_v1",1,0.0480451702617448,1,116,93,23,0,1
"8820","D23","RMDQ21_v1",0.5,0.297563754888929,2,115,92,23,1,1
"8821","D24","RMDQ21_v1",0.0833333333333333,0.0974405496966806,24,93,71,22,22,2
"8822","D25","RMDQ21_v1",0.333333333333333,0.577448469865294,3,114,91,23,2,1
"8823","D26","RMDQ21_v1",0.5,0.297563754888929,2,115,92,23,1,1
"8824","D27","RMDQ21_v1",0.75,0.00603078542094925,4,113,92,21,1,3
"8825","D28","RMDQ21_v1",0.6,0.0254219862501702,5,112,91,21,2,3
"8826","D29","RMDQ21_v1",0.261904761904762,0.255063039636742,42,75,62,13,31,11
"8827","D3","RMDQ21_v1",0.5,0.297563754888929,2,115,92,23,1,1
"8828","Lombalgia","RMDQ21_v1",0.262295081967213,0.109985422370149,61,56,48,8,45,16
"8829","D31","RMDQ21_v1",0.176470588235294,0.751610571829307,17,100,79,21,14,3
"8830","D32","RMDQ21_v1",0.27027027027027,0.235337191916833,37,80,66,14,27,10
"8831","D33","RMDQ21_v1",0.0833333333333333,0.27004794320233,12,105,82,23,11,1
"8832","D34","RMDQ21_v1",0.5,0.297563754888929,2,115,92,23,1,1
"8833","D35","RMDQ21_v1",1,0.0480451702617448,1,116,93,23,0,1
"8834","D36","RMDQ21_v1",0,0.165701567692758,7,110,86,24,7,0
"8835","D37","RMDQ21_v1",0.333333333333333,0.108220628258227,21,96,79,17,14,7
"8836","D38","RMDQ21_v1",0,0.372722708820125,3,114,90,24,3,0
"8837","D39","RMDQ21_v1",0.357142857142857,0.133282392746746,14,103,84,19,9,5
"8838","D4","RMDQ21_v1",0.666666666666667,0.0448972277463963,3,114,92,22,1,2
"8839","D40","RMDQ21_v1",0,0.245640976946185,5,112,88,24,5,0
"8840","D41","RMDQ21_v1",0.285714285714286,0.586057318067706,7,110,88,22,5,2
"8841","D42","RMDQ21_v1",0.5,0.297563754888929,2,115,92,23,1,1
"8842","D43","RMDQ21_v1",1,0.00498524702997903,2,115,93,22,0,2
"8843","D44","RMDQ21_v1",0.216216216216216,0.839920415549318,37,80,64,16,29,8
"8844","D45","RMDQ21_v1",0.0833333333333333,0.27004794320233,12,105,82,23,11,1
"8845","D46","RMDQ21_v1",0.243243243243243,0.487457244032155,37,80,65,15,28,9
"8846","D47","RMDQ21_v1",0.166666666666667,0.727614382819134,12,105,83,22,10,2
"8847","D48","RMDQ21_v1",0.230769230769231,0.71351373126343,26,91,73,18,20,6
"8848","D49","RMDQ21_v1",0.0769230769230769,0.224669361614885,13,104,81,23,12,1
"8849","D5","RMDQ21_v1",0.333333333333333,0.577448469865294,3,114,91,23,2,1
"8850","D50","RMDQ21_v1",0,0.609921533119359,1,116,92,24,1,0
"8851","D51","RMDQ21_v1",1,0.0480451702617448,1,116,93,23,0,1
"8852","D52","RMDQ21_v1",0,0.609921533119359,1,116,92,24,1,0
"8853","D53","RMDQ21_v1",1,0.0480451702617448,1,116,93,23,0,1
"8854","D9","RMDQ21_v1",1,0.0480451702617448,1,116,93,23,0,1
"8855","RMDQ1_v1","RMDQ21_v1",0.482352941176471,4.90670233882204e-13,85,134,127,7,44,41
"8856","RMDQ2_v1","RMDQ21_v1",0.488888888888889,6.16870353498056e-15,90,129,125,4,46,44
"8857","RMDQ3_v1","RMDQ21_v1",0.518987341772152,6.16068599359073e-16,79,141,134,7,38,41
"8858","RMDQ4_v1","RMDQ21_v1",0.407407407407407,0.000106233965949975,54,166,140,26,32,22
"8859","RMDQ5_v1","RMDQ21_v1",0.583333333333333,5.87766115702892e-20,72,148,142,6,30,42
"8860","RMDQ6_v1","RMDQ21_v1",0.625,1.37369259993242e-17,56,164,151,13,21,35
"8861","RMDQ7_v1","RMDQ21_v1",0.846153846153846,1.20598091840535e-25,39,181,166,15,6,33
"8862","RMDQ8_v1","RMDQ21_v1",0.875,4.60170653811448e-06,8,212,171,41,1,7
"8863","RMDQ9_v1","RMDQ21_v1",0.970588235294118,7.15114298375069e-31,34,186,171,15,1,33
"8864","RMDQ10_v1","RMDQ21_v1",0.925,5.3519458890139e-33,40,180,169,11,3,37
"8865","RMDQ11_v1","RMDQ21_v1",0.880952380952381,6.43141249103896e-31,42,178,167,11,5,37
"8866","RMDQ12_v1","RMDQ21_v1",0.795454545454545,3.55007709489676e-25,44,176,163,13,9,35
"8867","RMDQ13_v1","RMDQ21_v1",0.717391304347826,3.02717342793665e-20,46,174,159,15,13,33
"8868","RMDQ14_v1","RMDQ21_v1",0.73469387755102,3.09645348653985e-23,49,171,159,12,13,36
"8869","RMDQ15_v1","RMDQ21_v1",0.870967741935484,2.21372577838713e-21,31,189,168,21,4,27
"8870","RMDQ16_v1","RMDQ21_v1",0.864864864864865,1.58117638108734e-25,37,183,167,16,5,32
"8871","RMDQ17_v1","RMDQ21_v1",0.73469387755102,3.09645348653985e-23,49,171,159,12,13,36
"8872","RMDQ18_v1","RMDQ21_v1",0.972222222222222,4.6308617057448e-33,36,184,171,13,1,35
"8873","RMDQ19_v1","RMDQ21_v1",0.96875,9.93950282782106e-29,32,188,171,17,1,31
"8874","RMDQ20_v1","RMDQ21_v1",0.921052631578947,8.88911617501351e-31,38,182,169,13,3,35
"8875","RMDQ21_v1","RMDQ21_v1",1,9.04447975804475e-50,48,172,172,0,0,48
"8876","RMDQ22_v1","RMDQ21_v1",0.894736842105263,1.22415880293095e-28,38,182,168,14,4,34
"8877","RMDQ23_v1","RMDQ21_v1",0.918918918918919,1.09782273486496e-29,37,183,169,14,3,34
"8878","RMDQ24_v1","RMDQ21_v1",1,2.66706076832713e-34,35,185,172,13,0,35
"8879","DN4 - Queimação","RMDQ21_v1",0.18,0.572797507070615,100,109,86,23,82,18
"8880","DN4 - Sensação de frio dolorosa","RMDQ21_v1",0.0638297872340425,0.00903458715153292,47,161,123,38,44,3
"8881","DN4 - Choque elétrico","RMDQ21_v1",0.1,0.0305256876416991,60,152,117,35,54,6
"8882","DN4 - Formigamento","RMDQ21_v1",0.107142857142857,0.0567648991387372,56,156,121,35,50,6
"8883","DN4 - Alfinetada e agulhada","RMDQ21_v1",0.241935483870968,0.249970132636943,62,150,124,26,47,15
"8884","DN4 - Adormecimento","RMDQ21_v1",0.305084745762712,0.0128918394971669,59,150,127,23,41,18
"8885","DN4 - Coceira","RMDQ21_v1",0.272727272727273,0.493876500060901,11,201,163,38,8,3
"8886","DH4 - Hipoestesia ao toque","RMDQ21_v1",0.571428571428571,0.0100175450852705,7,205,168,37,3,4
"8887","DN4 - Hipoestesia a picada de agulha","RMDQ21_v1",0.571428571428571,0.0100175450852705,7,205,168,37,3,4
"8888","DN4 - Escovação","RMDQ21_v1",0.666666666666667,0.00290522348282851,6,206,169,37,2,4
"8889","Fuma","RMDQ22_v1",0.277777777777778,0.11335937634298,36,147,123,24,26,10
"8890","Cirurgia na coluna","RMDQ22_v1",0.176470588235294,0.624891640611865,68,127,108,19,56,12
"8891","Aposentado","RMDQ22_v1",0.242424242424242,0.259088984797628,33,150,126,24,25,8
"8892","Desempregado","RMDQ22_v1",0.192307692307692,0.845510164180753,26,153,126,27,21,5
"8893","Licenca_Medica","RMDQ22_v1",0.210526315789474,0.683732260466205,19,162,134,28,15,4
"8894","Aposentado_Invalidez","RMDQ22_v1",0.5,0.0152623123117159,8,171,143,28,4,4
"8895","Analgésicos","RMDQ22_v1",0.205673758865248,0.0462990106372058,141,57,52,5,112,29
"8896","OutraDoenca","RMDQ22_v1",0.226666666666667,0.12619685298872,75,114,98,16,58,17
"8897","Dor nas costas","RMDQ22_v1",0.203252032520325,0.0821699604389636,123,67,60,7,98,25
"8898","Dor nas pernas","RMDQ22_v1",0.230769230769231,0.108258813232636,65,123,106,17,50,15
"8899","Retornar_trabalho","RMDQ22_v1",0.315789473684211,0.0928309549108063,19,168,141,27,13,6
"8900","Masc","RMDQ22_v1",0.181208053691275,0.629759193064311,149,71,60,11,122,27
"8901","Fem","RMDQ22_v1",0.154929577464789,0.629759193064311,71,149,122,27,60,11
"8902","Casado/Amasiaado","RMDQ22_v1",0.197530864197531,0.611193575320539,81,101,84,17,65,16
"8903","Solteiro","RMDQ22_v1",0.16,0.531993687594629,75,107,86,21,63,12
"8904","Separado_Divorciado","RMDQ22_v1",0.142857142857143,0.787661959672211,7,175,143,32,6,1
"8905","X4","RMDQ22_v1",0,0.411118020233273,3,179,146,33,3,0
"8906","X5","RMDQ22_v1",0.25,0.718466846384741,4,178,146,32,3,1
"8907","X6","RMDQ22_v1",0.25,0.522860349660526,12,170,140,30,9,3
"8908","Livrar_costas","RMDQ22_v1",0.186915887850467,0.546677512023865,107,16,14,2,87,20
"8909","Livrar_perna","RMDQ22_v1",0.142857142857143,0.708837555071883,14,109,89,20,12,2
"8910","Livrar_perda_sens","RMDQ22_v1",0,0.505752825555412,2,121,99,22,2,0
"8911","D1","RMDQ22_v1",0,0.648368667298824,1,116,96,20,1,0
"8912","D15","RMDQ22_v1",0.142857142857143,0.838703911858419,7,110,91,19,6,1
"8913","D16","RMDQ22_v1",0.3,0.0922146018040814,20,97,83,14,14,6
"8914","D17","RMDQ22_v1",0,0.29938055120971,5,112,92,20,5,0
"8915","D18","RMDQ22_v1",0.230769230769231,0.543334595440438,13,104,87,17,10,3
"8916","D19","RMDQ22_v1",0.333333333333333,0.277999040548378,6,111,93,18,4,2
"8917","D2","RMDQ22_v1",0.25,0.538283058858107,8,109,91,18,6,2
"8918","D20","RMDQ22_v1",0.142857142857143,0.838703911858419,7,110,91,19,6,1
"8919","D21","RMDQ22_v1",0.142857142857143,0.838703911858419,7,110,91,19,6,1
"8920","D22","RMDQ22_v1",1,0.0269843768229582,1,116,97,19,0,1
"8921","D23","RMDQ22_v1",0,0.517165263403425,2,115,95,20,2,0
"8922","D24","RMDQ22_v1",0.0416666666666667,0.0591721923965132,24,93,74,19,23,1
"8923","D25","RMDQ22_v1",0,0.425587509741219,3,114,94,20,3,0
"8924","D26","RMDQ22_v1",0.5,0.212447592946906,2,115,96,19,1,1
"8925","D27","RMDQ22_v1",0.5,0.0752615085065314,4,113,95,18,2,2
"8926","D28","RMDQ22_v1",0.2,0.859964262675104,5,112,93,19,4,1
"8927","D29","RMDQ22_v1",0.238095238095238,0.14875437441928,42,75,65,10,32,10
"8928","D3","RMDQ22_v1",0.5,0.212447592946906,2,115,96,19,1,1
"8929","Lombalgia","RMDQ22_v1",0.229508196721311,0.0790298022673549,61,56,50,6,47,14
"8930","D31","RMDQ22_v1",0.176470588235294,0.947761616195463,17,100,83,17,14,3
"8931","D32","RMDQ22_v1",0.243243243243243,0.157705102959809,37,80,69,11,28,9
"8932","D33","RMDQ22_v1",0.0833333333333333,0.394788570407184,12,105,86,19,11,1
"8933","D34","RMDQ22_v1",0.5,0.212447592946906,2,115,96,19,1,1
"8934","D35","RMDQ22_v1",1,0.0269843768229582,1,116,97,19,0,1
"8935","D36","RMDQ22_v1",0,0.215341871421237,7,110,90,20,7,0
"8936","D37","RMDQ22_v1",0.285714285714286,0.122977375694485,21,96,82,14,15,6
"8937","D38","RMDQ22_v1",0,0.425587509741219,3,114,94,20,3,0
"8938","D39","RMDQ22_v1",0.285714285714286,0.224055629733022,14,103,87,16,10,4
"8939","D4","RMDQ22_v1",0.666666666666667,0.0208539320778979,3,114,96,18,1,2
"8940","D40","RMDQ22_v1",0,0.29938055120971,5,112,92,20,5,0
"8941","D41","RMDQ22_v1",0.142857142857143,0.838703911858419,7,110,91,19,6,1
"8942","D42","RMDQ22_v1",0.5,0.212447592946906,2,115,96,19,1,1
"8943","D43","RMDQ22_v1",0.5,0.212447592946906,2,115,96,19,1,1
"8944","D44","RMDQ22_v1",0.189189189189189,0.721396218577618,37,80,67,13,30,7
"8945","D45","RMDQ22_v1",0.0833333333333333,0.394788570407184,12,105,86,19,11,1
"8946","D46","RMDQ22_v1",0.216216216216216,0.376311582115925,37,80,68,12,29,8
"8947","D47","RMDQ22_v1",0.166666666666667,0.966888916247175,12,105,87,18,10,2
"8948","D48","RMDQ22_v1",0.192307692307692,0.742783600553943,26,91,76,15,21,5
"8949","D49","RMDQ22_v1",0.0769230769230769,0.339537234605017,13,104,85,19,12,1
"8950","D5","RMDQ22_v1",0.333333333333333,0.449093732608259,3,114,95,19,2,1
"8951","D50","RMDQ22_v1",0,0.648368667298824,1,116,96,20,1,0
"8952","D51","RMDQ22_v1",1,0.0269843768229582,1,116,97,19,0,1
"8953","D52","RMDQ22_v1",0,0.648368667298824,1,116,96,20,1,0
"8954","D53","RMDQ22_v1",0,0.648368667298824,1,116,96,20,1,0
"8955","D9","RMDQ22_v1",1,0.0269843768229582,1,116,97,19,0,1
"8956","RMDQ1_v1","RMDQ22_v1",0.341176470588235,1.04766953979787e-06,85,134,125,9,56,29
"8957","RMDQ2_v1","RMDQ22_v1",0.333333333333333,1.05676818168364e-06,90,129,121,8,60,30
"8958","RMDQ3_v1","RMDQ22_v1",0.468354430379747,3.86479379489919e-18,79,141,140,1,42,37
"8959","RMDQ4_v1","RMDQ22_v1",0.277777777777778,0.0187244284221641,54,166,143,23,39,15
"8960","RMDQ5_v1","RMDQ22_v1",0.527777777777778,2.55197534833148e-22,72,148,148,0,34,38
"8961","RMDQ6_v1","RMDQ22_v1",0.678571428571429,4.20211794682366e-31,56,164,164,0,18,38
"8962","RMDQ7_v1","RMDQ22_v1",0.82051282051282,3.96817775660089e-32,39,181,175,6,7,32
"8963","RMDQ8_v1","RMDQ22_v1",0.875,8.65541275507187e-08,8,212,181,31,1,7
"8964","RMDQ9_v1","RMDQ22_v1",0.941176470588235,5.02330188683508e-38,34,186,180,6,2,32
"8965","RMDQ10_v1","RMDQ22_v1",0.85,5.28115491603497e-36,40,180,176,4,6,34
"8966","RMDQ11_v1","RMDQ22_v1",0.80952380952381,6.70056269121632e-34,42,178,174,4,8,34
"8967","RMDQ12_v1","RMDQ22_v1",0.772727272727273,5.48132077282605e-32,44,176,172,4,10,34
"8968","RMDQ13_v1","RMDQ22_v1",0.695652173913043,5.0827520652276e-26,46,174,168,6,14,32
"8969","RMDQ14_v1","RMDQ22_v1",0.673469387755102,7.16027453909365e-26,49,171,166,5,16,33
"8970","RMDQ15_v1","RMDQ22_v1",0.870967741935484,1.31370570973966e-28,31,189,178,11,4,27
"8971","RMDQ16_v1","RMDQ22_v1",0.837837837837838,8.45258776283249e-32,37,183,176,7,6,31
"8972","RMDQ17_v1","RMDQ22_v1",0.673469387755102,7.16027453909365e-26,49,171,166,5,16,33
"8973","RMDQ18_v1","RMDQ22_v1",0.916666666666667,3.8622169865704e-38,36,184,179,5,3,33
"8974","RMDQ19_v1","RMDQ22_v1",0.96875,5.37655401110131e-38,32,188,181,7,1,31
"8975","RMDQ20_v1","RMDQ22_v1",0.894736842105263,2.50419694842993e-38,38,182,178,4,4,34
"8976","RMDQ21_v1","RMDQ22_v1",0.708333333333333,1.22415880293095e-28,48,172,168,4,14,34
"8977","RMDQ22_v1","RMDQ22_v1",1,9.04447975804488e-50,38,182,182,0,0,38
"8978","RMDQ23_v1","RMDQ22_v1",0.918918918918919,1.38902562344499e-39,37,183,179,4,3,34
"8979","RMDQ24_v1","RMDQ22_v1",0.971428571428571,2.60689005464508e-42,35,185,181,4,1,34
"8980","DN4 - Queimação","RMDQ22_v1",0.15,0.634277089981645,100,109,90,19,85,15
"8981","DN4 - Sensação de frio dolorosa","RMDQ22_v1",0.148936170212766,0.759538847125162,47,161,134,27,40,7
"8982","DN4 - Choque elétrico","RMDQ22_v1",0.15,0.795867384150781,60,152,127,25,51,9
"8983","DN4 - Formigamento","RMDQ22_v1",0.107142857142857,0.205674311599173,56,156,128,28,50,6
"8984","DN4 - Alfinetada e agulhada","RMDQ22_v1",0.241935483870968,0.0374779127996206,62,150,131,19,47,15
"8985","DN4 - Adormecimento","RMDQ22_v1",0.288135593220339,0.00205611385737335,59,150,133,17,42,17
"8986","DN4 - Coceira","RMDQ22_v1",0.272727272727273,0.297013826406587,11,201,170,31,8,3
"8987","DH4 - Hipoestesia ao toque","RMDQ22_v1",0.571428571428571,0.00257951051202975,7,205,175,30,3,4
"8988","DN4 - Hipoestesia a picada de agulha","RMDQ22_v1",0.571428571428571,0.00257951051202975,7,205,175,30,3,4
"8989","DN4 - Escovação","RMDQ22_v1",0.666666666666667,0.000607086316376842,6,206,176,30,2,4
"8990","Fuma","RMDQ23_v1",0.277777777777778,0.0897216220711249,36,147,124,23,26,10
"8991","Cirurgia na coluna","RMDQ23_v1",0.191176470588235,0.290413173481526,68,127,110,17,55,13
"8992","Aposentado","RMDQ23_v1",0.181818181818182,0.833606420633307,33,150,125,25,27,6
"8993","Desempregado","RMDQ23_v1",0.230769230769231,0.401300991479518,26,153,128,25,20,6
"8994","Licenca_Medica","RMDQ23_v1",0.210526315789474,0.631171563746075,19,162,135,27,15,4
"8995","Aposentado_Invalidez","RMDQ23_v1",0.5,0.0124440481664514,8,171,144,27,4,4
"8996","Analgésicos","RMDQ23_v1",0.212765957446809,0.0160030952767158,141,57,53,4,111,30
"8997","OutraDoenca","RMDQ23_v1",0.213333333333333,0.255275141212203,75,114,97,17,59,16
"8998","Dor nas costas","RMDQ23_v1",0.211382113821138,0.0320359554146977,123,67,61,6,97,26
"8999","Dor nas pernas","RMDQ23_v1",0.215384615384615,0.230901271720972,65,123,105,18,51,14
"9000","Retornar_trabalho","RMDQ23_v1",0.315789473684211,0.0928309549108063,19,168,141,27,13,6
"9001","Masc","RMDQ23_v1",0.174496644295302,0.716775702121014,149,71,60,11,123,26
"9002","Fem","RMDQ23_v1",0.154929577464789,0.716775702121014,71,149,123,26,60,11
"9003","Casado/Amasiaado","RMDQ23_v1",0.185185185185185,0.633057844463271,81,101,85,16,66,15
"9004","Solteiro","RMDQ23_v1",0.16,0.756288717982329,75,107,88,19,63,12
"9005","Separado_Divorciado","RMDQ23_v1",0,0.221508821782249,7,175,144,31,7,0
"9006","X4","RMDQ23_v1",0,0.428746611205637,3,179,148,31,3,0
"9007","X5","RMDQ23_v1",0.25,0.668212762738764,4,178,148,30,3,1
"9008","X6","RMDQ23_v1",0.25,0.447477423437325,12,170,142,28,9,3
"9009","Livrar_costas","RMDQ23_v1",0.205607476635514,0.447941658950252,107,16,14,2,85,22
"9010","Livrar_perna","RMDQ23_v1",0.142857142857143,0.600141486098285,14,109,87,22,12,2
"9011","Livrar_perda_sens","RMDQ23_v1",0,0.482653175722585,2,121,97,24,2,0
"9012","D1","RMDQ23_v1",0,0.658337884368623,1,116,97,19,1,0
"9013","D15","RMDQ23_v1",0.142857142857143,0.88507678924591,7,110,92,18,6,1
"9014","D16","RMDQ23_v1",0.25,0.243334917175902,20,97,83,14,15,5
"9015","D17","RMDQ23_v1",0,0.314265473296222,5,112,93,19,5,0
"9016","D18","RMDQ23_v1",0.230769230769231,0.478322601755956,13,104,88,16,10,3
"9017","D19","RMDQ23_v1",0.333333333333333,0.243778720817742,6,111,94,17,4,2
"9018","D2","RMDQ23_v1",0.25,0.486379185682309,8,109,92,17,6,2
"9019","D20","RMDQ23_v1",0.142857142857143,0.88507678924591,7,110,92,18,6,1
"9020","D21","RMDQ23_v1",0.285714285714286,0.36156501382498,7,110,93,17,5,2
"9021","D22","RMDQ23_v1",1,0.0225562523721356,1,116,98,18,0,1
"9022","D23","RMDQ23_v1",0,0.529944138338696,2,115,96,19,2,0
"9023","D24","RMDQ23_v1",0.0416666666666667,0.0720681410405464,24,93,75,18,23,1
"9024","D25","RMDQ23_v1",0,0.439748411324023,3,114,95,19,3,0
"9025","D26","RMDQ23_v1",0.5,0.191631215221544,2,115,97,18,1,1
"9026","D27","RMDQ23_v1",0.5,0.0624754800677752,4,113,96,17,2,2
"9027","D28","RMDQ23_v1",0.2,0.815729808427971,5,112,94,18,4,1
"9028","D29","RMDQ23_v1",0.214285714285714,0.254742236818866,42,75,65,10,33,9
"9029","D3","RMDQ23_v1",0.5,0.191631215221544,2,115,97,18,1,1
"9030","Lombalgia","RMDQ23_v1",0.229508196721311,0.0399394320646895,61,56,51,5,47,14
"9031","D31","RMDQ23_v1",0.176470588235294,0.864829085571817,17,100,84,16,14,3
"9032","D32","RMDQ23_v1",0.216216216216216,0.28303452459432,37,80,69,11,29,8
"9033","D33","RMDQ23_v1",0.166666666666667,0.966202918505237,12,105,88,17,10,2
"9034","D34","RMDQ23_v1",0.5,0.191631215221544,2,115,97,18,1,1
"9035","D35","RMDQ23_v1",1,0.0225562523721356,1,116,98,18,0,1
"9036","D36","RMDQ23_v1",0,0.229572755395786,7,110,91,19,7,0
"9037","D37","RMDQ23_v1",0.238095238095238,0.299077089450997,21,96,82,14,16,5
"9038","D38","RMDQ23_v1",0,0.439748411324023,3,114,95,19,3,0
"9039","D39","RMDQ23_v1",0.214285714285714,0.574730143735297,14,103,87,16,11,3
"9040","D4","RMDQ23_v1",0.666666666666667,0.0164317176559626,3,114,97,17,1,2
"9041","D40","RMDQ23_v1",0,0.314265473296222,5,112,93,19,5,0
"9042","D41","RMDQ23_v1",0.142857142857143,0.88507678924591,7,110,92,18,6,1
"9043","D42","RMDQ23_v1",0.5,0.191631215221544,2,115,97,18,1,1
"9044","D43","RMDQ23_v1",0.5,0.191631215221544,2,115,97,18,1,1
"9045","D44","RMDQ23_v1",0.162162162162162,0.99632382851565,37,80,67,13,31,6
"9046","D45","RMDQ23_v1",0.0833333333333333,0.433119831393324,12,105,87,18,11,1
"9047","D46","RMDQ23_v1",0.189189189189189,0.593023300735864,37,80,68,12,30,7
"9048","D47","RMDQ23_v1",0.166666666666667,0.966202918505237,12,105,88,17,10,2
"9049","D48","RMDQ23_v1",0.153846153846154,0.893411291142895,26,91,76,15,22,4
"9050","D49","RMDQ23_v1",0.153846153846154,0.92937963895314,13,104,87,17,11,2
"9051","D5","RMDQ23_v1",0.333333333333333,0.416056255685071,3,114,96,18,2,1
"9052","D50","RMDQ23_v1",0,0.658337884368623,1,116,97,19,1,0
"9053","D51","RMDQ23_v1",1,0.0225562523721356,1,116,98,18,0,1
"9054","D52","RMDQ23_v1",0,0.658337884368623,1,116,97,19,1,0
"9055","D53","RMDQ23_v1",0,0.658337884368623,1,116,97,19,1,0
"9056","D9","RMDQ23_v1",1,0.0225562523721356,1,116,98,18,0,1
"9057","RMDQ1_v1","RMDQ23_v1",0.341176470588235,3.6302012489557e-07,85,134,126,8,56,29
"9058","RMDQ2_v1","RMDQ23_v1",0.333333333333333,3.52642005073268e-07,90,129,122,7,60,30
"9059","RMDQ3_v1","RMDQ23_v1",0.417721518987342,1.29040585764663e-13,79,141,137,4,46,33
"9060","RMDQ4_v1","RMDQ23_v1",0.203703703703704,0.421727933842598,54,166,140,26,43,11
"9061","RMDQ5_v1","RMDQ23_v1",0.472222222222222,4.11481526565052e-17,72,148,145,3,38,34
"9062","RMDQ6_v1","RMDQ23_v1",0.607142857142857,2.64465390003181e-24,56,164,161,3,22,34
"9063","RMDQ7_v1","RMDQ23_v1",0.82051282051282,3.22770470404949e-33,39,181,176,5,7,32
"9064","RMDQ8_v1","RMDQ23_v1",0.875,5.18254372179348e-08,8,212,182,30,1,7
"9065","RMDQ9_v1","RMDQ23_v1",0.941176470588235,3.04597864637659e-39,34,186,181,5,2,32
"9066","RMDQ10_v1","RMDQ23_v1",0.925,1.92334772571708e-45,40,180,180,0,3,37
"9067","RMDQ11_v1","RMDQ23_v1",0.80952380952381,4.62773129154927e-35,42,178,175,3,8,34
"9068","RMDQ12_v1","RMDQ23_v1",0.772727272727273,4.16233038960417e-33,44,176,173,3,10,34
"9069","RMDQ13_v1","RMDQ23_v1",0.695652173913043,5.61408317275801e-27,46,174,169,5,14,32
"9070","RMDQ14_v1","RMDQ23_v1",0.673469387755102,7.66785369720488e-27,49,171,167,4,16,33
"9071","RMDQ15_v1","RMDQ23_v1",0.870967741935484,1.52047338237707e-29,31,189,179,10,4,27
"9072","RMDQ16_v1","RMDQ23_v1",0.837837837837838,7.24914946220842e-33,37,183,177,6,6,31
"9073","RMDQ17_v1","RMDQ23_v1",0.673469387755102,7.66785369720488e-27,49,171,167,4,16,33
"9074","RMDQ18_v1","RMDQ23_v1",0.916666666666667,2.24484708691214e-39,36,184,180,4,3,33
"9075","RMDQ19_v1","RMDQ23_v1",0.96875,3.38449294022428e-39,32,188,182,6,1,31
"9076","RMDQ20_v1","RMDQ23_v1",0.894736842105263,1.38902562344499e-39,38,182,179,3,4,34
"9077","RMDQ21_v1","RMDQ23_v1",0.708333333333333,1.09782273486496e-29,48,172,169,3,14,34
"9078","RMDQ22_v1","RMDQ23_v1",0.894736842105263,1.38902562344499e-39,38,182,179,3,4,34
"9079","RMDQ23_v1","RMDQ23_v1",1,9.04447975804488e-50,37,183,183,0,0,37
"9080","RMDQ24_v1","RMDQ23_v1",0.971428571428571,1.18750697278174e-43,35,185,182,3,1,34
"9081","DN4 - Queimação","RMDQ23_v1",0.14,0.496792633658893,100,109,90,19,86,14
"9082","DN4 - Sensação de frio dolorosa","RMDQ23_v1",0.127659574468085,0.508578174512341,47,161,134,27,41,6
"9083","DN4 - Choque elétrico","RMDQ23_v1",0.1,0.160171416672835,60,152,125,27,54,6
"9084","DN4 - Formigamento","RMDQ23_v1",0.160714285714286,0.903205654734907,56,156,132,24,47,9
"9085","DN4 - Alfinetada e agulhada","RMDQ23_v1",0.241935483870968,0.0259007596214018,62,150,132,18,47,15
"9086","DN4 - Adormecimento","RMDQ23_v1",0.23728813559322,0.0483694705066989,59,150,131,19,45,14
"9087","DN4 - Coceira","RMDQ23_v1",0.272727272727273,0.271376225839429,11,201,171,30,8,3
"9088","DH4 - Hipoestesia ao toque","RMDQ23_v1",0.571428571428571,0.00203122329892033,7,205,176,29,3,4
"9089","DN4 - Hipoestesia a picada de agulha","RMDQ23_v1",0.571428571428571,0.00203122329892033,7,205,176,29,3,4
"9090","DN4 - Escovação","RMDQ23_v1",0.666666666666667,0.000460768376442171,6,206,177,29,2,4
"9091","Fuma","RMDQ24_v1",0.305555555555556,0.0150990196424508,36,147,127,20,25,11
"9092","Cirurgia na coluna","RMDQ24_v1",0.176470588235294,0.338013017668139,68,127,111,16,56,12
"9093","Aposentado","RMDQ24_v1",0.181818181818182,0.684978356364437,33,150,127,23,27,6
"9094","Desempregado","RMDQ24_v1",0.192307692307692,0.650195269338077,26,153,129,24,21,5
"9095","Licenca_Medica","RMDQ24_v1",0.210526315789474,0.527469400140656,19,162,137,25,15,4
"9096","Aposentado_Invalidez","RMDQ24_v1",0.5,0.00794239239755861,8,171,146,25,4,4
"9097","Analgésicos","RMDQ24_v1",0.205673758865248,0.00807598686623394,141,57,54,3,112,29
"9098","OutraDoenca","RMDQ24_v1",0.213333333333333,0.137553628057166,75,114,99,15,59,16
"9099","Dor nas costas","RMDQ24_v1",0.203252032520325,0.0201725786429304,123,67,62,5,98,25
"9100","Dor nas pernas","RMDQ24_v1",0.215384615384615,0.128756227165614,65,123,107,16,51,14
"9101","Retornar_trabalho","RMDQ24_v1",0.315789473684211,0.0635782280420257,19,168,143,25,13,6
"9102","Masc","RMDQ24_v1",0.161073825503356,0.907265516814864,149,71,60,11,125,24
"9103","Fem","RMDQ24_v1",0.154929577464789,0.907265516814864,71,149,125,24,60,11
"9104","Casado/Amasiaado","RMDQ24_v1",0.185185185185185,0.507567320217459,81,101,86,15,66,15
"9105","Solteiro","RMDQ24_v1",0.146666666666667,0.580213445585084,75,107,88,19,64,11
"9106","Separado_Divorciado","RMDQ24_v1",0,0.230651040788941,7,175,145,30,7,0
"9107","X4","RMDQ24_v1",0,0.437804986559031,3,179,149,30,3,0
"9108","X5","RMDQ24_v1",0.25,0.642504591980499,4,178,149,29,3,1
"9109","X6","RMDQ24_v1",0.25,0.410668232492365,12,170,143,27,9,3
"9110","Livrar_costas","RMDQ24_v1",0.196261682242991,0.495326116175534,107,16,14,2,86,21
"9111","Livrar_perna","RMDQ24_v1",0.142857142857143,0.65277584695815,14,109,88,21,12,2
"9112","Livrar_perda_sens","RMDQ24_v1",0,0.494091831099047,2,121,98,23,2,0
"9113","D1","RMDQ24_v1",0,0.658337884368623,1,116,97,19,1,0
"9114","D15","RMDQ24_v1",0.142857142857143,0.88507678924591,7,110,92,18,6,1
"9115","D16","RMDQ24_v1",0.25,0.243334917175902,20,97,83,14,15,5
"9116","D17","RMDQ24_v1",0,0.314265473296222,5,112,93,19,5,0
"9117","D18","RMDQ24_v1",0.307692307692308,0.131905158843114,13,104,89,15,9,4
"9118","D19","RMDQ24_v1",0.333333333333333,0.243778720817742,6,111,94,17,4,2
"9119","D2","RMDQ24_v1",0.375,0.0911685513036505,8,109,93,16,5,3
"9120","D20","RMDQ24_v1",0.285714285714286,0.36156501382498,7,110,93,17,5,2
"9121","D21","RMDQ24_v1",0.285714285714286,0.36156501382498,7,110,93,17,5,2
"9122","D22","RMDQ24_v1",1,0.0225562523721356,1,116,98,18,0,1
"9123","D23","RMDQ24_v1",0,0.529944138338696,2,115,96,19,2,0
"9124","D24","RMDQ24_v1",0.0416666666666667,0.0720681410405464,24,93,75,18,23,1
"9125","D25","RMDQ24_v1",0,0.439748411324023,3,114,95,19,3,0
"9126","D26","RMDQ24_v1",0.5,0.191631215221544,2,115,97,18,1,1
"9127","D27","RMDQ24_v1",0.5,0.0624754800677752,4,113,96,17,2,2
"9128","D28","RMDQ24_v1",0.4,0.14091465862111,5,112,95,17,3,2
"9129","D29","RMDQ24_v1",0.214285714285714,0.254742236818866,42,75,65,10,33,9
"9130","D3","RMDQ24_v1",0.5,0.191631215221544,2,115,97,18,1,1
"9131","Lombalgia","RMDQ24_v1",0.213114754098361,0.120524579592681,61,56,50,6,48,13
"9132","D31","RMDQ24_v1",0.176470588235294,0.864829085571817,17,100,84,16,14,3
"9133","D32","RMDQ24_v1",0.216216216216216,0.28303452459432,37,80,69,11,29,8
"9134","D33","RMDQ24_v1",0.0833333333333333,0.433119831393324,12,105,87,18,11,1
"9135","D34","RMDQ24_v1",0.5,0.191631215221544,2,115,97,18,1,1
"9136","D35","RMDQ24_v1",1,0.0225562523721356,1,116,98,18,0,1
"9137","D36","RMDQ24_v1",0,0.229572755395786,7,110,91,19,7,0
"9138","D37","RMDQ24_v1",0.238095238095238,0.299077089450997,21,96,82,14,16,5
"9139","D38","RMDQ24_v1",0,0.439748411324023,3,114,95,19,3,0
"9140","D39","RMDQ24_v1",0.214285714285714,0.574730143735297,14,103,87,16,11,3
"9141","D4","RMDQ24_v1",0.666666666666667,0.0164317176559626,3,114,97,17,1,2
"9142","D40","RMDQ24_v1",0,0.314265473296222,5,112,93,19,5,0
"9143","D41","RMDQ24_v1",0.142857142857143,0.88507678924591,7,110,92,18,6,1
"9144","D42","RMDQ24_v1",0.5,0.191631215221544,2,115,97,18,1,1
"9145","D43","RMDQ24_v1",1,0.00119685414489978,2,115,98,17,0,2
"9146","D44","RMDQ24_v1",0.162162162162162,0.99632382851565,37,80,67,13,31,6
"9147","D45","RMDQ24_v1",0.0833333333333333,0.433119831393324,12,105,87,18,11,1
"9148","D46","RMDQ24_v1",0.189189189189189,0.593023300735864,37,80,68,12,30,7
"9149","D47","RMDQ24_v1",0.166666666666667,0.966202918505237,12,105,88,17,10,2
"9150","D48","RMDQ24_v1",0.153846153846154,0.893411291142895,26,91,76,15,22,4
"9151","D49","RMDQ24_v1",0.0769230769230769,0.375480790918795,13,104,86,18,12,1
"9152","D5","RMDQ24_v1",0.333333333333333,0.416056255685071,3,114,96,18,2,1
"9153","D50","RMDQ24_v1",0,0.658337884368623,1,116,97,19,1,0
"9154","D51","RMDQ24_v1",1,0.0225562523721356,1,116,98,18,0,1
"9155","D52","RMDQ24_v1",0,0.658337884368623,1,116,97,19,1,0
"9156","D53","RMDQ24_v1",1,0.0225562523721356,1,116,98,18,0,1
"9157","D9","RMDQ24_v1",1,0.0225562523721356,1,116,98,18,0,1
"9158","RMDQ1_v1","RMDQ24_v1",0.352941176470588,3.53874618470868e-09,85,134,129,5,55,30
"9159","RMDQ2_v1","RMDQ24_v1",0.344444444444444,3.1989979964361e-09,90,129,125,4,59,31
"9160","RMDQ3_v1","RMDQ24_v1",0.417721518987342,4.14338260931118e-15,79,141,139,2,46,33
"9161","RMDQ4_v1","RMDQ24_v1",0.222222222222222,0.144244861954636,54,166,143,23,42,12
"9162","RMDQ5_v1","RMDQ24_v1",0.472222222222222,8.23563250271037e-19,72,148,147,1,38,34
"9163","RMDQ6_v1","RMDQ24_v1",0.625,2.43765345961036e-28,56,164,164,0,21,35
"9164","RMDQ7_v1","RMDQ24_v1",0.846153846153846,2.92654056250376e-38,39,181,179,2,6,33
"9165","RMDQ8_v1","RMDQ24_v1",0.875,1.704357034572e-08,8,212,184,28,1,7
"9166","RMDQ9_v1","RMDQ24_v1",0.970588235294118,5.83329023750466e-45,34,186,184,2,1,33
"9167","RMDQ10_v1","RMDQ24_v1",0.875,1.23678548857098e-42,40,180,180,0,5,35
"9168","RMDQ11_v1","RMDQ24_v1",0.833333333333333,2.96671846020933e-40,42,178,178,0,7,35
"9169","RMDQ12_v1","RMDQ24_v1",0.795454545454545,4.33110628986617e-38,44,176,176,0,9,35
"9170","RMDQ13_v1","RMDQ24_v1",0.717391304347826,2.55322966548863e-31,46,174,172,2,13,33
"9171","RMDQ14_v1","RMDQ24_v1",0.693877551020408,3.70944441058562e-31,49,171,170,1,15,34
"9172","RMDQ15_v1","RMDQ24_v1",0.870967741935484,1.40934099121581e-31,31,189,181,8,4,27
"9173","RMDQ16_v1","RMDQ24_v1",0.864864864864865,6.70026680622147e-38,37,183,180,3,5,32
"9174","RMDQ17_v1","RMDQ24_v1",0.673469387755102,5.98266303908852e-29,49,171,169,2,16,33
"9175","RMDQ18_v1","RMDQ24_v1",0.916666666666667,4.66382581652858e-42,36,184,182,2,3,33
"9176","RMDQ19_v1","RMDQ24_v1",0.96875,8.36196224498593e-42,32,188,184,4,1,31
"9177","RMDQ20_v1","RMDQ24_v1",0.921052631578947,2.901511902757e-45,38,182,182,0,3,35
"9178","RMDQ21_v1","RMDQ24_v1",0.729166666666667,2.66706076832713e-34,48,172,172,0,13,35
"9179","RMDQ22_v1","RMDQ24_v1",0.894736842105263,2.60689005464508e-42,38,182,181,1,4,34
"9180","RMDQ23_v1","RMDQ24_v1",0.918918918918919,1.18750697278174e-43,37,183,182,1,3,34
"9181","RMDQ24_v1","RMDQ24_v1",1,9.04447975804488e-50,35,185,185,0,0,35
"9182","DN4 - Queimação","RMDQ24_v1",0.14,0.88879326316211,100,109,93,16,86,14
"9183","DN4 - Sensação de frio dolorosa","RMDQ24_v1",0.0638297872340425,0.0745392795527733,47,161,134,27,44,3
"9184","DN4 - Choque elétrico","RMDQ24_v1",0.1,0.275954597741857,60,152,128,24,54,6
"9185","DN4 - Formigamento","RMDQ24_v1",0.107142857142857,0.389704980538703,56,156,132,24,50,6
"9186","DN4 - Alfinetada e agulhada","RMDQ24_v1",0.241935483870968,0.00699371085824243,62,150,135,15,47,15
"9187","DN4 - Adormecimento","RMDQ24_v1",0.23728813559322,0.01534126871084,59,150,134,16,45,14
"9188","DN4 - Coceira","RMDQ24_v1",0.272727272727273,0.199728086972641,11,201,174,27,8,3
"9189","DH4 - Hipoestesia ao toque","RMDQ24_v1",0.571428571428571,0.000904416361714182,7,205,179,26,3,4
"9190","DN4 - Hipoestesia a picada de agulha","RMDQ24_v1",0.571428571428571,0.000904416361714182,7,205,179,26,3,4
"9191","DN4 - Escovação","RMDQ24_v1",0.666666666666667,0.000181095024232787,6,206,180,26,2,4
"9192","Fuma","DN4 - Queimação",0.41025641025641,0.563773679871448,39,145,78,67,23,16
"9193","Cirurgia na coluna","DN4 - Queimação",0.472972972972973,0.896388173692458,74,123,66,57,39,35
"9194","Aposentado","DN4 - Queimação",0.303030303030303,0.0796952734974277,33,151,80,71,23,10
"9195","Desempregado","DN4 - Queimação",0.384615384615385,0.564578895312484,26,155,86,69,16,10
"9196","Licenca_Medica","DN4 - Queimação",0.588235294117647,0.194587992107932,17,165,95,70,7,10
"9197","Aposentado_Invalidez","DN4 - Queimação",0.625,0.277857634711698,8,172,98,74,3,5
"9198","Analgésicos","DN4 - Queimação",0.548148148148148,0.00120430910508866,135,63,44,19,61,74
"9199","OutraDoenca","DN4 - Queimação",0.424657534246575,0.540596634506449,73,117,62,55,42,31
"9200","Dor nas costas","DN4 - Queimação",0.504273504273504,0.0498363660707855,117,75,48,27,58,59
"9201","Dor nas pernas","DN4 - Queimação",0.639344262295082,0.000252531915555172,61,129,83,46,22,39
"9202","Retornar_trabalho","DN4 - Queimação",0.411764705882353,0.625575503807537,17,171,90,81,10,7
"9203","Masc","DN4 - Queimação",0.445205479452055,0.561561699150641,146,74,38,36,81,65
"9204","Fem","DN4 - Queimação",0.486486486486487,0.561561699150641,74,146,81,65,38,36
"9205","Casado/Amasiaado","DN4 - Queimação",0.469135802469136,0.519914753168118,81,102,59,43,43,38
"9206","Solteiro","DN4 - Queimação",0.394736842105263,0.271700955566304,76,107,56,51,46,30
"9207","Separado_Divorciado","DN4 - Queimação",0.571428571428571,0.484165329554493,7,176,99,77,3,4
"9208","X4","DN4 - Queimação",0.666666666666667,0.430840014068599,3,180,101,79,1,2
"9209","X5","DN4 - Queimação",0.6,0.472526884224484,5,178,100,78,2,3
"9210","X6","DN4 - Queimação",0.363636363636364,0.586423708924194,11,172,95,77,7,4
"9211","Livrar_costas","DN4 - Queimação",0.456310679611651,0.12770793366904,103,15,5,10,56,47
"9212","Livrar_perna","DN4 - Queimação",0.692307692307692,0.109469991952695,13,105,57,48,4,9
"9213","Livrar_perda_sens","DN4 - Queimação",0.5,0.961414393251082,2,116,60,56,1,1
"9214","D1","DN4 - Queimação",1,0.266069863620088,1,117,65,52,0,1
"9215","D15","DN4 - Queimação",0.571428571428571,0.502481575566997,7,111,62,49,3,4
"9216","D16","DN4 - Queimação",0.5,0.615914729457111,20,98,55,43,10,10
"9217","D17","DN4 - Queimação",0.8,0.107020526847558,5,113,64,49,1,4
"9218","D18","DN4 - Queimação",0.7,0.0955215611693831,10,108,62,46,3,7
"9219","D19","DN4 - Queimação",0.8,0.107020526847558,5,113,64,49,1,4
"9220","D2","DN4 - Queimação",0.857142857142857,0.0252527584039801,7,111,64,47,1,6
"9221","D20","DN4 - Queimação",0.4,0.821358502889077,5,113,62,51,3,2
"9222","D21","DN4 - Queimação",0.6,0.488330641908803,5,113,63,50,2,3
"9223","D22","DN4 - Queimação",NA,NA,0,118,65,53,0,0
"9224","D23","DN4 - Queimação",1,0.266069863620088,1,117,65,52,0,1
"9225","D24","DN4 - Queimação",0.25,0.0279749884872299,24,94,47,47,18,6
"9226","D25","DN4 - Queimação",0.333333333333333,0.68288685723324,3,115,63,52,2,1
"9227","D26","DN4 - Queimação",0,0.364492892588794,1,117,64,53,1,0
"9228","D27","DN4 - Queimação",0.5,0.835224526173344,4,114,63,51,2,2
"9229","D28","DN4 - Queimação",0.25,0.415250383291776,4,114,62,52,3,1
"9230","D29","DN4 - Queimação",0.5,0.426492950580159,40,78,45,33,20,20
"9231","D3","DN4 - Queimação",1,0.114199645019226,2,116,65,51,0,2
"9232","Lombalgia","DN4 - Queimação",0.553571428571429,0.0302170854629842,56,62,40,22,25,31
"9233","D31","DN4 - Queimação",0.625,0.128264070919867,16,102,59,43,6,10
"9234","D32","DN4 - Queimação",0.514285714285714,0.355648448700288,35,83,48,35,17,18
"9235","D33","DN4 - Queimação",0.583333333333333,0.324155928560668,12,106,60,46,5,7
"9236","D34","DN4 - Queimação",0.666666666666667,0.442942687132334,3,115,64,51,1,2
"9237","D35","DN4 - Queimação",1,0.266069863620088,1,117,65,52,0,1
"9238","D36","DN4 - Queimação",0.5,0.764585157400898,8,110,61,49,4,4
"9239","D37","DN4 - Queimação",0.5,0.595012907348357,22,96,54,42,11,11
"9240","D38","DN4 - Queimação",0.666666666666667,0.442942687132334,3,115,64,51,1,2
"9241","D39","DN4 - Queimação",0.466666666666667,0.883950315603061,15,103,57,46,8,7
"9242","D4","DN4 - Queimação",1,0.0520168860438896,3,115,65,50,0,3
"9243","D40","DN4 - Queimação",0.6,0.488330641908803,5,113,63,50,2,3
"9244","D41","DN4 - Queimação",0.428571428571429,0.910132327374677,7,111,61,50,4,3
"9245","D42","DN4 - Queimação",0,0.364492892588794,1,117,64,53,1,0
"9246","D43","DN4 - Queimação",1,0.266069863620088,1,117,65,52,0,1
"9247","D44","DN4 - Queimação",0.594594594594595,0.0318150511689424,37,81,50,31,15,22
"9248","D45","DN4 - Queimação",0.833333333333333,0.00475853921802751,12,106,63,43,2,10
"9249","D46","DN4 - Queimação",0.621621621621622,0.0109075767241013,37,81,51,30,14,23
"9250","D47","DN4 - Queimação",0.833333333333333,0.00475853921802751,12,106,63,43,2,10
"9251","D48","DN4 - Queimação",0.541666666666667,0.307307465859831,24,94,54,40,11,13
"9252","D49","DN4 - Queimação",0.615384615384615,0.201467983968176,13,105,60,45,5,8
"9253","D5","DN4 - Queimação",0.666666666666667,0.442942687132334,3,115,64,51,1,2
"9254","D50","DN4 - Queimação",0.5,0.884072353041481,2,116,64,52,1,1
"9255","D51","DN4 - Queimação",1,0.266069863620088,1,117,65,52,0,1
"9256","D52","DN4 - Queimação",0.5,0.884072353041481,2,116,64,52,1,1
"9257","D53","DN4 - Queimação",1,0.266069863620088,1,117,65,52,0,1
"9258","D9","DN4 - Queimação",1,0.266069863620088,1,117,65,52,0,1
"9259","RMDQ1_v1","DN4 - Queimação",0.493827160493827,0.531281437797716,81,127,68,59,41,40
"9260","RMDQ2_v1","DN4 - Queimação",0.524390243902439,0.306127392917048,82,126,70,56,39,43
"9261","RMDQ3_v1","DN4 - Queimação",0.56,0.0775207366184494,75,134,76,58,33,42
"9262","RMDQ4_v1","DN4 - Queimação",0.48936170212766,0.865167565415426,47,162,85,77,24,23
"9263","RMDQ5_v1","DN4 - Queimação",0.514705882352941,0.466437351380103,68,141,76,65,33,35
"9264","RMDQ6_v1","DN4 - Queimação",0.470588235294118,0.896901661150236,51,158,82,76,27,24
"9265","RMDQ7_v1","DN4 - Queimação",0.472222222222222,0.934274867763459,36,173,90,83,19,17
"9266","RMDQ8_v1","DN4 - Queimação",0.142857142857143,0.0705946729285762,7,202,103,99,6,1
"9267","RMDQ9_v1","DN4 - Queimação",0.451612903225806,0.745670586316139,31,178,92,86,17,14
"9268","RMDQ10_v1","DN4 - Queimação",0.424242424242424,0.496792633658893,33,176,90,86,19,14
"9269","RMDQ11_v1","DN4 - Queimação",0.514285714285714,0.642008442300391,35,174,92,82,17,18
"9270","RMDQ12_v1","DN4 - Queimação",0.358974358974359,0.0976432609787212,39,170,84,86,25,14
"9271","RMDQ13_v1","DN4 - Queimação",0.395348837209302,0.220834426484533,43,166,83,83,26,17
"9272","RMDQ14_v1","DN4 - Queimação",0.5,0.754666689039567,42,167,88,79,21,21
"9273","RMDQ15_v1","DN4 - Queimação",0.466666666666667,0.88879326316211,30,179,93,86,16,14
"9274","RMDQ16_v1","DN4 - Queimação",0.411764705882353,0.394823566882916,34,175,89,86,20,14
"9275","RMDQ17_v1","DN4 - Queimação",0.4,0.234217519719875,45,164,82,82,27,18
"9276","RMDQ18_v1","DN4 - Queimação",0.5,0.798647651088386,30,179,94,85,15,15
"9277","RMDQ19_v1","DN4 - Queimação",0.483870967741935,0.94798014608573,31,178,93,85,16,15
"9278","RMDQ20_v1","DN4 - Queimação",0.424242424242424,0.496792633658893,33,176,90,86,19,14
"9279","RMDQ21_v1","DN4 - Queimação",0.439024390243902,0.572797507070615,41,168,86,82,23,18
"9280","RMDQ22_v1","DN4 - Queimação",0.441176470588235,0.634277089981645,34,175,90,85,19,15
"9281","RMDQ23_v1","DN4 - Queimação",0.424242424242424,0.496792633658893,33,176,90,86,19,14
"9282","RMDQ24_v1","DN4 - Queimação",0.466666666666667,0.88879326316211,30,179,93,86,16,14
"9283","DN4 - Queimação","DN4 - Queimação",1,9.04447975804488e-50,101,119,119,0,0,101
"9284","DN4 - Sensação de frio dolorosa","DN4 - Queimação",0.833333333333333,1.28771192218011e-09,48,168,111,57,8,40
"9285","DN4 - Choque elétrico","DN4 - Queimação",0.754098360655738,5.36553095247014e-08,61,159,104,55,15,46
"9286","DN4 - Formigamento","DN4 - Queimação",0.842105263157895,1.56726395183159e-11,57,163,110,53,9,48
"9287","DN4 - Alfinetada e agulhada","DN4 - Queimação",0.707692307692308,1.65331938547108e-06,65,155,100,55,19,46
"9288","DN4 - Adormecimento","DN4 - Queimação",0.741935483870968,1.33704054779248e-07,62,158,103,55,16,46
"9289","DN4 - Coceira","DN4 - Queimação",0.818181818181818,0.0142049064107218,11,209,117,92,2,9
"9290","DH4 - Hipoestesia ao toque","DN4 - Queimação",0.75,0.0925626679439719,8,212,117,95,2,6
"9291","DN4 - Hipoestesia a picada de agulha","DN4 - Queimação",0.666666666666667,0.201949455771583,9,211,116,95,3,6
"9292","DN4 - Escovação","DN4 - Queimação",0.857142857142857,0.0317276867436082,7,213,118,95,1,6
"9293","Fuma","DN4 - Sensação de frio dolorosa",0.128205128205128,0.0898930960292662,39,144,107,37,34,5
"9294","Cirurgia na coluna","DN4 - Sensação de frio dolorosa",0.25,0.899280469153179,72,124,94,30,54,18
"9295","Aposentado","DN4 - Sensação de frio dolorosa",0.212121212121212,0.732364119386545,33,150,114,36,26,7
"9296","Desempregado","DN4 - Sensação de frio dolorosa",0.192307692307692,0.592843634069639,26,154,117,37,21,5
"9297","Licenca_Medica","DN4 - Sensação de frio dolorosa",0.117647058823529,0.240464948395338,17,164,124,40,15,2
"9298","Aposentado_Invalidez","DN4 - Sensação de frio dolorosa",0.125,0.449459500118411,8,170,129,41,7,1
"9299","Analgésicos","DN4 - Sensação de frio dolorosa",0.26865671641791,0.0443604331434067,134,64,55,9,98,36
"9300","OutraDoenca","DN4 - Sensação de frio dolorosa",0.211267605633803,0.755631602484096,71,117,90,27,56,15
"9301","Dor nas costas","DN4 - Sensação de frio dolorosa",0.239316239316239,0.675997484317467,117,75,59,16,89,28
"9302","Dor nas pernas","DN4 - Sensação de frio dolorosa",0.213114754098361,0.764916733861298,61,129,99,30,48,13
"9303","Retornar_trabalho","DN4 - Sensação de frio dolorosa",0.117647058823529,0.272348348007432,17,171,131,40,15,2
"9304","Masc","DN4 - Sensação de frio dolorosa",0.217687074829932,0.939250945897119,147,72,56,16,115,32
"9305","Fem","DN4 - Sensação de frio dolorosa",0.222222222222222,0.939250945897119,72,147,115,32,56,16
"9306","Casado/Amasiaado","DN4 - Sensação de frio dolorosa",0.341772151898734,0.000500219567324592,79,103,90,13,52,27
"9307","Solteiro","DN4 - Sensação de frio dolorosa",0.128205128205128,0.00977487616366015,78,104,74,30,68,10
"9308","Separado_Divorciado","DN4 - Sensação de frio dolorosa",0.285714285714286,0.667480523178376,7,175,137,38,5,2
"9309","X4","DN4 - Sensação de frio dolorosa",0,0.353953248138362,3,179,139,40,3,0
"9310","X5","DN4 - Sensação de frio dolorosa",0,0.228810979671472,5,177,137,40,5,0
"9311","X6","DN4 - Sensação de frio dolorosa",0.1,0.346744640181569,10,172,133,39,9,1
"9312","Livrar_costas","DN4 - Sensação de frio dolorosa",0.194174757281553,0.949841823322859,103,16,13,3,83,20
"9313","Livrar_perna","DN4 - Sensação de frio dolorosa",0.214285714285714,0.832165115677634,14,105,85,20,11,3
"9314","Livrar_perda_sens","DN4 - Sensação de frio dolorosa",0,0.485108414698764,2,117,94,23,2,0
"9315","D1","DN4 - Sensação de frio dolorosa",1,0.0468674002441255,1,117,94,23,0,1
"9316","D15","DN4 - Sensação de frio dolorosa",0,0.168084755737741,7,111,87,24,7,0
"9317","D16","DN4 - Sensação de frio dolorosa",0.210526315789474,0.932760869926198,19,99,79,20,15,4
"9318","D17","DN4 - Sensação de frio dolorosa",0.2,0.984647097685877,5,113,90,23,4,1
"9319","D18","DN4 - Sensação de frio dolorosa",0.2,0.977792301857777,10,108,86,22,8,2
"9320","D19","DN4 - Sensação de frio dolorosa",0.2,0.984647097685877,5,113,90,23,4,1
"9321","D2","DN4 - Sensação de frio dolorosa",0.142857142857143,0.681634787454959,7,111,88,23,6,1
"9322","D20","DN4 - Sensação de frio dolorosa",0.2,0.984647097685877,5,113,90,23,4,1
"9323","D21","DN4 - Sensação de frio dolorosa",0.4,0.264377007831233,5,113,91,22,3,2
"9324","D22","DN4 - Sensação de frio dolorosa",NA,NA,0,118,94,24,0,0
"9325","D23","DN4 - Sensação de frio dolorosa",0,0.611841971208142,1,117,93,24,1,0
"9326","D24","DN4 - Sensação de frio dolorosa",0.125,0.285094982739129,24,94,73,21,21,3
"9327","D25","DN4 - Sensação de frio dolorosa",0.333333333333333,0.571125001077476,3,115,92,23,2,1
"9328","D26","DN4 - Sensação de frio dolorosa",0,0.611841971208142,1,117,93,24,1,0
"9329","D27","DN4 - Sensação de frio dolorosa",0,0.303875056389333,4,114,90,24,4,0
"9330","D28","DN4 - Sensação de frio dolorosa",0,0.303875056389333,4,114,90,24,4,0
"9331","D29","DN4 - Sensação de frio dolorosa",0.225,0.676215800887989,40,78,63,15,31,9
"9332","D3","DN4 - Sensação de frio dolorosa",0,0.471079632468736,2,116,92,24,2,0
"9333","Lombalgia","DN4 - Sensação de frio dolorosa",0.232142857142857,0.460846035509305,56,62,51,11,43,13
"9334","D31","DN4 - Sensação de frio dolorosa",0.0625,0.132095622319054,16,102,79,23,15,1
"9335","D32","DN4 - Sensação de frio dolorosa",0.228571428571429,0.658997444668027,35,83,67,16,27,8
"9336","D33","DN4 - Sensação de frio dolorosa",0.166666666666667,0.738794323369912,12,106,84,22,10,2
"9337","D34","DN4 - Sensação de frio dolorosa",0.333333333333333,0.571125001077476,3,115,92,23,2,1
"9338","D35","DN4 - Sensação de frio dolorosa",0,0.611841971208142,1,117,93,24,1,0
"9339","D36","DN4 - Sensação de frio dolorosa",0.125,0.568333107790654,8,110,87,23,7,1
"9340","D37","DN4 - Sensação de frio dolorosa",0.19047619047619,0.871185096473233,21,97,77,20,17,4
"9341","D38","DN4 - Sensação de frio dolorosa",0,0.375330930984671,3,115,91,24,3,0
"9342","D39","DN4 - Sensação de frio dolorosa",0.214285714285714,0.914086480890856,14,104,83,21,11,3
"9343","D4","DN4 - Sensação de frio dolorosa",0,0.375330930984671,3,115,91,24,3,0
"9344","D40","DN4 - Sensação de frio dolorosa",0,0.248257616012612,5,113,89,24,5,0
"9345","D41","DN4 - Sensação de frio dolorosa",0,0.168084755737741,7,111,87,24,7,0
"9346","D42","DN4 - Sensação de frio dolorosa",0,0.611841971208142,1,117,93,24,1,0
"9347","D43","DN4 - Sensação de frio dolorosa",1,0.0468674002441255,1,117,94,23,0,1
"9348","D44","DN4 - Sensação de frio dolorosa",0.216216216216216,0.815026697223694,37,81,65,16,29,8
"9349","D45","DN4 - Sensação de frio dolorosa",0.0833333333333333,0.275657507779326,12,106,83,23,11,1
"9350","D46","DN4 - Sensação de frio dolorosa",0.216216216216216,0.815026697223694,37,81,65,16,29,8
"9351","D47","DN4 - Sensação de frio dolorosa",0.0833333333333333,0.275657507779326,12,106,83,23,11,1
"9352","D48","DN4 - Sensação de frio dolorosa",0.208333333333333,0.946254614399026,24,94,75,19,19,5
"9353","D49","DN4 - Sensação de frio dolorosa",0.153846153846154,0.638029486706138,13,105,83,22,11,2
"9354","D5","DN4 - Sensação de frio dolorosa",0,0.375330930984671,3,115,91,24,3,0
"9355","D50","DN4 - Sensação de frio dolorosa",0.5,0.293233262263206,2,116,93,23,1,1
"9356","D51","DN4 - Sensação de frio dolorosa",0,0.611841971208142,1,117,93,24,1,0
"9357","D52","DN4 - Sensação de frio dolorosa",0.5,0.293233262263206,2,116,93,23,1,1
"9358","D53","DN4 - Sensação de frio dolorosa",1,0.0468674002441255,1,117,94,23,0,1
"9359","D9","DN4 - Sensação de frio dolorosa",0,0.611841971208142,1,117,93,24,1,0
"9360","RMDQ1_v1","DN4 - Sensação de frio dolorosa",0.135802469135802,0.0363607768486632,81,126,90,36,70,11
"9361","RMDQ2_v1","DN4 - Sensação de frio dolorosa",0.134146341463415,0.0302754368560354,82,125,89,36,71,11
"9362","RMDQ3_v1","DN4 - Sensação de frio dolorosa",0.323943661971831,0.0149959134720355,71,137,113,24,48,23
"9363","RMDQ4_v1","DN4 - Sensação de frio dolorosa",0.395348837209302,0.00286381027296812,43,165,135,30,26,17
"9364","RMDQ5_v1","DN4 - Sensação de frio dolorosa",0.25,0.580504516566278,64,144,113,31,48,16
"9365","RMDQ6_v1","DN4 - Sensação de frio dolorosa",0.25531914893617,0.584376565461367,47,161,126,35,35,12
"9366","RMDQ7_v1","DN4 - Sensação de frio dolorosa",0.0833333333333333,0.0244347864127157,36,172,128,44,33,3
"9367","RMDQ8_v1","DN4 - Sensação de frio dolorosa",0,0.145895960672681,7,201,154,47,7,0
"9368","RMDQ9_v1","DN4 - Sensação de frio dolorosa",0.129032258064516,0.161847157985229,31,177,134,43,27,4
"9369","RMDQ10_v1","DN4 - Sensação de frio dolorosa",0.181818181818182,0.508578174512341,33,175,134,41,27,6
"9370","RMDQ11_v1","DN4 - Sensação de frio dolorosa",0.0967741935483871,0.0622605966358203,31,177,133,44,28,3
"9371","RMDQ12_v1","DN4 - Sensação de frio dolorosa",0.0769230769230769,0.0135492605568523,39,169,125,44,36,3
"9372","RMDQ13_v1","DN4 - Sensação de frio dolorosa",0.13953488372093,0.128133411741689,43,165,124,41,37,6
"9373","RMDQ14_v1","DN4 - Sensação de frio dolorosa",0.19047619047619,0.538201413250108,42,166,127,39,34,8
"9374","RMDQ15_v1","DN4 - Sensação de frio dolorosa",0.1,0.0745392795527733,30,178,134,44,27,3
"9375","RMDQ16_v1","DN4 - Sensação de frio dolorosa",0.0882352941176471,0.035773360480661,34,174,130,44,31,3
"9376","RMDQ17_v1","DN4 - Sensação de frio dolorosa",0.155555555555556,0.202054732293545,45,163,123,40,38,7
"9377","RMDQ18_v1","DN4 - Sensação de frio dolorosa",0.1,0.0745392795527733,30,178,134,44,27,3
"9378","RMDQ19_v1","DN4 - Sensação de frio dolorosa",0.129032258064516,0.161847157985229,31,177,134,43,27,4
"9379","RMDQ20_v1","DN4 - Sensação de frio dolorosa",0.0909090909090909,0.0431319284443871,33,175,131,44,30,3
"9380","RMDQ21_v1","DN4 - Sensação de frio dolorosa",0.0731707317073171,0.00903458715153292,41,167,123,44,38,3
"9381","RMDQ22_v1","DN4 - Sensação de frio dolorosa",0.205882352941176,0.759538847125162,34,174,134,40,27,7
"9382","RMDQ23_v1","DN4 - Sensação de frio dolorosa",0.181818181818182,0.508578174512341,33,175,134,41,27,6
"9383","RMDQ24_v1","DN4 - Sensação de frio dolorosa",0.1,0.0745392795527733,30,178,134,44,27,3
"9384","DN4 - Queimação","DN4 - Sensação de frio dolorosa",0.412371134020619,1.28771192218011e-09,97,119,111,8,57,40
"9385","DN4 - Sensação de frio dolorosa","DN4 - Sensação de frio dolorosa",1,1.49455292814741e-49,48,171,171,0,0,48
"9386","DN4 - Choque elétrico","DN4 - Sensação de frio dolorosa",0.295081967213115,0.0915788583152414,61,158,128,30,43,18
"9387","DN4 - Formigamento","DN4 - Sensação de frio dolorosa",0.433962264150943,1.415527087588e-05,53,166,141,25,30,23
"9388","DN4 - Alfinetada e agulhada","DN4 - Sensação de frio dolorosa",0.0983606557377049,0.00724370601995142,61,158,116,42,55,6
"9389","DN4 - Adormecimento","DN4 - Sensação de frio dolorosa",0.193548387096774,0.520112974529489,62,154,118,36,50,12
"9390","DN4 - Coceira","DN4 - Sensação de frio dolorosa",0,0.0713793678197071,11,208,160,48,11,0
"9391","DH4 - Hipoestesia ao toque","DN4 - Sensação de frio dolorosa",0.375,0.277755605412279,8,211,166,45,5,3
"9392","DN4 - Hipoestesia a picada de agulha","DN4 - Sensação de frio dolorosa",0.222222222222222,0.982014313931702,9,210,164,46,7,2
"9393","DN4 - Escovação","DN4 - Sensação de frio dolorosa",0.285714285714286,0.665377695438209,7,212,166,46,5,2
"9394","Fuma","DN4 - Choque elétrico",0.358974358974359,0.213907084570306,39,147,109,38,25,14
"9395","Cirurgia na coluna","DN4 - Choque elétrico",0.297297297297297,0.292917092159791,74,126,97,29,52,22
"9396","Aposentado","DN4 - Choque elétrico",0.333333333333333,0.275924204970753,33,153,116,37,22,11
"9397","Desempregado","DN4 - Choque elétrico",0.153846153846154,0.194398212406589,26,157,114,43,22,4
"9398","Licenca_Medica","DN4 - Choque elétrico",0.470588235294118,0.0327472837765836,17,167,128,39,9,8
"9399","Aposentado_Invalidez","DN4 - Choque elétrico",0.375,0.465148484458466,8,174,129,45,5,3
"9400","Analgésicos","DN4 - Choque elétrico",0.284671532846715,0.779017935677809,137,64,47,17,98,39
"9401","OutraDoenca","DN4 - Choque elétrico",0.301369863013699,0.720381968743229,73,119,86,33,51,22
"9402","Dor nas costas","DN4 - Choque elétrico",0.305084745762712,0.146653671327541,118,76,60,16,82,36
"9403","Dor nas pernas","DN4 - Choque elétrico",0.467741935483871,4.06963731872765e-05,62,130,106,24,33,29
"9404","Retornar_trabalho","DN4 - Choque elétrico",0.411764705882353,0.195158915345752,17,174,128,46,10,7
"9405","Masc","DN4 - Choque elétrico",0.308724832214765,0.0944489894177433,149,74,59,15,103,46
"9406","Fem","DN4 - Choque elétrico",0.202702702702703,0.0944489894177433,74,149,103,46,59,15
"9407","Casado/Amasiaado","DN4 - Choque elétrico",0.259259259259259,0.56009353206846,81,104,73,31,60,21
"9408","Solteiro","DN4 - Choque elétrico",0.269230769230769,0.759500621899454,78,107,76,31,57,21
"9409","Separado_Divorciado","DN4 - Choque elétrico",0.285714285714286,0.977821369580842,7,178,128,50,5,2
"9410","X4","DN4 - Choque elétrico",0.666666666666667,0.134165504642534,3,182,132,50,1,2
"9411","X5","DN4 - Choque elétrico",0.4,0.548710096884232,5,180,130,50,3,2
"9412","X6","DN4 - Choque elétrico",0.363636363636364,0.529968849020069,11,174,126,48,7,4
"9413","Livrar_costas","DN4 - Choque elétrico",0.278846153846154,0.43084077961608,104,16,10,6,75,29
"9414","Livrar_perna","DN4 - Choque elétrico",0.428571428571429,0.230486251037914,14,106,77,29,8,6
"9415","Livrar_perda_sens","DN4 - Choque elétrico",0,0.36011632639728,2,118,83,35,2,0
"9416","D1","DN4 - Choque elétrico",0,0.508374874653824,1,118,82,36,1,0
"9417","D15","DN4 - Choque elétrico",0.714285714285714,0.014498692935062,7,112,81,31,2,5
"9418","D16","DN4 - Choque elétrico",0.45,0.115443064543299,20,99,72,27,11,9
"9419","D17","DN4 - Choque elétrico",0.4,0.627809401675126,5,114,80,34,3,2
"9420","D18","DN4 - Choque elétrico",0.5,0.155465442549244,10,109,78,31,5,5
"9421","D19","DN4 - Choque elétrico",0.8,0.0133529243945253,5,114,82,32,1,4
"9422","D2","DN4 - Choque elétrico",0.714285714285714,0.014498692935062,7,112,81,31,2,5
"9423","D20","DN4 - Choque elétrico",0.4,0.627809401675126,5,114,80,34,3,2
"9424","D21","DN4 - Choque elétrico",0.6,0.139003043752015,5,114,81,33,2,3
"9425","D22","DN4 - Choque elétrico",NA,NA,0,119,83,36,0,0
"9426","D23","DN4 - Choque elétrico",1,0.127302516839353,1,118,83,35,0,1
"9427","D24","DN4 - Choque elétrico",0.25,0.530716507537342,24,95,65,30,18,6
"9428","D25","DN4 - Choque elétrico",0.333333333333333,0.906324738174181,3,116,81,35,2,1
"9429","D26","DN4 - Choque elétrico",0,0.508374874653824,1,118,82,36,1,0
"9430","D27","DN4 - Choque elétrico",0.5,0.381766761425683,4,115,81,34,2,2
"9431","D28","DN4 - Choque elétrico",0.25,0.816057649600488,4,115,80,35,3,1
"9432","D29","DN4 - Choque elétrico",0.341463414634146,0.50254031345675,41,78,56,22,27,14
"9433","D3","DN4 - Choque elétrico",1,0.0303398211599874,2,117,83,34,0,2
"9434","Lombalgia","DN4 - Choque elétrico",0.403508771929825,0.0214744404722358,57,62,49,13,34,23
"9435","D31","DN4 - Choque elétrico",0.6875,0.000314120929291655,16,103,78,25,5,11
"9436","D32","DN4 - Choque elétrico",0.333333333333333,0.629869187939028,36,83,59,24,24,12
"9437","D33","DN4 - Choque elétrico",0.583333333333333,0.0255298524370368,12,107,78,29,5,7
"9438","D34","DN4 - Choque elétrico",0.666666666666667,0.164313056647265,3,116,82,34,1,2
"9439","D35","DN4 - Choque elétrico",1,0.127302516839353,1,118,83,35,0,1
"9440","D36","DN4 - Choque elétrico",0.375,0.644017374799388,8,111,78,33,5,3
"9441","D37","DN4 - Choque elétrico",0.409090909090909,0.228092839702289,22,97,70,27,13,9
"9442","D38","DN4 - Choque elétrico",0.666666666666667,0.164313056647265,3,116,82,34,1,2
"9443","D39","DN4 - Choque elétrico",0.333333333333333,0.781091566389068,15,104,73,31,10,5
"9444","D4","DN4 - Choque elétrico",1,0.00772757479418338,3,116,83,33,0,3
"9445","D40","DN4 - Choque elétrico",0.6,0.139003043752015,5,114,81,33,2,3
"9446","D41","DN4 - Choque elétrico",0.285714285714286,0.920517219168758,7,112,78,34,5,2
"9447","D42","DN4 - Choque elétrico",0,0.508374874653824,1,118,82,36,1,0
"9448","D43","DN4 - Choque elétrico",1,0.127302516839353,1,118,83,35,0,1
"9449","D44","DN4 - Choque elétrico",0.368421052631579,0.283752899184301,38,81,59,22,24,14
"9450","D45","DN4 - Choque elétrico",0.583333333333333,0.0255298524370368,12,107,78,29,5,7
"9451","D46","DN4 - Choque elétrico",0.394736842105263,0.133620063834212,38,81,60,21,23,15
"9452","D47","DN4 - Choque elétrico",0.75,0.000372576926849565,12,107,80,27,3,9
"9453","D48","DN4 - Choque elétrico",0.44,0.0922337776047711,25,94,69,25,14,11
"9454","D49","DN4 - Choque elétrico",0.615384615384615,0.00926872850286714,13,106,78,28,5,8
"9455","D5","DN4 - Choque elétrico",0.666666666666667,0.164313056647265,3,116,82,34,1,2
"9456","D50","DN4 - Choque elétrico",0.5,0.539771205928562,2,117,82,35,1,1
"9457","D51","DN4 - Choque elétrico",1,0.127302516839353,1,118,83,35,0,1
"9458","D52","DN4 - Choque elétrico",0.5,0.539771205928562,2,117,82,35,1,1
"9459","D53","DN4 - Choque elétrico",1,0.127302516839353,1,118,83,35,0,1
"9460","D9","DN4 - Choque elétrico",1,0.127302516839353,1,118,83,35,0,1
"9461","RMDQ1_v1","DN4 - Choque elétrico",0.296296296296296,0.255956111731342,81,130,95,35,57,24
"9462","RMDQ2_v1","DN4 - Choque elétrico",0.329268292682927,0.124024635121457,82,129,97,32,55,27
"9463","RMDQ3_v1","DN4 - Choque elétrico",0.253333333333333,0.477741396481729,75,137,96,41,56,19
"9464","RMDQ4_v1","DN4 - Choque elétrico",0.212765957446809,0.225539055270831,47,165,115,50,37,10
"9465","RMDQ5_v1","DN4 - Choque elétrico",0.25,0.463313617812442,68,144,101,43,51,17
"9466","RMDQ6_v1","DN4 - Choque elétrico",0.274509803921569,0.876981982189141,51,161,115,46,37,14
"9467","RMDQ7_v1","DN4 - Choque elétrico",0.25,0.629319679842136,36,176,125,51,27,9
"9468","RMDQ8_v1","DN4 - Choque elétrico",0.142857142857143,0.402503259502644,7,205,146,59,6,1
"9469","RMDQ9_v1","DN4 - Choque elétrico",0.225806451612903,0.4440860960561,31,181,128,53,24,7
"9470","RMDQ10_v1","DN4 - Choque elétrico",0.181818181818182,0.160171416672835,33,179,125,54,27,6
"9471","RMDQ11_v1","DN4 - Choque elétrico",0.171428571428571,0.108733731364316,35,177,123,54,29,6
"9472","RMDQ12_v1","DN4 - Choque elétrico",0.153846153846154,0.0474369808423653,39,173,119,54,33,6
"9473","RMDQ13_v1","DN4 - Choque elétrico",0.13953488372093,0.0193158028304068,43,169,115,54,37,6
"9474","RMDQ14_v1","DN4 - Choque elétrico",0.166666666666667,0.0615797984782919,42,170,117,53,35,7
"9475","RMDQ15_v1","DN4 - Choque elétrico",0.2,0.275954597741857,30,182,128,54,24,6
"9476","RMDQ16_v1","DN4 - Choque elétrico",0.176470588235294,0.132283299607425,34,178,124,54,28,6
"9477","RMDQ17_v1","DN4 - Choque elétrico",0.222222222222222,0.307690766607806,45,167,117,50,35,10
"9478","RMDQ18_v1","DN4 - Choque elétrico",0.2,0.275954597741857,30,182,128,54,24,6
"9479","RMDQ19_v1","DN4 - Choque elétrico",0.225806451612903,0.4440860960561,31,181,128,53,24,7
"9480","RMDQ20_v1","DN4 - Choque elétrico",0.181818181818182,0.160171416672835,33,179,125,54,27,6
"9481","RMDQ21_v1","DN4 - Choque elétrico",0.146341463414634,0.0305256876416991,41,171,117,54,35,6
"9482","RMDQ22_v1","DN4 - Choque elétrico",0.264705882352941,0.795867384150781,34,178,127,51,25,9
"9483","RMDQ23_v1","DN4 - Choque elétrico",0.181818181818182,0.160171416672835,33,179,125,54,27,6
"9484","RMDQ24_v1","DN4 - Choque elétrico",0.2,0.275954597741857,30,182,128,54,24,6
"9485","DN4 - Queimação","DN4 - Choque elétrico",0.455445544554455,5.36553095247014e-08,101,119,104,15,55,46
"9486","DN4 - Sensação de frio dolorosa","DN4 - Choque elétrico",0.375,0.0915788583152414,48,171,128,43,30,18
"9487","DN4 - Choque elétrico","DN4 - Choque elétrico",1,2.0045955124732e-50,61,162,162,0,0,61
"9488","DN4 - Formigamento","DN4 - Choque elétrico",0.631578947368421,2.0918433724917e-12,57,166,141,25,21,36
"9489","DN4 - Alfinetada e agulhada","DN4 - Choque elétrico",0.646153846153846,1.18439795593978e-15,65,158,139,19,23,42
"9490","DN4 - Adormecimento","DN4 - Choque elétrico",0.532258064516129,1.20718350861482e-07,62,158,130,28,29,33
"9491","DN4 - Coceira","DN4 - Choque elétrico",0.818181818181818,3.23913203994836e-05,11,212,160,52,2,9
"9492","DH4 - Hipoestesia ao toque","DN4 - Choque elétrico",0.875,0.000101674322618174,8,215,161,54,1,7
"9493","DN4 - Hipoestesia a picada de agulha","DN4 - Choque elétrico",0.666666666666667,0.00691904555528566,9,214,159,55,3,6
"9494","DN4 - Escovação","DN4 - Choque elétrico",0.857142857142857,0.000432473076791566,7,216,161,55,1,6
"9495","Fuma","DN4 - Formigamento",0.205128205128205,0.492195107558159,39,147,109,38,31,8
"9496","Cirurgia na coluna","DN4 - Formigamento",0.297297297297297,0.145943615807705,74,126,100,26,52,22
"9497","Aposentado","DN4 - Formigamento",0.212121212121212,0.659249403441332,33,153,115,38,26,7
"9498","Desempregado","DN4 - Formigamento",0.192307692307692,0.535258633638523,26,157,118,39,21,5
"9499","Licenca_Medica","DN4 - Formigamento",0.235294117647059,0.968951007462745,17,167,127,40,13,4
"9500","Aposentado_Invalidez","DN4 - Formigamento",0.125,0.395149097485649,8,174,129,45,7,1
"9501","Analgésicos","DN4 - Formigamento",0.27007299270073,0.435988065551561,137,64,50,14,100,37
"9502","OutraDoenca","DN4 - Formigamento",0.26027397260274,0.796502239231962,73,119,86,33,54,19
"9503","Dor nas costas","DN4 - Formigamento",0.271186440677966,0.164409258371794,118,76,62,14,86,32
"9504","Dor nas pernas","DN4 - Formigamento",0.387096774193548,0.00153960439967824,62,130,107,23,38,24
"9505","Retornar_trabalho","DN4 - Formigamento",0.294117647058824,0.59039013813298,17,174,133,41,12,5
"9506","Masc","DN4 - Formigamento",0.268456375838926,0.532443320790802,149,74,57,17,109,40
"9507","Fem","DN4 - Formigamento",0.22972972972973,0.532443320790802,74,149,109,40,57,17
"9508","Casado/Amasiaado","DN4 - Formigamento",0.259259259259259,0.885874195697831,81,104,78,26,60,21
"9509","Solteiro","DN4 - Formigamento",0.205128205128205,0.191839243541406,78,107,76,31,62,16
"9510","Separado_Divorciado","DN4 - Formigamento",0.285714285714286,0.84448077252083,7,178,133,45,5,2
"9511","X4","DN4 - Formigamento",0.666666666666667,0.0978946970900838,3,182,137,45,1,2
"9512","X5","DN4 - Formigamento",0.4,0.447258441037516,5,180,135,45,3,2
"9513","X6","DN4 - Formigamento",0.363636363636364,0.389316508736938,11,174,131,43,7,4
"9514","Livrar_costas","DN4 - Formigamento",0.230769230769231,0.0786251804882373,104,16,9,7,80,24
"9515","Livrar_perna","DN4 - Formigamento",0.5,0.0279504880910265,14,106,82,24,7,7
"9516","Livrar_perda_sens","DN4 - Formigamento",0,0.399963349010264,2,118,87,31,2,0
"9517","D1","DN4 - Formigamento",1,0.0906514651303281,1,118,88,30,0,1
"9518","D15","DN4 - Formigamento",0.571428571428571,0.0533672436257132,7,112,85,27,3,4
"9519","D16","DN4 - Formigamento",0.4,0.119157289747005,20,99,76,23,12,8
"9520","D17","DN4 - Formigamento",0.4,0.467782054809843,5,114,85,29,3,2
"9521","D18","DN4 - Formigamento",0.3,0.766216056027575,10,109,81,28,7,3
"9522","D19","DN4 - Formigamento",0,0.175113197012655,5,114,83,31,5,0
"9523","D2","DN4 - Formigamento",0.428571428571429,0.296351034805344,7,112,84,28,4,3
"9524","D20","DN4 - Formigamento",0.2,0.752813516034861,5,114,84,30,4,1
"9525","D21","DN4 - Formigamento",0.4,0.467782054809843,5,114,85,29,3,2
"9526","D22","DN4 - Formigamento",NA,NA,0,119,88,31,0,0
"9527","D23","DN4 - Formigamento",1,0.0906514651303281,1,118,88,30,0,1
"9528","D24","DN4 - Formigamento",0.0416666666666667,0.00626114686302869,24,95,65,30,23,1
"9529","D25","DN4 - Formigamento",0,0.297771094102592,3,116,85,31,3,0
"9530","D26","DN4 - Formigamento",0,0.55115163907239,1,118,87,31,1,0
"9531","D27","DN4 - Formigamento",0.5,0.266939273393398,4,115,86,29,2,2
"9532","D28","DN4 - Formigamento",0,0.227232231770622,4,115,84,31,4,0
"9533","D29","DN4 - Formigamento",0.268292682926829,0.888387738139097,41,78,58,20,30,11
"9534","D3","DN4 - Formigamento",0,0.39726507436377,2,117,86,31,2,0
"9535","Lombalgia","DN4 - Formigamento",0.333333333333333,0.0826378864105217,57,62,50,12,38,19
"9536","D31","DN4 - Formigamento",0.4375,0.0829510273928639,16,103,79,24,9,7
"9537","D32","DN4 - Formigamento",0.305555555555556,0.460863469086601,36,83,63,20,25,11
"9538","D33","DN4 - Formigamento",0.75,4.61660587381643e-05,12,107,85,22,3,9
"9539","D34","DN4 - Formigamento",0.666666666666667,0.104500621656448,3,116,87,29,1,2
"9540","D35","DN4 - Formigamento",1,0.0906514651303281,1,118,88,30,0,1
"9541","D36","DN4 - Formigamento",0.375,0.444890353815475,8,111,83,28,5,3
"9542","D37","DN4 - Formigamento",0.363636363636364,0.222190142389455,22,97,74,23,14,8
"9543","D38","DN4 - Formigamento",0.666666666666667,0.104500621656448,3,116,87,29,1,2
"9544","D39","DN4 - Formigamento",0.266666666666667,0.953615071008199,15,104,77,27,11,4
"9545","D4","DN4 - Formigamento",0.333333333333333,0.770978521413746,3,116,86,30,2,1
"9546","D40","DN4 - Formigamento",0.4,0.467782054809843,5,114,85,29,3,2
"9547","D41","DN4 - Formigamento",0.285714285714286,0.875525765708914,7,112,83,29,5,2
"9548","D42","DN4 - Formigamento",0,0.55115163907239,1,118,87,31,1,0
"9549","D43","DN4 - Formigamento",1,0.0906514651303281,1,118,88,30,0,1
"9550","D44","DN4 - Formigamento",0.368421052631579,0.0661926275618911,38,81,64,17,24,14
"9551","D45","DN4 - Formigamento",0.666666666666667,0.000723216206233774,12,107,84,23,4,8
"9552","D46","DN4 - Formigamento",0.368421052631579,0.0661926275618911,38,81,64,17,24,14
"9553","D47","DN4 - Formigamento",0.666666666666667,0.000723216206233774,12,107,84,23,4,8
"9554","D48","DN4 - Formigamento",0.48,0.00490215543486522,25,94,75,19,13,12
"9555","D49","DN4 - Formigamento",0.769230769230769,9.51387328061662e-06,13,106,85,21,3,10
"9556","D5","DN4 - Formigamento",0.666666666666667,0.104500621656448,3,116,87,29,1,2
"9557","D50","DN4 - Formigamento",0.5,0.436422601135095,2,117,87,30,1,1
"9558","D51","DN4 - Formigamento",1,0.0906514651303281,1,118,88,30,0,1
"9559","D52","DN4 - Formigamento",0.5,0.436422601135095,2,117,87,30,1,1
"9560","D53","DN4 - Formigamento",1,0.0906514651303281,1,118,88,30,0,1
"9561","D9","DN4 - Formigamento",1,0.0906514651303281,1,118,88,30,0,1
"9562","RMDQ1_v1","DN4 - Formigamento",0.246913580246914,0.231449026336963,81,130,95,35,61,20
"9563","RMDQ2_v1","DN4 - Formigamento",0.25609756097561,0.244962253015484,82,129,95,34,61,21
"9564","RMDQ3_v1","DN4 - Formigamento",0.266666666666667,0.950982935288064,75,137,101,36,55,20
"9565","RMDQ4_v1","DN4 - Formigamento",0.276595744680851,0.826375541877911,47,165,122,43,34,13
"9566","RMDQ5_v1","DN4 - Formigamento",0.235294117647059,0.512537717775224,68,144,104,40,52,16
"9567","RMDQ6_v1","DN4 - Formigamento",0.294117647058824,0.577524443925025,51,161,120,41,36,15
"9568","RMDQ7_v1","DN4 - Formigamento",0.194444444444444,0.29780330905441,36,176,127,49,29,7
"9569","RMDQ8_v1","DN4 - Formigamento",0.142857142857143,0.459169246624527,7,205,150,55,6,1
"9570","RMDQ9_v1","DN4 - Formigamento",0.193548387096774,0.334564676943188,31,181,131,50,25,6
"9571","RMDQ10_v1","DN4 - Formigamento",0.272727272727273,0.903205654734907,33,179,132,47,24,9
"9572","RMDQ11_v1","DN4 - Formigamento",0.285714285714286,0.751491788555487,35,177,131,46,25,10
"9573","RMDQ12_v1","DN4 - Formigamento",0.153846153846154,0.0836979037188427,39,173,123,50,33,6
"9574","RMDQ13_v1","DN4 - Formigamento",0.209302325581395,0.360874042788507,43,169,122,47,34,9
"9575","RMDQ14_v1","DN4 - Formigamento",0.142857142857143,0.0464733238027768,42,170,120,50,36,6
"9576","RMDQ15_v1","DN4 - Formigamento",0.2,0.389704980538703,30,182,132,50,24,6
"9577","RMDQ16_v1","DN4 - Formigamento",0.176470588235294,0.205674311599173,34,178,128,50,28,6
"9578","RMDQ17_v1","DN4 - Formigamento",0.222222222222222,0.472265128431607,45,167,121,46,35,10
"9579","RMDQ18_v1","DN4 - Formigamento",0.2,0.389704980538703,30,182,132,50,24,6
"9580","RMDQ19_v1","DN4 - Formigamento",0.225806451612903,0.60022756681232,31,181,132,49,24,7
"9581","RMDQ20_v1","DN4 - Formigamento",0.181818181818182,0.243015315021093,33,179,129,50,27,6
"9582","RMDQ21_v1","DN4 - Formigamento",0.146341463414634,0.0567648991387372,41,171,121,50,35,6
"9583","RMDQ22_v1","DN4 - Formigamento",0.176470588235294,0.205674311599173,34,178,128,50,28,6
"9584","RMDQ23_v1","DN4 - Formigamento",0.272727272727273,0.903205654734907,33,179,132,47,24,9
"9585","RMDQ24_v1","DN4 - Formigamento",0.2,0.389704980538703,30,182,132,50,24,6
"9586","DN4 - Queimação","DN4 - Formigamento",0.475247524752475,1.56726395183159e-11,101,119,110,9,53,48
"9587","DN4 - Sensação de frio dolorosa","DN4 - Formigamento",0.479166666666667,1.415527087588e-05,48,171,141,30,25,23
"9588","DN4 - Choque elétrico","DN4 - Formigamento",0.590163934426229,2.0918433724917e-12,61,162,141,21,25,36
"9589","DN4 - Formigamento","DN4 - Formigamento",1,2.00459551247323e-50,57,166,166,0,0,57
"9590","DN4 - Alfinetada e agulhada","DN4 - Formigamento",0.569230769230769,5.71396174936494e-12,65,158,138,20,28,37
"9591","DN4 - Adormecimento","DN4 - Formigamento",0.451612903225806,4.45101140513488e-05,62,158,129,29,34,28
"9592","DN4 - Coceira","DN4 - Formigamento",0.636363636363636,0.00298548886297037,11,212,162,50,4,7
"9593","DH4 - Hipoestesia ao toque","DN4 - Formigamento",0.5,0.106543794784111,8,215,162,53,4,4
"9594","DN4 - Hipoestesia a picada de agulha","DN4 - Formigamento",0.444444444444444,0.184912008034783,9,214,161,53,5,4
"9595","DN4 - Escovação","DN4 - Formigamento",0.571428571428571,0.0516067701534699,7,216,163,53,3,4
"9596","Fuma","DN4 - Alfinetada e agulhada",0.435897435897436,0.0188149262656854,39,147,111,36,22,17
"9597","Cirurgia na coluna","DN4 - Alfinetada e agulhada",0.310810810810811,0.209315704631462,74,126,97,29,51,23
"9598","Aposentado","DN4 - Alfinetada e agulhada",0.272727272727273,0.923066685263061,33,153,110,43,24,9
"9599","Desempregado","DN4 - Alfinetada e agulhada",0.192307692307692,0.317489966798219,26,157,112,45,21,5
"9600","Licenca_Medica","DN4 - Alfinetada e agulhada",0.529411764705882,0.0147324298305629,17,167,125,42,8,9
"9601","Aposentado_Invalidez","DN4 - Alfinetada e agulhada",0.5,0.170020943487372,8,174,126,48,4,4
"9602","Analgésicos","DN4 - Alfinetada e agulhada",0.306569343065693,0.714783320721274,137,64,46,18,95,42
"9603","OutraDoenca","DN4 - Alfinetada e agulhada",0.397260273972603,0.0343185834306142,73,119,89,30,44,29
"9604","Dor nas costas","DN4 - Alfinetada e agulhada",0.305084745762712,0.405984173461354,118,76,57,19,82,36
"9605","Dor nas pernas","DN4 - Alfinetada e agulhada",0.451612903225806,0.000758979055352931,62,130,102,28,34,28
"9606","Retornar_trabalho","DN4 - Alfinetada e agulhada",0.470588235294118,0.116855005104781,17,174,124,50,9,8
"9607","Masc","DN4 - Alfinetada e agulhada",0.302013422818792,0.623310672677408,149,74,54,20,104,45
"9608","Fem","DN4 - Alfinetada e agulhada",0.27027027027027,0.623310672677408,74,149,104,45,54,20
"9609","Casado/Amasiaado","DN4 - Alfinetada e agulhada",0.222222222222222,0.0486514610908088,81,104,67,37,63,18
"9610","Solteiro","DN4 - Alfinetada e agulhada",0.346153846153846,0.214488596365182,78,107,79,28,51,27
"9611","Separado_Divorciado","DN4 - Alfinetada e agulhada",0.142857142857143,0.3620904084458,7,178,124,54,6,1
"9612","X4","DN4 - Alfinetada e agulhada",1,0.00725877307748413,3,182,130,52,0,3
"9613","X5","DN4 - Alfinetada e agulhada",0.4,0.610491395590076,5,180,127,53,3,2
"9614","X6","DN4 - Alfinetada e agulhada",0.363636363636364,0.619641352825129,11,174,123,51,7,4
"9615","Livrar_costas","DN4 - Alfinetada e agulhada",0.336538461538462,0.84939640127479,104,16,11,5,69,35
"9616","Livrar_perna","DN4 - Alfinetada e agulhada",0.357142857142857,0.840639713612799,14,106,71,35,9,5
"9617","Livrar_perda_sens","DN4 - Alfinetada e agulhada",0,0.313243773401308,2,118,78,40,2,0
"9618","D1","DN4 - Alfinetada e agulhada",0,0.508374874653824,1,118,82,36,1,0
"9619","D15","DN4 - Alfinetada e agulhada",0.714285714285714,0.014498692935062,7,112,81,31,2,5
"9620","D16","DN4 - Alfinetada e agulhada",0.35,0.612301358266918,20,99,70,29,13,7
"9621","D17","DN4 - Alfinetada e agulhada",0.6,0.139003043752015,5,114,81,33,2,3
"9622","D18","DN4 - Alfinetada e agulhada",0.6,0.032370927649448,10,109,79,30,4,6
"9623","D19","DN4 - Alfinetada e agulhada",0.6,0.139003043752015,5,114,81,33,2,3
"9624","D2","DN4 - Alfinetada e agulhada",0.714285714285714,0.014498692935062,7,112,81,31,2,5
"9625","D20","DN4 - Alfinetada e agulhada",0.4,0.627809401675126,5,114,80,34,3,2
"9626","D21","DN4 - Alfinetada e agulhada",0.4,0.627809401675126,5,114,80,34,3,2
"9627","D22","DN4 - Alfinetada e agulhada",NA,NA,0,119,83,36,0,0
"9628","D23","DN4 - Alfinetada e agulhada",1,0.127302516839353,1,118,83,35,0,1
"9629","D24","DN4 - Alfinetada e agulhada",0.166666666666667,0.10488602224455,24,95,63,32,20,4
"9630","D25","DN4 - Alfinetada e agulhada",0,0.247943045876988,3,116,80,36,3,0
"9631","D26","DN4 - Alfinetada e agulhada",0,0.508374874653824,1,118,82,36,1,0
"9632","D27","DN4 - Alfinetada e agulhada",1,0.00200713940072537,4,115,83,32,0,4
"9633","D28","DN4 - Alfinetada e agulhada",0.75,0.0474893437654903,4,115,82,33,1,3
"9634","D29","DN4 - Alfinetada e agulhada",0.24390243902439,0.31284224067714,41,78,52,26,31,10
"9635","D3","DN4 - Alfinetada e agulhada",1,0.0303398211599874,2,117,83,34,0,2
"9636","Lombalgia","DN4 - Alfinetada e agulhada",0.350877192982456,0.270856455210731,57,62,46,16,37,20
"9637","D31","DN4 - Alfinetada e agulhada",0.625,0.00254135637681665,16,103,77,26,6,10
"9638","D32","DN4 - Alfinetada e agulhada",0.25,0.411396162515402,36,83,56,27,27,9
"9639","D33","DN4 - Alfinetada e agulhada",0.583333333333333,0.0255298524370368,12,107,78,29,5,7
"9640","D34","DN4 - Alfinetada e agulhada",0.666666666666667,0.164313056647265,3,116,82,34,1,2
"9641","D35","DN4 - Alfinetada e agulhada",1,0.127302516839353,1,118,83,35,0,1
"9642","D36","DN4 - Alfinetada e agulhada",0.75,0.00433224746463042,8,111,81,30,2,6
"9643","D37","DN4 - Alfinetada e agulhada",0.454545454545455,0.0855472345791167,22,97,71,26,12,10
"9644","D38","DN4 - Alfinetada e agulhada",1,0.00772757479418338,3,116,83,33,0,3
"9645","D39","DN4 - Alfinetada e agulhada",0.4,0.37931210066382,15,104,74,30,9,6
"9646","D4","DN4 - Alfinetada e agulhada",1,0.00772757479418338,3,116,83,33,0,3
"9647","D40","DN4 - Alfinetada e agulhada",0.8,0.0133529243945253,5,114,82,32,1,4
"9648","D41","DN4 - Alfinetada e agulhada",0.714285714285714,0.014498692935062,7,112,81,31,2,5
"9649","D42","DN4 - Alfinetada e agulhada",0,0.508374874653824,1,118,82,36,1,0
"9650","D43","DN4 - Alfinetada e agulhada",1,0.127302516839353,1,118,83,35,0,1
"9651","D44","DN4 - Alfinetada e agulhada",0.289473684210526,0.831929847069928,38,81,56,25,27,11
"9652","D45","DN4 - Alfinetada e agulhada",0.666666666666667,0.00377908564860014,12,107,79,28,4,8
"9653","D46","DN4 - Alfinetada e agulhada",0.342105263157895,0.51965616320544,38,81,58,23,25,13
"9654","D47","DN4 - Alfinetada e agulhada",0.75,0.000372576926849565,12,107,80,27,3,9
"9655","D48","DN4 - Alfinetada e agulhada",0.36,0.48146032827094,25,94,67,27,16,9
"9656","D49","DN4 - Alfinetada e agulhada",0.615384615384615,0.00926872850286714,13,106,78,28,5,8
"9657","D5","DN4 - Alfinetada e agulhada",0.666666666666667,0.164313056647265,3,116,82,34,1,2
"9658","D50","DN4 - Alfinetada e agulhada",0.5,0.539771205928562,2,117,82,35,1,1
"9659","D51","DN4 - Alfinetada e agulhada",1,0.127302516839353,1,118,83,35,0,1
"9660","D52","DN4 - Alfinetada e agulhada",0.5,0.539771205928562,2,117,82,35,1,1
"9661","D53","DN4 - Alfinetada e agulhada",1,0.127302516839353,1,118,83,35,0,1
"9662","D9","DN4 - Alfinetada e agulhada",1,0.127302516839353,1,118,83,35,0,1
"9663","RMDQ1_v1","DN4 - Alfinetada e agulhada",0.296296296296296,0.291748256718926,81,130,93,37,57,24
"9664","RMDQ2_v1","DN4 - Alfinetada e agulhada",0.317073170731707,0.230151198924343,82,129,94,35,56,26
"9665","RMDQ3_v1","DN4 - Alfinetada e agulhada",0.346666666666667,0.199164938710078,75,137,101,36,49,26
"9666","RMDQ4_v1","DN4 - Alfinetada e agulhada",0.340425531914894,0.412485604347167,47,165,119,46,31,16
"9667","RMDQ5_v1","DN4 - Alfinetada e agulhada",0.382352941176471,0.047995803762316,68,144,108,36,42,26
"9668","RMDQ6_v1","DN4 - Alfinetada e agulhada",0.450980392156863,0.00429183596148837,51,161,122,39,28,23
"9669","RMDQ7_v1","DN4 - Alfinetada e agulhada",0.5,0.0026600662266838,36,176,132,44,18,18
"9670","RMDQ8_v1","DN4 - Alfinetada e agulhada",1,2.8523454992126e-05,7,205,150,55,0,7
"9671","RMDQ9_v1","DN4 - Alfinetada e agulhada",0.483870967741935,0.0112243234722338,31,181,134,47,16,15
"9672","RMDQ10_v1","DN4 - Alfinetada e agulhada",0.454545454545455,0.0259007596214018,33,179,132,47,18,15
"9673","RMDQ11_v1","DN4 - Alfinetada e agulhada",0.542857142857143,0.000365088140169493,35,177,134,43,16,19
"9674","RMDQ12_v1","DN4 - Alfinetada e agulhada",0.384615384615385,0.161322189762555,39,173,126,47,24,15
"9675","RMDQ13_v1","DN4 - Alfinetada e agulhada",0.348837209302326,0.362633980758102,43,169,122,47,28,15
"9676","RMDQ14_v1","DN4 - Alfinetada e agulhada",0.333333333333333,0.515435616806471,42,170,122,48,28,14
"9677","RMDQ15_v1","DN4 - Alfinetada e agulhada",0.366666666666667,0.33482880483961,30,182,131,51,19,11
"9678","RMDQ16_v1","DN4 - Alfinetada e agulhada",0.411764705882353,0.0951028251111057,34,178,130,48,20,14
"9679","RMDQ17_v1","DN4 - Alfinetada e agulhada",0.4,0.073947616220736,45,167,123,44,27,18
"9680","RMDQ18_v1","DN4 - Alfinetada e agulhada",0.466666666666667,0.0235762076742553,30,182,134,48,16,14
"9681","RMDQ19_v1","DN4 - Alfinetada e agulhada",0.483870967741935,0.0112243234722338,31,181,134,47,16,15
"9682","RMDQ20_v1","DN4 - Alfinetada e agulhada",0.454545454545455,0.0259007596214018,33,179,132,47,18,15
"9683","RMDQ21_v1","DN4 - Alfinetada e agulhada",0.365853658536585,0.249970132636943,41,171,124,47,26,15
"9684","RMDQ22_v1","DN4 - Alfinetada e agulhada",0.441176470588235,0.0374779127996206,34,178,131,47,19,15
"9685","RMDQ23_v1","DN4 - Alfinetada e agulhada",0.454545454545455,0.0259007596214018,33,179,132,47,18,15
"9686","RMDQ24_v1","DN4 - Alfinetada e agulhada",0.5,0.00699371085824243,30,182,135,47,15,15
"9687","DN4 - Queimação","DN4 - Alfinetada e agulhada",0.455445544554455,1.65331938547108e-06,101,119,100,19,55,46
"9688","DN4 - Sensação de frio dolorosa","DN4 - Alfinetada e agulhada",0.125,0.00724370601995142,48,171,116,55,42,6
"9689","DN4 - Choque elétrico","DN4 - Alfinetada e agulhada",0.688524590163934,1.18439795593978e-15,61,162,139,23,19,42
"9690","DN4 - Formigamento","DN4 - Alfinetada e agulhada",0.649122807017544,5.71396174936494e-12,57,166,138,28,20,37
"9691","DN4 - Alfinetada e agulhada","DN4 - Alfinetada e agulhada",1,2.0045955124732e-50,65,158,158,0,0,65
"9692","DN4 - Adormecimento","DN4 - Alfinetada e agulhada",0.596774193548387,8.44681152830884e-10,62,158,130,28,25,37
"9693","DN4 - Coceira","DN4 - Alfinetada e agulhada",1,1.136782276366e-07,11,212,158,54,0,11
"9694","DH4 - Hipoestesia ao toque","DN4 - Alfinetada e agulhada",0.875,0.000216673053331912,8,215,157,58,1,7
"9695","DN4 - Hipoestesia a picada de agulha","DN4 - Alfinetada e agulhada",1,1.80048356297352e-06,9,214,158,56,0,9
"9696","DN4 - Escovação","DN4 - Alfinetada e agulhada",1,2.77387838176512e-05,7,216,158,58,0,7
"9697","Fuma","DN4 - Adormecimento",0.282051282051282,0.85987139323557,39,145,102,43,28,11
"9698","Cirurgia na coluna","DN4 - Adormecimento",0.256756756756757,0.763080231205605,74,123,89,34,55,19
"9699","Aposentado","DN4 - Adormecimento",0.303030303030303,0.773649074651853,33,151,109,42,23,10
"9700","Desempregado","DN4 - Adormecimento",0.153846153846154,0.117150541976059,26,155,108,47,22,4
"9701","Licenca_Medica","DN4 - Adormecimento",0.294117647058824,0.893399602049962,17,165,119,46,12,5
"9702","Aposentado_Invalidez","DN4 - Adormecimento",0.5,0.164153020002218,8,172,125,47,4,4
"9703","Analgésicos","DN4 - Adormecimento",0.311111111111111,0.55426354494039,135,63,46,17,93,42
"9704","OutraDoenca","DN4 - Adormecimento",0.315068493150685,0.627293249693758,73,117,84,33,50,23
"9705","Dor nas costas","DN4 - Adormecimento",0.307692307692308,0.541735023725154,117,75,55,20,81,36
"9706","Dor nas pernas","DN4 - Adormecimento",0.426229508196721,0.0062621414728558,61,129,99,30,35,26
"9707","Retornar_trabalho","DN4 - Adormecimento",0.470588235294118,0.102525688376637,17,171,123,48,9,8
"9708","Masc","DN4 - Adormecimento",0.280821917808219,0.96320145437287,146,74,53,21,105,41
"9709","Fem","DN4 - Adormecimento",0.283783783783784,0.96320145437287,74,146,105,41,53,21
"9710","Casado/Amasiaado","DN4 - Adormecimento",0.271604938271605,0.534901691067144,81,102,70,32,59,22
"9711","Solteiro","DN4 - Adormecimento",0.263157894736842,0.424854278463538,76,107,73,34,56,20
"9712","Separado_Divorciado","DN4 - Adormecimento",0.571428571428571,0.102116961386795,7,176,126,50,3,4
"9713","X4","DN4 - Adormecimento",0.666666666666667,0.154772063632672,3,180,128,52,1,2
"9714","X5","DN4 - Adormecimento",0.8,0.0120717210767695,5,178,128,50,1,4
"9715","X6","DN4 - Adormecimento",0.181818181818182,0.395554489252605,11,172,120,52,9,2
"9716","Livrar_costas","DN4 - Adormecimento",0.29126213592233,0.0608460144847477,103,15,7,8,73,30
"9717","Livrar_perna","DN4 - Adormecimento",0.538461538461538,0.0766574292733324,13,105,74,31,6,7
"9718","Livrar_perda_sens","DN4 - Adormecimento",0.5,0.586949267478778,2,116,79,37,1,1
"9719","D1","DN4 - Adormecimento",0,0.531483921254055,1,117,84,33,1,0
"9720","D15","DN4 - Adormecimento",0.428571428571429,0.36544265238027,7,111,81,30,4,3
"9721","D16","DN4 - Adormecimento",0.45,0.0625469554834348,20,98,74,24,11,9
"9722","D17","DN4 - Adormecimento",0,0.154518328207651,5,113,80,33,5,0
"9723","D18","DN4 - Adormecimento",0.1,0.185796163618726,10,108,76,32,9,1
"9724","D19","DN4 - Adormecimento",0.2,0.685070666079238,5,113,81,32,4,1
"9725","D2","DN4 - Adormecimento",0.285714285714286,0.970652158540852,7,111,80,31,5,2
"9726","D20","DN4 - Adormecimento",0.4,0.540111281186488,5,113,82,31,3,2
"9727","D21","DN4 - Adormecimento",0.2,0.685070666079238,5,113,81,32,4,1
"9728","D22","DN4 - Adormecimento",NA,NA,0,118,85,33,0,0
"9729","D23","DN4 - Adormecimento",1,0.107014020238433,1,117,85,32,0,1
"9730","D24","DN4 - Adormecimento",0.0833333333333333,0.0163533862722201,24,94,63,31,22,2
"9731","D25","DN4 - Adormecimento",0,0.274305339715658,3,115,82,33,3,0
"9732","D26","DN4 - Adormecimento",1,0.107014020238433,1,117,85,32,0,1
"9733","D27","DN4 - Adormecimento",0.75,0.032983475967616,4,114,84,30,1,3
"9734","D28","DN4 - Adormecimento",1,0.00109208999839961,4,114,85,29,0,4
"9735","D29","DN4 - Adormecimento",0.325,0.431985702698184,40,78,58,20,27,13
"9736","D3","DN4 - Adormecimento",0.5,0.483790516345729,2,116,84,32,1,1
"9737","Lombalgia","DN4 - Adormecimento",0.375,0.0283122434292819,56,62,50,12,35,21
"9738","D31","DN4 - Adormecimento",0.5,0.0346806473890254,16,102,77,25,8,8
"9739","D32","DN4 - Adormecimento",0.342857142857143,0.320606593923282,35,83,62,21,23,12
"9740","D33","DN4 - Adormecimento",0.5,0.072771525257529,12,106,79,27,6,6
"9741","D34","DN4 - Adormecimento",0.666666666666667,0.130326862481361,3,115,84,31,1,2
"9742","D35","DN4 - Adormecimento",1,0.107014020238433,1,117,85,32,0,1
"9743","D36","DN4 - Adormecimento",0.375,0.533767282950704,8,110,80,30,5,3
"9744","D37","DN4 - Adormecimento",0.454545454545455,0.0427437413060908,22,96,73,23,12,10
"9745","D38","DN4 - Adormecimento",0.666666666666667,0.130326862481361,3,115,84,31,1,2
"9746","D39","DN4 - Adormecimento",0.466666666666667,0.0841348257973214,15,103,77,26,8,7
"9747","D4","DN4 - Adormecimento",0.666666666666667,0.130326862481361,3,115,84,31,1,2
"9748","D40","DN4 - Adormecimento",0.4,0.540111281186488,5,113,82,31,3,2
"9749","D41","DN4 - Adormecimento",0.428571428571429,0.36544265238027,7,111,81,30,4,3
"9750","D42","DN4 - Adormecimento",0,0.531483921254055,1,117,84,33,1,0
"9751","D43","DN4 - Adormecimento",1,0.107014020238433,1,117,85,32,0,1
"9752","D44","DN4 - Adormecimento",0.351351351351351,0.240928467432434,37,81,61,20,24,13
"9753","D45","DN4 - Adormecimento",0.416666666666667,0.264566727705962,12,106,78,28,7,5
"9754","D46","DN4 - Adormecimento",0.378378378378378,0.106362286393871,37,81,62,19,23,14
"9755","D47","DN4 - Adormecimento",0.416666666666667,0.264566727705962,12,106,78,28,7,5
"9756","D48","DN4 - Adormecimento",0.375,0.24364675372679,24,94,70,24,15,9
"9757","D49","DN4 - Adormecimento",0.461538461538462,0.121415134494979,13,105,78,27,7,6
"9758","D5","DN4 - Adormecimento",0.333333333333333,0.833818818348444,3,115,83,32,2,1
"9759","D50","DN4 - Adormecimento",0.5,0.483790516345729,2,116,84,32,1,1
"9760","D51","DN4 - Adormecimento",1,0.107014020238433,1,117,85,32,0,1
"9761","D52","DN4 - Adormecimento",0.5,0.483790516345729,2,116,84,32,1,1
"9762","D53","DN4 - Adormecimento",1,0.107014020238433,1,117,85,32,0,1
"9763","D9","DN4 - Adormecimento",1,0.107014020238433,1,117,85,32,0,1
"9764","RMDQ1_v1","DN4 - Adormecimento",0.382716049382716,0.00815208145448882,81,127,100,27,50,31
"9765","RMDQ2_v1","DN4 - Adormecimento",0.365853658536585,0.0222315492561776,82,126,98,28,52,30
"9766","RMDQ3_v1","DN4 - Adormecimento",0.346666666666667,0.121932546565981,75,134,101,33,49,26
"9767","RMDQ4_v1","DN4 - Adormecimento",0.361702127659574,0.169537021809952,47,162,120,42,30,17
"9768","RMDQ5_v1","DN4 - Adormecimento",0.382352941176471,0.0256343629274268,68,141,108,33,42,26
"9769","RMDQ6_v1","DN4 - Adormecimento",0.431372549019608,0.0065228926516506,51,158,121,37,29,22
"9770","RMDQ7_v1","DN4 - Adormecimento",0.388888888888889,0.11835531946683,36,173,128,45,22,14
"9771","RMDQ8_v1","DN4 - Adormecimento",0.428571428571429,0.381812300990245,7,202,146,56,4,3
"9772","RMDQ9_v1","DN4 - Adormecimento",0.451612903225806,0.0232420322146906,31,178,133,45,17,14
"9773","RMDQ10_v1","DN4 - Adormecimento",0.424242424242424,0.0483694705066989,33,176,131,45,19,14
"9774","RMDQ11_v1","DN4 - Adormecimento",0.4,0.0899819283488679,35,174,129,45,21,14
"9775","RMDQ12_v1","DN4 - Adormecimento",0.358974358974359,0.238170154136472,39,170,125,45,25,14
"9776","RMDQ13_v1","DN4 - Adormecimento",0.325581395348837,0.479218981564061,43,166,121,45,29,14
"9777","RMDQ14_v1","DN4 - Adormecimento",0.380952380952381,0.112049966900367,42,167,124,43,26,16
"9778","RMDQ15_v1","DN4 - Adormecimento",0.333333333333333,0.502179363737638,30,179,130,49,20,10
"9779","RMDQ16_v1","DN4 - Adormecimento",0.382352941176471,0.156632936691205,34,175,129,46,21,13
"9780","RMDQ17_v1","DN4 - Adormecimento",0.377777777777778,0.108189325659196,45,164,122,42,28,17
"9781","RMDQ18_v1","DN4 - Adormecimento",0.466666666666667,0.01534126871084,30,179,134,45,16,14
"9782","RMDQ19_v1","DN4 - Adormecimento",0.483870967741935,0.00689644079596225,31,178,134,44,16,15
"9783","RMDQ20_v1","DN4 - Adormecimento",0.424242424242424,0.0483694705066989,33,176,131,45,19,14
"9784","RMDQ21_v1","DN4 - Adormecimento",0.439024390243902,0.0128918394971669,41,168,127,41,23,18
"9785","RMDQ22_v1","DN4 - Adormecimento",0.5,0.00205611385737335,34,175,133,42,17,17
"9786","RMDQ23_v1","DN4 - Adormecimento",0.424242424242424,0.0483694705066989,33,176,131,45,19,14
"9787","RMDQ24_v1","DN4 - Adormecimento",0.466666666666667,0.01534126871084,30,179,134,45,16,14
"9788","DN4 - Queimação","DN4 - Adormecimento",0.455445544554455,1.33704054779248e-07,101,119,103,16,55,46
"9789","DN4 - Sensação de frio dolorosa","DN4 - Adormecimento",0.25,0.520112974529489,48,168,118,50,36,12
"9790","DN4 - Choque elétrico","DN4 - Adormecimento",0.540983606557377,1.20718350861482e-07,61,159,130,29,28,33
"9791","DN4 - Formigamento","DN4 - Adormecimento",0.491228070175439,4.45101140513488e-05,57,163,129,34,29,28
"9792","DN4 - Alfinetada e agulhada","DN4 - Adormecimento",0.569230769230769,8.44681152830884e-10,65,155,130,25,28,37
"9793","DN4 - Adormecimento","DN4 - Adormecimento",1,9.04447975804475e-50,62,158,158,0,0,62
"9794","DN4 - Coceira","DN4 - Adormecimento",0.818181818181818,4.97326230239267e-05,11,209,156,53,2,9
"9795","DH4 - Hipoestesia ao toque","DN4 - Adormecimento",0.625,0.0279551371056123,8,212,155,57,3,5
"9796","DN4 - Hipoestesia a picada de agulha","DN4 - Adormecimento",0.777777777777778,0.000732709060071309,9,211,156,55,2,7
"9797","DN4 - Escovação","DN4 - Adormecimento",0.714285714285714,0.00974432103717479,7,213,156,57,2,5
"9798","Fuma","DN4 - Coceira",0.102564102564103,0.0392052080717575,39,147,143,4,35,4
"9799","Cirurgia na coluna","DN4 - Coceira",0.0540540540540541,0.635964783089406,74,126,121,5,70,4
"9800","Aposentado","DN4 - Coceira",0.0909090909090909,0.0355059389885742,33,153,150,3,30,3
"9801","Desempregado","DN4 - Coceira",0.0769230769230769,0.172437389057117,26,157,153,4,24,2
"9802","Licenca_Medica","DN4 - Coceira",0.176470588235294,0.000455707231909072,17,167,164,3,14,3
"9803","Aposentado_Invalidez","DN4 - Coceira",0.25,0.000437802717886862,8,174,170,4,6,2
"9804","Analgésicos","DN4 - Coceira",0.0656934306569343,0.128289386014827,137,64,63,1,128,9
"9805","OutraDoenca","DN4 - Coceira",0.0958904109589041,0.0714654272968782,73,119,115,4,66,7
"9806","Dor nas costas","DN4 - Coceira",0.0423728813559322,0.921031456932321,118,76,73,3,113,5
"9807","Dor nas pernas","DN4 - Coceira",0.0806451612903226,0.126303842853706,62,130,126,4,57,5
"9808","Retornar_trabalho","DN4 - Coceira",0.117647058823529,0.205429107867913,17,174,166,8,15,2
"9809","Masc","DN4 - Coceira",0.0604026845637584,0.278478014292514,149,74,72,2,140,9
"9810","Fem","DN4 - Coceira",0.027027027027027,0.278478014292514,74,149,140,9,72,2
"9811","Casado/Amasiaado","DN4 - Coceira",0.0246913580246914,0.408206429617873,81,104,99,5,79,2
"9812","Solteiro","DN4 - Coceira",0.0256410256410256,0.457883994181554,78,107,102,5,76,2
"9813","Separado_Divorciado","DN4 - Coceira",0,0.592726414847795,7,178,171,7,7,0
"9814","X4","DN4 - Coceira",0.333333333333333,0.00684234475716709,3,182,176,6,2,1
"9815","X5","DN4 - Coceira",0,0.653038209525315,5,180,173,7,5,0
"9816","X6","DN4 - Coceira",0.181818181818182,0.00986240276699366,11,174,169,5,9,2
"9817","Livrar_costas","DN4 - Coceira",0.0480769230769231,0.370294615560341,104,16,16,0,99,5
"9818","Livrar_perna","DN4 - Coceira",0,0.406474276328387,14,106,101,5,14,0
"9819","Livrar_perda_sens","DN4 - Coceira",0,0.766182191157743,2,118,113,5,2,0
"9820","D1","DN4 - Coceira",0,0.817001778007153,1,118,112,6,1,0
"9821","D15","DN4 - Coceira",0.142857142857143,0.249278728612911,7,112,107,5,6,1
"9822","D16","DN4 - Coceira",0.1,0.266574970439957,20,99,95,4,18,2
"9823","D17","DN4 - Coceira",0,0.598587935384081,5,114,108,6,5,0
"9824","D18","DN4 - Coceira",0,0.446435185239397,10,109,103,6,10,0
"9825","D19","DN4 - Coceira",0.2,0.11834715083047,5,114,109,5,4,1
"9826","D2","DN4 - Coceira",0.285714285714286,0.0033610855800127,7,112,108,4,5,2
"9827","D20","DN4 - Coceira",0.2,0.11834715083047,5,114,109,5,4,1
"9828","D21","DN4 - Coceira",0.2,0.11834715083047,5,114,109,5,4,1
"9829","D22","DN4 - Coceira",NA,NA,0,119,113,6,0,0
"9830","D23","DN4 - Coceira",0,0.817001778007153,1,118,112,6,1,0
"9831","D24","DN4 - Coceira",0.0416666666666667,0.826379941349948,24,95,90,5,23,1
"9832","D25","DN4 - Coceira",0,0.686034714726899,3,116,110,6,3,0
"9833","D26","DN4 - Coceira",0,0.817001778007153,1,118,112,6,1,0
"9834","D27","DN4 - Coceira",0,0.63921000981023,4,115,109,6,4,0
"9835","D28","DN4 - Coceira",0,0.63921000981023,4,115,109,6,4,0
"9836","D29","DN4 - Coceira",0.024390243902439,0.346778696019672,41,78,73,5,40,1
"9837","D3","DN4 - Coceira",0.5,0.00338470231249276,2,117,112,5,1,1
"9838","Lombalgia","DN4 - Coceira",0.0526315789473684,0.915812340238761,57,62,59,3,54,3
"9839","D31","DN4 - Coceira",0,0.32182195153957,16,103,97,6,16,0
"9840","D32","DN4 - Coceira",0.0277777777777778,0.457221398349819,36,83,78,5,35,1
"9841","D33","DN4 - Coceira",0.0833333333333333,0.582656910389208,12,107,102,5,11,1
"9842","D34","DN4 - Coceira",0.333333333333333,0.0233141434108428,3,116,111,5,2,1
"9843","D35","DN4 - Coceira",1,1.31203161243512e-05,1,118,113,5,0,1
"9844","D36","DN4 - Coceira",0,0.499784758338323,8,111,105,6,8,0
"9845","D37","DN4 - Coceira",0.0909090909090909,0.336392058412393,22,97,93,4,20,2
"9846","D38","DN4 - Coceira",0,0.686034714726899,3,116,110,6,3,0
"9847","D39","DN4 - Coceira",0.0666666666666667,0.758382407367147,15,104,99,5,14,1
"9848","D4","DN4 - Coceira",0.666666666666667,7.78280281738889e-07,3,116,112,4,1,2
"9849","D40","DN4 - Coceira",0,0.598587935384081,5,114,108,6,5,0
"9850","D41","DN4 - Coceira",0.142857142857143,0.249278728612911,7,112,107,5,6,1
"9851","D42","DN4 - Coceira",0,0.817001778007153,1,118,112,6,1,0
"9852","D43","DN4 - Coceira",0,0.817001778007153,1,118,112,6,1,0
"9853","D44","DN4 - Coceira",0.0263157894736842,0.410453044653206,38,81,76,5,37,1
"9854","D45","DN4 - Coceira",0,0.399900240836412,12,107,101,6,12,0
"9855","D46","DN4 - Coceira",0.0526315789473684,0.939806194659872,38,81,77,4,36,2
"9856","D47","DN4 - Coceira",0,0.399900240836412,12,107,101,6,12,0
"9857","D48","DN4 - Coceira",0.08,0.44694723501294,25,94,90,4,23,2
"9858","D49","DN4 - Coceira",0.0769230769230769,0.643565378174902,13,106,101,5,12,1
"9859","D5","DN4 - Coceira",0.333333333333333,0.0233141434108428,3,116,111,5,2,1
"9860","D50","DN4 - Coceira",0,0.742421215085394,2,117,111,6,2,0
"9861","D51","DN4 - Coceira",1,1.31203161243512e-05,1,118,113,5,0,1
"9862","D52","DN4 - Coceira",0,0.742421215085394,2,117,111,6,2,0
"9863","D53","DN4 - Coceira",0,0.817001778007153,1,118,112,6,1,0
"9864","D9","DN4 - Coceira",1,1.31203161243512e-05,1,118,113,5,0,1
"9865","RMDQ1_v1","DN4 - Coceira",0.0740740740740741,0.511309730893215,81,130,125,5,75,6
"9866","RMDQ2_v1","DN4 - Coceira",0.0609756097560976,0.874510431028916,82,129,123,6,77,5
"9867","RMDQ3_v1","DN4 - Coceira",0.0266666666666667,0.220584862106837,75,137,128,9,73,2
"9868","RMDQ4_v1","DN4 - Coceira",0,0.0690773633006216,47,165,154,11,47,0
"9869","RMDQ5_v1","DN4 - Coceira",0.0441176470588235,0.725982954394664,68,144,136,8,65,3
"9870","RMDQ6_v1","DN4 - Coceira",0.0588235294117647,0.797724578374081,51,161,153,8,48,3
"9871","RMDQ7_v1","DN4 - Coceira",0.0833333333333333,0.350492102089586,36,176,168,8,33,3
"9872","RMDQ8_v1","DN4 - Coceira",0,0.529076219218887,7,205,194,11,7,0
"9873","RMDQ9_v1","DN4 - Coceira",0.0967741935483871,0.222661254184648,31,181,173,8,28,3
"9874","RMDQ10_v1","DN4 - Coceira",0.0909090909090909,0.271376225839429,33,179,171,8,30,3
"9875","RMDQ11_v1","DN4 - Coceira",0.0857142857142857,0.323409257998533,35,177,169,8,32,3
"9876","RMDQ12_v1","DN4 - Coceira",0.0769230769230769,0.435185825682832,39,173,165,8,36,3
"9877","RMDQ13_v1","DN4 - Coceira",0.0697674418604651,0.55379410473523,43,169,161,8,40,3
"9878","RMDQ14_v1","DN4 - Coceira",0.0476190476190476,0.889249344313632,42,170,161,9,40,2
"9879","RMDQ15_v1","DN4 - Coceira",0.0666666666666667,0.693642072654427,30,182,173,9,28,2
"9880","RMDQ16_v1","DN4 - Coceira",0.0588235294117647,0.842248038288819,34,178,169,9,32,2
"9881","RMDQ17_v1","DN4 - Coceira",0.0444444444444444,0.799796400427567,45,167,158,9,43,2
"9882","RMDQ18_v1","DN4 - Coceira",0.0666666666666667,0.693642072654427,30,182,173,9,28,2
"9883","RMDQ19_v1","DN4 - Coceira",0.0967741935483871,0.222661254184648,31,181,173,8,28,3
"9884","RMDQ20_v1","DN4 - Coceira",0.0909090909090909,0.271376225839429,33,179,171,8,30,3
"9885","RMDQ21_v1","DN4 - Coceira",0.0731707317073171,0.493876500060901,41,171,163,8,38,3
"9886","RMDQ22_v1","DN4 - Coceira",0.0882352941176471,0.297013826406587,34,178,170,8,31,3
"9887","RMDQ23_v1","DN4 - Coceira",0.0909090909090909,0.271376225839429,33,179,171,8,30,3
"9888","RMDQ24_v1","DN4 - Coceira",0.1,0.199728086972641,30,182,174,8,27,3
"9889","DN4 - Queimação","DN4 - Coceira",0.0891089108910891,0.0142049064107218,101,119,117,2,92,9
"9890","DN4 - Sensação de frio dolorosa","DN4 - Coceira",0,0.0713793678197071,48,171,160,11,48,0
"9891","DN4 - Choque elétrico","DN4 - Coceira",0.147540983606557,3.23913203994836e-05,61,162,160,2,52,9
"9892","DN4 - Formigamento","DN4 - Coceira",0.12280701754386,0.00298548886297037,57,166,162,4,50,7
"9893","DN4 - Alfinetada e agulhada","DN4 - Coceira",0.169230769230769,1.136782276366e-07,65,158,158,0,54,11
"9894","DN4 - Adormecimento","DN4 - Coceira",0.145161290322581,4.97326230239267e-05,62,158,156,2,53,9
"9895","DN4 - Coceira","DN4 - Coceira",1,2.0045955124732e-50,11,212,212,0,0,11
"9896","DH4 - Hipoestesia ao toque","DN4 - Coceira",0.375,1.47683157343954e-05,8,215,207,8,5,3
"9897","DN4 - Hipoestesia a picada de agulha","DN4 - Coceira",0.333333333333333,5.90987565363136e-05,9,214,206,8,6,3
"9898","DN4 - Escovação","DN4 - Coceira",0.428571428571429,2.50192149129156e-06,7,216,208,8,4,3
"9899","Fuma","DH4 - Hipoestesia ao toque",0.102564102564103,0.0165441606794115,39,147,144,3,35,4
"9900","Cirurgia na coluna","DH4 - Hipoestesia ao toque",0.0405405405405405,0.280678605211463,74,126,124,2,71,3
"9901","Aposentado","DH4 - Hipoestesia ao toque",0.0606060606060606,0.309520825184632,33,153,149,4,31,2
"9902","Desempregado","DH4 - Hipoestesia ao toque",0.115384615384615,0.00294160960349787,26,157,155,2,23,3
"9903","Licenca_Medica","DH4 - Hipoestesia ao toque",0.117647058823529,0.0160293064749318,17,167,164,3,15,2
"9904","Aposentado_Invalidez","DH4 - Hipoestesia ao toque",0.25,0.000437802717886862,8,174,170,4,6,2
"9905","Analgésicos","DH4 - Hipoestesia ao toque",0.0510948905109489,0.0656699619495896,137,64,64,0,130,7
"9906","OutraDoenca","DH4 - Hipoestesia ao toque",0.0410958904109589,0.788290736702024,73,119,115,4,70,3
"9907","Dor nas costas","DH4 - Hipoestesia ao toque",0.0423728813559322,0.251232754975307,118,76,75,1,113,5
"9908","Dor nas pernas","DH4 - Hipoestesia ao toque",0.0806451612903226,0.0065952994083608,62,130,129,1,57,5
"9909","Retornar_trabalho","DH4 - Hipoestesia ao toque",0.176470588235294,0.00130664873956548,17,174,170,4,14,3
"9910","Masc","DH4 - Hipoestesia ao toque",0.0402684563758389,0.616619212122889,149,74,72,2,143,6
"9911","Fem","DH4 - Hipoestesia ao toque",0.027027027027027,0.616619212122889,74,149,143,6,72,2
"9912","Casado/Amasiaado","DH4 - Hipoestesia ao toque",0.037037037037037,0.755030127145604,81,104,101,3,78,3
"9913","Solteiro","DH4 - Hipoestesia ao toque",0.0384615384615385,0.692663830585402,78,107,104,3,75,3
"9914","Separado_Divorciado","DH4 - Hipoestesia ao toque",0,0.621429036548809,7,178,172,6,7,0
"9915","X4","DH4 - Hipoestesia ao toque",0,0.749186120839485,3,182,176,6,3,0
"9916","X5","DH4 - Hipoestesia ao toque",0,0.678116980295812,5,180,174,6,5,0
"9917","X6","DH4 - Hipoestesia ao toque",0,0.531237070984813,11,174,168,6,11,0
"9918","Livrar_costas","DH4 - Hipoestesia ao toque",0.0384615384615385,0.424942938277499,104,16,16,0,100,4
"9919","Livrar_perna","DH4 - Hipoestesia ao toque",0,0.459743448144979,14,106,102,4,14,0
"9920","Livrar_perda_sens","DH4 - Hipoestesia ao toque",0,0.791141159033469,2,118,114,4,2,0
"9921","D1","DH4 - Hipoestesia ao toque",0,0.833423792098798,1,118,113,5,1,0
"9922","D15","DH4 - Hipoestesia ao toque",0.142857142857143,0.170453834419036,7,112,108,4,6,1
"9923","D16","DH4 - Hipoestesia ao toque",0.05,0.845314736680156,20,99,95,4,19,1
"9924","D17","DH4 - Hipoestesia ao toque",0,0.632328327021753,5,114,109,5,5,0
"9925","D18","DH4 - Hipoestesia ao toque",0.1,0.339612700081032,10,109,105,4,9,1
"9926","D19","DH4 - Hipoestesia ao toque",0.2,0.0720217504435083,5,114,110,4,4,1
"9927","D2","DH4 - Hipoestesia ao toque",0.285714285714286,0.000924203167710576,7,112,109,3,5,2
"9928","D20","DH4 - Hipoestesia ao toque",0.2,0.0720217504435083,5,114,110,4,4,1
"9929","D21","DH4 - Hipoestesia ao toque",0,0.632328327021753,5,114,109,5,5,0
"9930","D22","DH4 - Hipoestesia ao toque",NA,NA,0,119,114,5,0,0
"9931","D23","DH4 - Hipoestesia ao toque",0,0.833423792098798,1,118,113,5,1,0
"9932","D24","DH4 - Hipoestesia ao toque",0.0833333333333333,0.258835660952616,24,95,92,3,22,2
"9933","D25","DH4 - Hipoestesia ao toque",0,0.71332159403313,3,116,111,5,3,0
"9934","D26","DH4 - Hipoestesia ao toque",0,0.833423792098798,1,118,113,5,1,0
"9935","D27","DH4 - Hipoestesia ao toque",0,0.670052424301302,4,115,110,5,4,0
"9936","D28","DH4 - Hipoestesia ao toque",0,0.670052424301302,4,115,110,5,4,0
"9937","D29","DH4 - Hipoestesia ao toque",0,0.0976520625454602,41,78,73,5,41,0
"9938","D3","DH4 - Hipoestesia ao toque",0.5,0.00113082615896294,2,117,113,4,1,1
"9939","Lombalgia","DH4 - Hipoestesia ao toque",0.0350877192982456,0.717917055169856,57,62,59,3,55,2
"9940","D31","DH4 - Hipoestesia ao toque",0,0.367894241007966,16,103,98,5,16,0
"9941","D32","DH4 - Hipoestesia ao toque",0,0.132429438284423,36,83,78,5,36,0
"9942","D33","DH4 - Hipoestesia ao toque",0,0.444226067014997,12,107,102,5,12,0
"9943","D34","DH4 - Hipoestesia ao toque",0.666666666666667,4.70813487421436e-08,3,116,113,3,1,2
"9944","D35","DH4 - Hipoestesia ao toque",1,1.6257371427835e-06,1,118,114,4,0,1
"9945","D36","DH4 - Hipoestesia ao toque",0,0.539662498936668,8,111,106,5,8,0
"9946","D37","DH4 - Hipoestesia ao toque",0.0454545454545455,0.929067031228355,22,97,93,4,21,1
"9947","D38","DH4 - Hipoestesia ao toque",0,0.71332159403313,3,116,111,5,3,0
"9948","D39","DH4 - Hipoestesia ao toque",0,0.385596417926411,15,104,99,5,15,0
"9949","D4","DH4 - Hipoestesia ao toque",0.666666666666667,4.70813487421436e-08,3,116,113,3,1,2
"9950","D40","DH4 - Hipoestesia ao toque",0,0.632328327021753,5,114,109,5,5,0
"9951","D41","DH4 - Hipoestesia ao toque",0,0.567901636238271,7,112,107,5,7,0
"9952","D42","DH4 - Hipoestesia ao toque",0,0.833423792098798,1,118,113,5,1,0
"9953","D43","DH4 - Hipoestesia ao toque",1,1.6257371427835e-06,1,118,114,4,0,1
"9954","D44","DH4 - Hipoestesia ao toque",0,0.117632762345584,38,81,76,5,38,0
"9955","D45","DH4 - Hipoestesia ao toque",0,0.444226067014997,12,107,102,5,12,0
"9956","D46","DH4 - Hipoestesia ao toque",0.0263157894736842,0.558725007131444,38,81,77,4,37,1
"9957","D47","DH4 - Hipoestesia ao toque",0.0833333333333333,0.451855575848102,12,107,103,4,11,1
"9958","D48","DH4 - Hipoestesia ao toque",0,0.238724325823377,25,94,89,5,25,0
"9959","D49","DH4 - Hipoestesia ao toque",0,0.423673641225769,13,106,101,5,13,0
"9960","D5","DH4 - Hipoestesia ao toque",0.333333333333333,0.0108560655197623,3,116,112,4,2,1
"9961","D50","DH4 - Hipoestesia ao toque",0.5,0.00113082615896294,2,117,113,4,1,1
"9962","D51","DH4 - Hipoestesia ao toque",1,1.6257371427835e-06,1,118,114,4,0,1
"9963","D52","DH4 - Hipoestesia ao toque",0.5,0.00113082615896294,2,117,113,4,1,1
"9964","D53","DH4 - Hipoestesia ao toque",1,1.6257371427835e-06,1,118,114,4,0,1
"9965","D9","DH4 - Hipoestesia ao toque",1,1.6257371427835e-06,1,118,114,4,0,1
"9966","RMDQ1_v1","DH4 - Hipoestesia ao toque",0.0617283950617284,0.183481095295291,81,130,128,2,76,5
"9967","RMDQ2_v1","DH4 - Hipoestesia ao toque",0.0609756097560976,0.19389547816516,82,129,127,2,77,5
"9968","RMDQ3_v1","DH4 - Hipoestesia ao toque",0.0666666666666667,0.0424950368778223,75,137,135,2,70,5
"9969","RMDQ4_v1","DH4 - Hipoestesia ao toque",0.0212765957446809,0.609584954759234,47,165,159,6,46,1
"9970","RMDQ5_v1","DH4 - Hipoestesia ao toque",0.0588235294117647,0.148475296901625,68,144,141,3,64,4
"9971","RMDQ6_v1","DH4 - Hipoestesia ao toque",0.0784313725490196,0.0372791334115866,51,161,158,3,47,4
"9972","RMDQ7_v1","DH4 - Hipoestesia ao toque",0.111111111111111,0.00400290344824931,36,176,173,3,32,4
"9973","RMDQ8_v1","DH4 - Hipoestesia ao toque",0,0.61906336739482,7,205,198,7,7,0
"9974","RMDQ9_v1","DH4 - Hipoestesia ao toque",0.161290322580645,1.52096182008966e-05,31,181,179,2,26,5
"9975","RMDQ10_v1","DH4 - Hipoestesia ao toque",0.121212121212121,0.00203122329892033,33,179,176,3,29,4
"9976","RMDQ11_v1","DH4 - Hipoestesia ao toque",0.114285714285714,0.00323285080933449,35,177,174,3,31,4
"9977","RMDQ12_v1","DH4 - Hipoestesia ao toque",0.102564102564103,0.00713165947264401,39,173,170,3,35,4
"9978","RMDQ13_v1","DH4 - Hipoestesia ao toque",0.0930232558139535,0.0136504338106029,43,169,166,3,39,4
"9979","RMDQ14_v1","DH4 - Hipoestesia ao toque",0.0952380952380952,0.0117350775654101,42,170,167,3,38,4
"9980","RMDQ15_v1","DH4 - Hipoestesia ao toque",0.133333333333333,0.000904416361714182,30,182,179,3,26,4
"9981","RMDQ16_v1","DH4 - Hipoestesia ao toque",0.117647058823529,0.00257951051202975,34,178,175,3,30,4
"9982","RMDQ17_v1","DH4 - Hipoestesia ao toque",0.0888888888888889,0.0181167666764295,45,167,164,3,41,4
"9983","RMDQ18_v1","DH4 - Hipoestesia ao toque",0.133333333333333,0.000904416361714182,30,182,179,3,26,4
"9984","RMDQ19_v1","DH4 - Hipoestesia ao toque",0.129032258064516,0.00120451487286722,31,181,178,3,27,4
"9985","RMDQ20_v1","DH4 - Hipoestesia ao toque",0.121212121212121,0.00203122329892033,33,179,176,3,29,4
"9986","RMDQ21_v1","DH4 - Hipoestesia ao toque",0.0975609756097561,0.0100175450852705,41,171,168,3,37,4
"9987","RMDQ22_v1","DH4 - Hipoestesia ao toque",0.117647058823529,0.00257951051202975,34,178,175,3,30,4
"9988","RMDQ23_v1","DH4 - Hipoestesia ao toque",0.121212121212121,0.00203122329892033,33,179,176,3,29,4
"9989","RMDQ24_v1","DH4 - Hipoestesia ao toque",0.133333333333333,0.000904416361714182,30,182,179,3,26,4
"9990","DN4 - Queimação","DH4 - Hipoestesia ao toque",0.0594059405940594,0.0925626679439719,101,119,117,2,95,6
"9991","DN4 - Sensação de frio dolorosa","DH4 - Hipoestesia ao toque",0.0625,0.277755605412279,48,171,166,5,45,3
"9992","DN4 - Choque elétrico","DH4 - Hipoestesia ao toque",0.114754098360656,0.000101674322618174,61,162,161,1,54,7
"9993","DN4 - Formigamento","DH4 - Hipoestesia ao toque",0.0701754385964912,0.106543794784111,57,166,162,4,53,4
"9994","DN4 - Alfinetada e agulhada","DH4 - Hipoestesia ao toque",0.107692307692308,0.000216673053331912,65,158,157,1,58,7
"9995","DN4 - Adormecimento","DH4 - Hipoestesia ao toque",0.0806451612903226,0.0279551371056123,62,158,155,3,57,5
"9996","DN4 - Coceira","DH4 - Hipoestesia ao toque",0.272727272727273,1.47683157343954e-05,11,212,207,5,8,3
"9997","DH4 - Hipoestesia ao toque","DH4 - Hipoestesia ao toque",1,2.00459551247323e-50,8,215,215,0,0,8
"9998","DN4 - Hipoestesia a picada de agulha","DH4 - Hipoestesia ao toque",0.777777777777778,2.53078892719671e-34,9,214,213,1,2,7
"9999","DN4 - Escovação","DH4 - Hipoestesia ao toque",1,3.8096863903247e-44,7,216,215,1,0,7
"10000","Fuma","DN4 - Hipoestesia a picada de agulha",0.128205128205128,0.00317934889476581,39,147,144,3,34,5
"10001","Cirurgia na coluna","DN4 - Hipoestesia a picada de agulha",0.027027027027027,0.88809703569092,74,126,123,3,72,2
"10002","Aposentado","DN4 - Hipoestesia a picada de agulha",0.0606060606060606,0.444548495977596,33,153,148,5,31,2
"10003","Desempregado","DN4 - Hipoestesia a picada de agulha",0.115384615384615,0.010667603730983,26,157,154,3,23,3
"10004","Licenca_Medica","DN4 - Hipoestesia a picada de agulha",0.117647058823529,0.0382509940907734,17,167,163,4,15,2
"10005","Aposentado_Invalidez","DN4 - Hipoestesia a picada de agulha",0.25,0.00146267097872286,8,174,169,5,6,2
"10006","Analgésicos","DN4 - Hipoestesia a picada de agulha",0.0583941605839416,0.0485126520663351,137,64,64,0,129,8
"10007","OutraDoenca","DN4 - Hipoestesia a picada de agulha",0.0410958904109589,0.975270103701947,73,119,114,5,70,3
"10008","Dor nas costas","DN4 - Hipoestesia a picada de agulha",0.0338983050847458,0.83893133358566,118,76,73,3,114,4
"10009","Dor nas pernas","DN4 - Hipoestesia a picada de agulha",0.0645161290322581,0.15200073527304,62,130,127,3,58,4
"10010","Retornar_trabalho","DN4 - Hipoestesia a picada de agulha",0.176470588235294,0.00370542718338043,17,174,169,5,14,3
"10011","Masc","DN4 - Hipoestesia a picada de agulha",0.0469798657718121,0.475898128680994,149,74,72,2,142,7
"10012","Fem","DN4 - Hipoestesia a picada de agulha",0.027027027027027,0.475898128680994,74,149,142,7,72,2
"10013","Casado/Amasiaado","DN4 - Hipoestesia a picada de agulha",0.0246913580246914,0.408206429617873,81,104,99,5,79,2
"10014","Solteiro","DN4 - Hipoestesia a picada de agulha",0.0641025641025641,0.109920104973387,78,107,105,2,73,5
"10015","Separado_Divorciado","DN4 - Hipoestesia a picada de agulha",0,0.592726414847795,7,178,171,7,7,0
"10016","X4","DN4 - Hipoestesia a picada de agulha",0,0.729118871529751,3,182,175,7,3,0
"10017","X5","DN4 - Hipoestesia a picada de agulha",0,0.653038209525315,5,180,173,7,5,0
"10018","X6","DN4 - Hipoestesia a picada de agulha",0,0.497655964603027,11,174,167,7,11,0
"10019","Livrar_costas","DN4 - Hipoestesia a picada de agulha",0.0384615384615385,0.424942938277499,104,16,16,0,100,4
"10020","Livrar_perna","DN4 - Hipoestesia a picada de agulha",0,0.459743448144979,14,106,102,4,14,0
"10021","Livrar_perda_sens","DN4 - Hipoestesia a picada de agulha",0,0.791141159033469,2,118,114,4,2,0
"10022","D1","DN4 - Hipoestesia a picada de agulha",0,0.833423792098798,1,118,113,5,1,0
"10023","D15","DN4 - Hipoestesia a picada de agulha",0.142857142857143,0.170453834419036,7,112,108,4,6,1
"10024","D16","DN4 - Hipoestesia a picada de agulha",0.05,0.845314736680156,20,99,95,4,19,1
"10025","D17","DN4 - Hipoestesia a picada de agulha",0,0.632328327021753,5,114,109,5,5,0
"10026","D18","DN4 - Hipoestesia a picada de agulha",0.1,0.339612700081032,10,109,105,4,9,1
"10027","D19","DN4 - Hipoestesia a picada de agulha",0.2,0.0720217504435083,5,114,110,4,4,1
"10028","D2","DN4 - Hipoestesia a picada de agulha",0.285714285714286,0.000924203167710576,7,112,109,3,5,2
"10029","D20","DN4 - Hipoestesia a picada de agulha",0.2,0.0720217504435083,5,114,110,4,4,1
"10030","D21","DN4 - Hipoestesia a picada de agulha",0,0.632328327021753,5,114,109,5,5,0
"10031","D22","DN4 - Hipoestesia a picada de agulha",NA,NA,0,119,114,5,0,0
"10032","D23","DN4 - Hipoestesia a picada de agulha",0,0.833423792098798,1,118,113,5,1,0
"10033","D24","DN4 - Hipoestesia a picada de agulha",0.0833333333333333,0.258835660952616,24,95,92,3,22,2
"10034","D25","DN4 - Hipoestesia a picada de agulha",0,0.71332159403313,3,116,111,5,3,0
"10035","D26","DN4 - Hipoestesia a picada de agulha",0,0.833423792098798,1,118,113,5,1,0
"10036","D27","DN4 - Hipoestesia a picada de agulha",0.25,0.0349379793761989,4,115,111,4,3,1
"10037","D28","DN4 - Hipoestesia a picada de agulha",0.25,0.0349379793761989,4,115,111,4,3,1
"10038","D29","DN4 - Hipoestesia a picada de agulha",0,0.0976520625454602,41,78,73,5,41,0
"10039","D3","DN4 - Hipoestesia a picada de agulha",0.5,0.00113082615896294,2,117,113,4,1,1
"10040","Lombalgia","DN4 - Hipoestesia a picada de agulha",0.0350877192982456,0.717917055169856,57,62,59,3,55,2
"10041","D31","DN4 - Hipoestesia a picada de agulha",0,0.367894241007966,16,103,98,5,16,0
"10042","D32","DN4 - Hipoestesia a picada de agulha",0,0.132429438284423,36,83,78,5,36,0
"10043","D33","DN4 - Hipoestesia a picada de agulha",0,0.444226067014997,12,107,102,5,12,0
"10044","D34","DN4 - Hipoestesia a picada de agulha",0.666666666666667,4.70813487421436e-08,3,116,113,3,1,2
"10045","D35","DN4 - Hipoestesia a picada de agulha",1,1.6257371427835e-06,1,118,114,4,0,1
"10046","D36","DN4 - Hipoestesia a picada de agulha",0,0.539662498936668,8,111,106,5,8,0
"10047","D37","DN4 - Hipoestesia a picada de agulha",0.0454545454545455,0.929067031228355,22,97,93,4,21,1
"10048","D38","DN4 - Hipoestesia a picada de agulha",0,0.71332159403313,3,116,111,5,3,0
"10049","D39","DN4 - Hipoestesia a picada de agulha",0,0.385596417926411,15,104,99,5,15,0
"10050","D4","DN4 - Hipoestesia a picada de agulha",0.666666666666667,4.70813487421436e-08,3,116,113,3,1,2
"10051","D40","DN4 - Hipoestesia a picada de agulha",0,0.632328327021753,5,114,109,5,5,0
"10052","D41","DN4 - Hipoestesia a picada de agulha",0,0.567901636238271,7,112,107,5,7,0
"10053","D42","DN4 - Hipoestesia a picada de agulha",0,0.833423792098798,1,118,113,5,1,0
"10054","D43","DN4 - Hipoestesia a picada de agulha",1,1.6257371427835e-06,1,118,114,4,0,1
"10055","D44","DN4 - Hipoestesia a picada de agulha",0,0.117632762345584,38,81,76,5,38,0
"10056","D45","DN4 - Hipoestesia a picada de agulha",0,0.444226067014997,12,107,102,5,12,0
"10057","D46","DN4 - Hipoestesia a picada de agulha",0.0263157894736842,0.558725007131444,38,81,77,4,37,1
"10058","D47","DN4 - Hipoestesia a picada de agulha",0.0833333333333333,0.451855575848102,12,107,103,4,11,1
"10059","D48","DN4 - Hipoestesia a picada de agulha",0,0.238724325823377,25,94,89,5,25,0
"10060","D49","DN4 - Hipoestesia a picada de agulha",0,0.423673641225769,13,106,101,5,13,0
"10061","D5","DN4 - Hipoestesia a picada de agulha",0.333333333333333,0.0108560655197623,3,116,112,4,2,1
"10062","D50","DN4 - Hipoestesia a picada de agulha",0.5,0.00113082615896294,2,117,113,4,1,1
"10063","D51","DN4 - Hipoestesia a picada de agulha",1,1.6257371427835e-06,1,118,114,4,0,1
"10064","D52","DN4 - Hipoestesia a picada de agulha",0.5,0.00113082615896294,2,117,113,4,1,1
"10065","D53","DN4 - Hipoestesia a picada de agulha",1,1.6257371427835e-06,1,118,114,4,0,1
"10066","D9","DN4 - Hipoestesia a picada de agulha",1,1.6257371427835e-06,1,118,114,4,0,1
"10067","RMDQ1_v1","DN4 - Hipoestesia a picada de agulha",0.0493827160493827,0.572377583306212,81,130,127,3,77,4
"10068","RMDQ2_v1","DN4 - Hipoestesia a picada de agulha",0.0487804878048781,0.58940764301107,82,129,126,3,78,4
"10069","RMDQ3_v1","DN4 - Hipoestesia a picada de agulha",0.0533333333333333,0.2206629042074,75,137,134,3,71,4
"10070","RMDQ4_v1","DN4 - Hipoestesia a picada de agulha",0,0.151009363170705,47,165,158,7,47,0
"10071","RMDQ5_v1","DN4 - Hipoestesia a picada de agulha",0.0588235294117647,0.148475296901625,68,144,141,3,64,4
"10072","RMDQ6_v1","DN4 - Hipoestesia a picada de agulha",0.0784313725490196,0.0372791334115866,51,161,158,3,47,4
"10073","RMDQ7_v1","DN4 - Hipoestesia a picada de agulha",0.111111111111111,0.00400290344824931,36,176,173,3,32,4
"10074","RMDQ8_v1","DN4 - Hipoestesia a picada de agulha",0,0.61906336739482,7,205,198,7,7,0
"10075","RMDQ9_v1","DN4 - Hipoestesia a picada de agulha",0.129032258064516,0.00120451487286722,31,181,178,3,27,4
"10076","RMDQ10_v1","DN4 - Hipoestesia a picada de agulha",0.121212121212121,0.00203122329892033,33,179,176,3,29,4
"10077","RMDQ11_v1","DN4 - Hipoestesia a picada de agulha",0.114285714285714,0.00323285080933449,35,177,174,3,31,4
"10078","RMDQ12_v1","DN4 - Hipoestesia a picada de agulha",0.102564102564103,0.00713165947264401,39,173,170,3,35,4
"10079","RMDQ13_v1","DN4 - Hipoestesia a picada de agulha",0.0930232558139535,0.0136504338106029,43,169,166,3,39,4
"10080","RMDQ14_v1","DN4 - Hipoestesia a picada de agulha",0.0952380952380952,0.0117350775654101,42,170,167,3,38,4
"10081","RMDQ15_v1","DN4 - Hipoestesia a picada de agulha",0.133333333333333,0.000904416361714182,30,182,179,3,26,4
"10082","RMDQ16_v1","DN4 - Hipoestesia a picada de agulha",0.117647058823529,0.00257951051202975,34,178,175,3,30,4
"10083","RMDQ17_v1","DN4 - Hipoestesia a picada de agulha",0.0888888888888889,0.0181167666764295,45,167,164,3,41,4
"10084","RMDQ18_v1","DN4 - Hipoestesia a picada de agulha",0.133333333333333,0.000904416361714182,30,182,179,3,26,4
"10085","RMDQ19_v1","DN4 - Hipoestesia a picada de agulha",0.129032258064516,0.00120451487286722,31,181,178,3,27,4
"10086","RMDQ20_v1","DN4 - Hipoestesia a picada de agulha",0.121212121212121,0.00203122329892033,33,179,176,3,29,4
"10087","RMDQ21_v1","DN4 - Hipoestesia a picada de agulha",0.0975609756097561,0.0100175450852705,41,171,168,3,37,4
"10088","RMDQ22_v1","DN4 - Hipoestesia a picada de agulha",0.117647058823529,0.00257951051202975,34,178,175,3,30,4
"10089","RMDQ23_v1","DN4 - Hipoestesia a picada de agulha",0.121212121212121,0.00203122329892033,33,179,176,3,29,4
"10090","RMDQ24_v1","DN4 - Hipoestesia a picada de agulha",0.133333333333333,0.000904416361714182,30,182,179,3,26,4
"10091","DN4 - Queimação","DN4 - Hipoestesia a picada de agulha",0.0594059405940594,0.201949455771583,101,119,116,3,95,6
"10092","DN4 - Sensação de frio dolorosa","DN4 - Hipoestesia a picada de agulha",0.0416666666666667,0.982014313931702,48,171,164,7,46,2
"10093","DN4 - Choque elétrico","DN4 - Hipoestesia a picada de agulha",0.0983606557377049,0.00691904555528566,61,162,159,3,55,6
"10094","DN4 - Formigamento","DN4 - Hipoestesia a picada de agulha",0.0701754385964912,0.184912008034783,57,166,161,5,53,4
"10095","DN4 - Alfinetada e agulhada","DN4 - Hipoestesia a picada de agulha",0.138461538461538,1.80048356297352e-06,65,158,158,0,56,9
"10096","DN4 - Adormecimento","DN4 - Hipoestesia a picada de agulha",0.112903225806452,0.000732709060071309,62,158,156,2,55,7
"10097","DN4 - Coceira","DN4 - Hipoestesia a picada de agulha",0.272727272727273,5.90987565363136e-05,11,212,206,6,8,3
"10098","DH4 - Hipoestesia ao toque","DN4 - Hipoestesia a picada de agulha",0.875,2.53078892719671e-34,8,215,213,2,1,7
"10099","DN4 - Hipoestesia a picada de agulha","DN4 - Hipoestesia a picada de agulha",1,2.00459551247323e-50,9,214,214,0,0,9
"10100","DN4 - Escovação","DN4 - Hipoestesia a picada de agulha",1,2.93519539996466e-39,7,216,214,2,0,7
"10101","Fuma","DN4 - Escovação",0.102564102564103,0.00518563487972528,39,147,145,2,35,4
"10102","Cirurgia na coluna","DN4 - Escovação",0.027027027027027,0.586449856605349,74,126,124,2,72,2
"10103","Aposentado","DN4 - Escovação",0.0606060606060606,0.186605811676443,33,153,150,3,31,2
"10104","Desempregado","DN4 - Escovação",0.115384615384615,0.000429574147144764,26,157,156,1,23,3
"10105","Licenca_Medica","DN4 - Escovação",0.117647058823529,0.00442300038628143,17,167,165,2,15,2
"10106","Aposentado_Invalidez","DN4 - Escovação",0.25,8.21209548319804e-05,8,174,171,3,6,2
"10107","Analgésicos","DN4 - Escovação",0.0437956204379562,0.0891772222388207,137,64,64,0,131,6
"10108","OutraDoenca","DN4 - Escovação",0.0273972602739726,0.810087574384097,73,119,115,4,71,2
"10109","Dor nas costas","DN4 - Escovação",0.0338983050847458,0.373509792553173,118,76,75,1,114,4
"10110","Dor nas pernas","DN4 - Escovação",0.0645161290322581,0.0207909066765475,62,130,129,1,58,4
"10111","Retornar_trabalho","DN4 - Escovação",0.176470588235294,0.000327726219129346,17,174,171,3,14,3
"10112","Masc","DN4 - Escovação",0.0335570469798658,0.792296379331768,149,74,72,2,144,5
"10113","Fem","DN4 - Escovação",0.027027027027027,0.792296379331768,74,149,144,5,72,2
"10114","Casado/Amasiaado","DN4 - Escovação",0.0246913580246914,0.862736765472299,81,104,101,3,79,2
"10115","Solteiro","DN4 - Escovação",0.0384615384615385,0.412866609583166,78,107,105,2,75,3
"10116","Separado_Divorciado","DN4 - Escovação",0,0.653038209525315,7,178,173,5,7,0
"10117","X4","DN4 - Escovação",0,0.771017208658739,3,182,177,5,3,0
"10118","X5","DN4 - Escovação",0,0.705565336576118,5,180,175,5,5,0
"10119","X6","DN4 - Escovação",0,0.568694187092496,11,174,169,5,11,0
"10120","Livrar_costas","DN4 - Escovação",0.0288461538461538,0.491439609923196,104,16,16,0,101,3
"10121","Livrar_perna","DN4 - Escovação",0,0.523809518045622,14,106,103,3,14,0
"10122","Livrar_perda_sens","DN4 - Escovação",0,0.819361364095442,2,118,115,3,2,0
"10123","D1","DN4 - Escovação",0,0.851433613762243,1,118,114,4,1,0
"10124","D15","DN4 - Escovação",0.142857142857143,0.098326934488196,7,112,109,3,6,1
"10125","D16","DN4 - Escovação",0.05,0.655751723264071,20,99,96,3,19,1
"10126","D17","DN4 - Escovação",0,0.670052424301302,5,114,110,4,5,0
"10127","D18","DN4 - Escovação",0.1,0.223585207119876,10,109,106,3,9,1
"10128","D19","DN4 - Escovação",0.2,0.0349379793761989,5,114,111,3,4,1
"10129","D2","DN4 - Escovação",0.285714285714286,0.000136370593411503,7,112,110,2,5,2
"10130","D20","DN4 - Escovação",0.2,0.0349379793761989,5,114,111,3,4,1
"10131","D21","DN4 - Escovação",0,0.670052424301302,5,114,110,4,5,0
"10132","D22","DN4 - Escovação",NA,NA,0,119,115,4,0,0
"10133","D23","DN4 - Escovação",0,0.851433613762243,1,118,114,4,1,0
"10134","D24","DN4 - Escovação",0.0833333333333333,0.130388916402017,24,95,93,2,22,2
"10135","D25","DN4 - Escovação",0,0.743532065455045,3,116,112,4,3,0
"10136","D26","DN4 - Escovação",0,0.851433613762243,1,118,114,4,1,0
"10137","D27","DN4 - Escovação",0,0.704366003832738,4,115,111,4,4,0
"10138","D28","DN4 - Escovação",0,0.704366003832738,4,115,111,4,4,0
"10139","D29","DN4 - Escovação",0,0.140206003079748,41,78,74,4,41,0
"10140","D3","DN4 - Escovação",0.5,0.000223631269562627,2,117,114,3,1,1
"10141","Lombalgia","DN4 - Escovação",0.0350877192982456,0.931817682458751,57,62,60,2,55,2
"10142","D31","DN4 - Escovação",0,0.422636739271226,16,103,99,4,16,0
"10143","D32","DN4 - Escovação",0,0.180283502753194,36,83,79,4,36,0
"10144","D33","DN4 - Escovação",0,0.495666894505734,12,107,103,4,12,0
"10145","D34","DN4 - Escovação",0.666666666666667,7.18853818890754e-10,3,116,114,2,1,2
"10146","D35","DN4 - Escovação",1,7.26161658379463e-08,1,118,115,3,0,1
"10147","D36","DN4 - Escovação",0,0.584940252839,8,111,107,4,8,0
"10148","D37","DN4 - Escovação",0.0454545454545455,0.732864282036451,22,97,94,3,21,1
"10149","D38","DN4 - Escovação",0,0.743532065455045,3,116,112,4,3,0
"10150","D39","DN4 - Escovação",0,0.439728800281152,15,104,100,4,15,0
"10151","D4","DN4 - Escovação",0.666666666666667,7.18853818890754e-10,3,116,114,2,1,2
"10152","D40","DN4 - Escovação",0,0.670052424301302,5,114,110,4,5,0
"10153","D41","DN4 - Escovação",0,0.61101767849463,7,112,108,4,7,0
"10154","D42","DN4 - Escovação",0,0.851433613762243,1,118,114,4,1,0
"10155","D43","DN4 - Escovação",1,7.26161658379463e-08,1,118,115,3,0,1
"10156","D44","DN4 - Escovação",0,0.163471677972797,38,81,77,4,38,0
"10157","D45","DN4 - Escovação",0,0.495666894505734,12,107,103,4,12,0
"10158","D46","DN4 - Escovação",0.0263157894736842,0.762245014770329,38,81,78,3,37,1
"10159","D47","DN4 - Escovação",0.0833333333333333,0.313554889768837,12,107,104,3,11,1
"10160","D48","DN4 - Escovação",0,0.294083464247611,25,94,90,4,25,0
"10161","D49","DN4 - Escovação",0,0.476166960329298,13,106,102,4,13,0
"10162","D5","DN4 - Escovação",0.333333333333333,0.0035301799116423,3,116,113,3,2,1
"10163","D50","DN4 - Escovação",0.5,0.000223631269562627,2,117,114,3,1,1
"10164","D51","DN4 - Escovação",1,7.26161658379463e-08,1,118,115,3,0,1
"10165","D52","DN4 - Escovação",0.5,0.000223631269562627,2,117,114,3,1,1
"10166","D53","DN4 - Escovação",1,7.26161658379463e-08,1,118,115,3,0,1
"10167","D9","DN4 - Escovação",1,7.26161658379463e-08,1,118,115,3,0,1
"10168","RMDQ1_v1","DN4 - Escovação",0.0493827160493827,0.345280605550868,81,130,128,2,77,4
"10169","RMDQ2_v1","DN4 - Escovação",0.0487804878048781,0.359177906869156,82,129,127,2,78,4
"10170","RMDQ3_v1","DN4 - Escovação",0.0533333333333333,0.103925515433484,75,137,135,2,71,4
"10171","RMDQ4_v1","DN4 - Escovação",0,0.184765492222842,47,165,159,6,47,0
"10172","RMDQ5_v1","DN4 - Escovação",0.0588235294117647,0.0655458709319826,68,144,142,2,64,4
"10173","RMDQ6_v1","DN4 - Escovação",0.0784313725490196,0.0132420038532461,51,161,159,2,47,4
"10174","RMDQ7_v1","DN4 - Escovação",0.111111111111111,0.00100803164363727,36,176,174,2,32,4
"10175","RMDQ8_v1","DN4 - Escovação",0,0.646105616644332,7,205,199,6,7,0
"10176","RMDQ9_v1","DN4 - Escovação",0.129032258064516,0.000252086995375938,31,181,179,2,27,4
"10177","RMDQ10_v1","DN4 - Escovação",0.121212121212121,0.000460768376442171,33,179,177,2,29,4
"10178","RMDQ11_v1","DN4 - Escovação",0.114285714285714,0.000787768634466104,35,177,175,2,31,4
"10179","RMDQ12_v1","DN4 - Escovação",0.102564102564103,0.00196288294764954,39,173,171,2,35,4
"10180","RMDQ13_v1","DN4 - Escovação",0.0930232558139535,0.00415201059983438,43,169,167,2,39,4
"10181","RMDQ14_v1","DN4 - Escovação",0.0952380952380952,0.00348726888642748,42,170,168,2,38,4
"10182","RMDQ15_v1","DN4 - Escovação",0.133333333333333,0.000181095024232787,30,182,180,2,26,4
"10183","RMDQ16_v1","DN4 - Escovação",0.117647058823529,0.000607086316376842,34,178,176,2,30,4
"10184","RMDQ17_v1","DN4 - Escovação",0.0888888888888889,0.00575622969320227,45,167,165,2,41,4
"10185","RMDQ18_v1","DN4 - Escovação",0.133333333333333,0.000181095024232787,30,182,180,2,26,4
"10186","RMDQ19_v1","DN4 - Escovação",0.129032258064516,0.000252086995375938,31,181,179,2,27,4
"10187","RMDQ20_v1","DN4 - Escovação",0.121212121212121,0.000460768376442171,33,179,177,2,29,4
"10188","RMDQ21_v1","DN4 - Escovação",0.0975609756097561,0.00290522348282851,41,171,169,2,37,4
"10189","RMDQ22_v1","DN4 - Escovação",0.117647058823529,0.000607086316376842,34,178,176,2,30,4
"10190","RMDQ23_v1","DN4 - Escovação",0.121212121212121,0.000460768376442171,33,179,177,2,29,4
"10191","RMDQ24_v1","DN4 - Escovação",0.133333333333333,0.000181095024232787,30,182,180,2,26,4
"10192","DN4 - Queimação","DN4 - Escovação",0.0594059405940594,0.0317276867436082,101,119,118,1,95,6
"10193","DN4 - Sensação de frio dolorosa","DN4 - Escovação",0.0416666666666667,0.665377695438209,48,171,166,5,46,2
"10194","DN4 - Choque elétrico","DN4 - Escovação",0.0983606557377049,0.000432473076791566,61,162,161,1,55,6
"10195","DN4 - Formigamento","DN4 - Escovação",0.0701754385964912,0.0516067701534699,57,166,163,3,53,4
"10196","DN4 - Alfinetada e agulhada","DN4 - Escovação",0.107692307692308,2.77387838176512e-05,65,158,158,0,58,7
"10197","DN4 - Adormecimento","DN4 - Escovação",0.0806451612903226,0.00974432103717479,62,158,156,2,57,5
"10198","DN4 - Coceira","DN4 - Escovação",0.272727272727273,2.50192149129156e-06,11,212,208,4,8,3
"10199","DH4 - Hipoestesia ao toque","DN4 - Escovação",0.875,3.8096863903247e-44,8,215,215,0,1,7
"10200","DN4 - Hipoestesia a picada de agulha","DN4 - Escovação",0.777777777777778,2.93519539996466e-39,9,214,214,0,2,7
"10201","DN4 - Escovação","DN4 - Escovação",1,2.0045955124732e-50,7,216,216,0,0,7
